PokerStars Hand #1099153772: Omaha Pot Limit ($200/$400 USD) - 2020/10/24 06:23:33 ET
Table 'ADA120881500' 6-max Seat #1 is the button
Seat 1: DoJingBULLETS ($48000 in chips)
Seat 2: bothras ($52447 in chips)
Seat 3: vimalchotai001 ($15320 in chips)
Seat 4: TurnOnTuneInDropOut ($30200 in chips)
Seat 6: yatin47 ($44400 in chips)
bothras: posts small blind $200
vimalchotai001: posts big blind $400
*** HOLE CARDS ***
Dealt to TurnOnTuneInDropOut [4c Ts 8c 8d]
TurnOnTuneInDropOut: folds
yatin47: folds
DoJingBULLETS: folds
bothras: calls $200
vimalchotai001: checks
*** FLOP *** [8h Ad Jh]
bothras: bets $600
vimalchotai001: folds
Uncalled bet ($600) returned to bothras
bothras collected $768 from pot
bothras: doesn't show hand
*** SUMMARY ***
Total pot $800 | Rake $32
Board [8h Ad Jh]
Seat 1: DoJingBULLETS (button) folded before Flop (didn't bet)
Seat 2: bothras (small blind) collected ($768)
Seat 3: vimalchotai001 (big blind) folded on the Flop
Seat 4: TurnOnTuneInDropOut folded before Flop (didn't bet)
Seat 6: yatin47 folded before Flop (didn't bet)

PokerStars Hand #1099153773: Omaha Pot Limit ($200/$400 USD) - 2020/10/24 06:24:08 ET
Table 'ADA120881500' 6-max Seat #2 is the button
Seat 1: DoJingBULLETS ($48000 in chips)
Seat 2: bothras ($52815 in chips)
Seat 3: vimalchotai001 ($14920 in chips)
Seat 4: TurnOnTuneInDropOut ($30200 in chips)
Seat 6: yatin47 ($44400 in chips)
vimalchotai001: posts small blind $200
TurnOnTuneInDropOut: posts big blind $400
*** HOLE CARDS ***
Dealt to TurnOnTuneInDropOut [Ad Js 7s Qd]
yatin47: folds
DoJingBULLETS: folds
bothras: raises $1000 to $1400
vimalchotai001: calls $1200
TurnOnTuneInDropOut: raises $4200 to $5600
bothras: calls $4200
vimalchotai001: folds
*** FLOP *** [Td 5h Qc]
TurnOnTuneInDropOut: bets $8116
bothras: folds
Uncalled bet ($8116) returned to TurnOnTuneInDropOut
TurnOnTuneInDropOut collected $12095 from pot
TurnOnTuneInDropOut: doesn't show hand
*** SUMMARY ***
Total pot $12600 | Rake $505
Board [Td 5h Qc]
Seat 1: DoJingBULLETS folded before Flop (didn't bet)
Seat 2: bothras (button) folded on the Flop
Seat 3: vimalchotai001 (small blind) folded before Flop
Seat 4: TurnOnTuneInDropOut (big blind) collected ($12095)
Seat 6: yatin47 folded before Flop (didn't bet)

PokerStars Hand #1099153777: Omaha Pot Limit ($200/$400 USD) - 2020/10/24 06:27:07 ET
Table 'ADA120881500' 6-max Seat #1 is the button
Seat 1: DoJingBULLETS ($48000 in chips)
Seat 2: bothras ($46815 in chips)
Seat 3: vimalchotai001 ($17156 in chips)
Seat 4: TurnOnTuneInDropOut ($36495 in chips)
Seat 6: yatin47 ($43400 in chips)
bothras: posts small blind $200
vimalchotai001: posts big blind $400
*** HOLE CARDS ***
Dealt to TurnOnTuneInDropOut [Qh 7c 8c 8s]
TurnOnTuneInDropOut: folds
yatin47: calls $400
DoJingBULLETS: folds
bothras: calls $200
vimalchotai001: checks
*** FLOP *** [7h 3h 2h]
bothras: checks
vimalchotai001: checks
yatin47: checks
*** TURN *** [7h 3h 2h] [6d]
bothras: bets $900
vimalchotai001: folds
yatin47: folds
Uncalled bet ($900) returned to bothras
bothras collected $1152 from pot
bothras: doesn't show hand
*** SUMMARY ***
Total pot $1200 | Rake $48
Board [7h 3h 2h 6d]
Seat 1: DoJingBULLETS (button) folded before Flop (didn't bet)
Seat 2: bothras (small blind) collected ($1152)
Seat 3: vimalchotai001 (big blind) folded on the Turn
Seat 4: TurnOnTuneInDropOut folded before Flop (didn't bet)
Seat 6: yatin47 folded on the Turn

PokerStars Hand #1099153778: Omaha Pot Limit ($200/$400 USD) - 2020/10/24 06:27:41 ET
Table 'ADA120881500' 6-max Seat #2 is the button
Seat 1: DoJingBULLETS ($48000 in chips)
Seat 2: bothras ($47567 in chips)
Seat 3: vimalchotai001 ($16756 in chips)
Seat 4: TurnOnTuneInDropOut ($36495 in chips)
Seat 6: yatin47 ($43000 in chips)
vimalchotai001: posts small blind $200
TurnOnTuneInDropOut: posts big blind $400
*** HOLE CARDS ***
Dealt to TurnOnTuneInDropOut [Kd 4s Tc 8h]
yatin47: folds
DoJingBULLETS: folds
bothras: raises $1000 to $1400
vimalchotai001: folds
TurnOnTuneInDropOut: folds
Uncalled bet ($1000) returned to bothras
bothras collected $1000 from pot
bothras: doesn't show hand
*** SUMMARY ***
Total pot $1000 | Rake $0
Seat 1: DoJingBULLETS folded before Flop (didn't bet)
Seat 2: bothras (button) collected ($1000)
Seat 3: vimalchotai001 (small blind) folded before Flop
Seat 4: TurnOnTuneInDropOut (big blind) folded before Flop
Seat 6: yatin47 folded before Flop (didn't bet)

PokerStars Hand #1099153779: Omaha Pot Limit ($200/$400 USD) - 2020/10/24 06:28:17 ET
Table 'ADA120881500' 6-max Seat #3 is the button
Seat 1: DoJingBULLETS ($48000 in chips)
Seat 2: bothras ($48167 in chips)
Seat 3: vimalchotai001 ($16556 in chips)
Seat 4: TurnOnTuneInDropOut ($36095 in chips)
Seat 6: yatin47 ($43000 in chips)
TurnOnTuneInDropOut: posts small blind $200
yatin47: posts big blind $400
*** HOLE CARDS ***
Dealt to TurnOnTuneInDropOut [Qh 7d Jd 3h]
DoJingBULLETS: folds
bothras: raises $1000 to $1400
vimalchotai001: folds
TurnOnTuneInDropOut: folds
yatin47: calls $1000
*** FLOP *** [4h 8d 3s]
yatin47: checks
bothras: bets $1800
yatin47: folds
Uncalled bet ($1800) returned to bothras
bothras collected $2880 from pot
bothras: doesn't show hand
*** SUMMARY ***
Total pot $3000 | Rake $120
Board [4h 8d 3s]
Seat 1: DoJingBULLETS folded before Flop (didn't bet)
Seat 2: bothras collected ($2880)
Seat 3: vimalchotai001 (button) folded before Flop (didn't bet)
Seat 4: TurnOnTuneInDropOut (small blind) folded before Flop
Seat 6: yatin47 (big blind) folded on the Flop

PokerStars Hand #1099153781: Omaha Pot Limit ($200/$400 USD) - 2020/10/24 06:29:22 ET
Table 'ADA120881500' 6-max Seat #6 is the button
Seat 2: bothras ($50207 in chips)
Seat 3: vimalchotai001 ($16156 in chips)
Seat 4: TurnOnTuneInDropOut ($35895 in chips)
Seat 6: yatin47 ($41400 in chips)
bothras: posts small blind $200
vimalchotai001: posts big blind $400
*** HOLE CARDS ***
Dealt to TurnOnTuneInDropOut [8d Jd 9h Js]
TurnOnTuneInDropOut: raises $1000 to $1400
yatin47: folds
bothras: folds
vimalchotai001: folds
Uncalled bet ($1000) returned to TurnOnTuneInDropOut
TurnOnTuneInDropOut collected $1000 from pot
TurnOnTuneInDropOut: doesn't show hand
*** SUMMARY ***
Total pot $1000 | Rake $0
Seat 2: bothras (small blind) folded before Flop
Seat 3: vimalchotai001 (big blind) folded before Flop
Seat 4: TurnOnTuneInDropOut collected ($1000)
Seat 6: yatin47 (button) folded before Flop (didn't bet)

PokerStars Hand #1099153782: Omaha Pot Limit ($200/$400 USD) - 2020/10/24 06:29:38 ET
Table 'ADA120881500' 6-max Seat #2 is the button
Seat 2: bothras ($50007 in chips)
Seat 3: vimalchotai001 ($15756 in chips)
Seat 4: TurnOnTuneInDropOut ($36495 in chips)
Seat 6: yatin47 ($41400 in chips)
vimalchotai001: posts small blind $200
TurnOnTuneInDropOut: posts big blind $400
*** HOLE CARDS ***
Dealt to TurnOnTuneInDropOut [Kd 9c 3h Ts]
yatin47: folds
bothras: raises $1000 to $1400
vimalchotai001: calls $1200
TurnOnTuneInDropOut: folds
*** FLOP *** [5h 7h 7s]
vimalchotai001: checks
bothras: checks
*** TURN *** [5h 7h 7s] [2d]
vimalchotai001: bets $800
bothras: calls $800
*** RIVER *** [5h 7h 7s 2d] [8d]
vimalchotai001: bets $1200
bothras: calls $1200
*** SHOW DOWN ***
vimalchotai001: mucks hand
bothras: shows [Ks Ad Ac Js]
bothras collected $6911 from pot
*** SUMMARY ***
Total pot $7200 | Rake $289
Board [5h 7h 7s 2d 8d]
Seat 2: bothras (button) showed [Ks Ad Ac Js] and won ($6911)
Seat 3: vimalchotai001 (small blind) mucked
Seat 4: TurnOnTuneInDropOut (big blind) folded before Flop
Seat 6: yatin47 folded before Flop (didn't bet)

PokerStars Hand #163848419: Omaha Pot Limit ($200/$400 USD) - 2020/10/24 06:01:29 ET
Table 'ADA874189191' 6-max Seat #3 is the button
Seat 1: fernz666 ($48000 in chips)
Seat 3: vimalchotai001 ($14186 in chips)
Seat 4: TurnOnTuneInDropOut ($30368 in chips)
Seat 5: hashstack ($22317 in chips)
Seat 6: nimit2908 ($17704 in chips)
TurnOnTuneInDropOut: posts small blind $200
hashstack: posts big blind $400
*** HOLE CARDS ***
Dealt to TurnOnTuneInDropOut [7s 6d 3d 5h]
nimit2908: folds
fernz666: raises $1000 to $1400
vimalchotai001: calls $1400
TurnOnTuneInDropOut: folds
hashstack: folds
*** FLOP *** [9c Ac 6c]
fernz666: bets $2150
vimalchotai001: folds
Uncalled bet ($2150) returned to fernz666
fernz666 collected $3264 from pot
fernz666: doesn't show hand
*** SUMMARY ***
Total pot $3400 | Rake $136
Board [9c Ac 6c]
Seat 1: fernz666 collected ($3264)
Seat 3: vimalchotai001 (button) folded on the Flop
Seat 4: TurnOnTuneInDropOut (small blind) folded before Flop
Seat 5: hashstack (big blind) folded before Flop
Seat 6: nimit2908 folded before Flop (didn't bet)

PokerStars Hand #163848422: Omaha Pot Limit ($200/$400 USD) - 2020/10/24 06:03:02 ET
Table 'ADA874189191' 6-max Seat #6 is the button
Seat 1: fernz666 ($49464 in chips)
Seat 3: vimalchotai001 ($13346 in chips)
Seat 4: TurnOnTuneInDropOut ($25768 in chips)
Seat 5: hashstack ($21717 in chips)
Seat 6: nimit2908 ($21743 in chips)
fernz666: posts small blind $200
vimalchotai001: posts big blind $400
*** HOLE CARDS ***
Dealt to TurnOnTuneInDropOut [9h Ks 3s Jc]
TurnOnTuneInDropOut: folds
hashstack: raises $650 to $1050
nimit2908: folds
fernz666: folds
vimalchotai001: calls $650
*** FLOP *** [3c Ad 9c]
vimalchotai001: bets $800
hashstack: calls $800
*** TURN *** [3c Ad 9c] [Qc]
vimalchotai001: bets $800
hashstack: raises $1797 to $2597
vimalchotai001: calls $1797
*** RIVER *** [3c Ad 9c Qc] [7s]
vimalchotai001: bets $1600
hashstack: folds
Uncalled bet ($1600) returned to vimalchotai001
vimalchotai001 collected $8729 from pot
vimalchotai001: doesn't show hand
*** SUMMARY ***
Total pot $9094 | Rake $365
Board [3c Ad 9c Qc 7s]
Seat 1: fernz666 (small blind) folded before Flop
Seat 3: vimalchotai001 (big blind) collected ($8729)
Seat 4: TurnOnTuneInDropOut folded before Flop (didn't bet)
Seat 5: hashstack folded on the River
Seat 6: nimit2908 (button) folded before Flop (didn't bet)

PokerStars Hand #163848426: Omaha Pot Limit ($200/$400 USD) - 2020/10/24 06:05:55 ET
Table 'ADA874189191' 6-max Seat #5 is the button
Seat 1: fernz666 ($49264 in chips)
Seat 3: vimalchotai001 ($13628 in chips)
Seat 4: TurnOnTuneInDropOut ($25168 in chips)
Seat 5: hashstack ($21158 in chips)
Seat 6: nimit2908 ($22095 in chips)
nimit2908: posts small blind $200
fernz666: posts big blind $400
*** HOLE CARDS ***
Dealt to TurnOnTuneInDropOut [Ah Ts 9c Kh]
vimalchotai001: raises $800 to $1200
TurnOnTuneInDropOut: raises $3000 to $4200
hashstack: folds
nimit2908: folds
fernz666: folds
vimalchotai001: calls $3000
*** FLOP *** [Td 4s Kd]
vimalchotai001: bets $1600
TurnOnTuneInDropOut: raises $12200 to $13800
vimalchotai001: calls $7828 and is all-in
Uncalled bet ($4372) returned to TurnOnTuneInDropOut
*** TURN *** [Td 4s Kd] [4c]
*** RIVER *** [Td 4s Kd 4c] [8s]
*** SHOW DOWN ***
vimalchotai001: shows [Qd Ac 5h As]
TurnOnTuneInDropOut: shows [Ah Ts 9c Kh]
vimalchotai001 collected $27056 from pot
*** SUMMARY ***
Total pot $27856 | Rake $800
Board [Td 4s Kd 4c 8s]
Seat 1: fernz666 (big blind) folded before Flop
Seat 3: vimalchotai001 showed [Qd Ac 5h As] and won ($27056)
Seat 4: TurnOnTuneInDropOut showed [Ah Ts 9c Kh] and lost
Seat 5: hashstack (button) folded before Flop (didn't bet)
Seat 6: nimit2908 (small blind) folded before Flop

PokerStars Hand #163848427: Omaha Pot Limit ($200/$400 USD) - 2020/10/24 06:06:29 ET
Table 'ADA874189191' 6-max Seat #6 is the button
Seat 1: fernz666 ($48864 in chips)
Seat 2: bothras ($48000 in chips)
Seat 3: vimalchotai001 ($27056 in chips)
Seat 4: TurnOnTuneInDropOut ($11540 in chips)
Seat 5: hashstack ($21158 in chips)
Seat 6: nimit2908 ($21895 in chips)
fernz666: posts small blind $200
bothras: posts big blind $400
*** HOLE CARDS ***
Dealt to TurnOnTuneInDropOut [2h 5c 4h 3s]
vimalchotai001: folds
TurnOnTuneInDropOut: folds
hashstack: folds
nimit2908: folds
fernz666: folds
Uncalled bet ($200) returned to bothras
bothras collected $400 from pot
bothras: doesn't show hand
*** SUMMARY ***
Total pot $400 | Rake $0
Seat 1: fernz666 (small blind) folded before Flop
Seat 2: bothras (big blind) collected ($400)
Seat 3: vimalchotai001 folded before Flop (didn't bet)
Seat 4: TurnOnTuneInDropOut folded before Flop (didn't bet)
Seat 5: hashstack folded before Flop (didn't bet)
Seat 6: nimit2908 (button) folded before Flop (didn't bet)

PokerStars Hand #163848428: Omaha Pot Limit ($200/$400 USD) - 2020/10/24 06:06:48 ET
Table 'ADA874189191' 6-max Seat #1 is the button
Seat 1: fernz666 ($48664 in chips)
Seat 2: bothras ($48200 in chips)
Seat 3: vimalchotai001 ($27056 in chips)
Seat 4: TurnOnTuneInDropOut ($24000 in chips)
Seat 5: hashstack ($21158 in chips)
Seat 6: nimit2908 ($21895 in chips)
bothras: posts small blind $200
vimalchotai001: posts big blind $400
*** HOLE CARDS ***
Dealt to TurnOnTuneInDropOut [Qs 3h 2s 4c]
TurnOnTuneInDropOut: folds
hashstack: raises $650 to $1050
nimit2908: folds
fernz666: folds
bothras: folds
vimalchotai001: folds
Uncalled bet ($650) returned to hashstack
hashstack collected $1000 from pot
hashstack: doesn't show hand
*** SUMMARY ***
Total pot $1000 | Rake $0
Seat 1: fernz666 (button) folded before Flop (didn't bet)
Seat 2: bothras (small blind) folded before Flop
Seat 3: vimalchotai001 (big blind) folded before Flop
Seat 4: TurnOnTuneInDropOut folded before Flop (didn't bet)
Seat 5: hashstack collected ($1000)
Seat 6: nimit2908 folded before Flop (didn't bet)

PokerStars Hand #163848429: Omaha Pot Limit ($200/$400 USD) - 2020/10/24 06:07:05 ET
Table 'ADA874189191' 6-max Seat #2 is the button
Seat 1: fernz666 ($48664 in chips)
Seat 2: bothras ($48000 in chips)
Seat 3: vimalchotai001 ($26656 in chips)
Seat 4: TurnOnTuneInDropOut ($24000 in chips)
Seat 5: hashstack ($21758 in chips)
Seat 6: nimit2908 ($21895 in chips)
vimalchotai001: posts small blind $200
TurnOnTuneInDropOut: posts big blind $400
*** HOLE CARDS ***
Dealt to TurnOnTuneInDropOut [5s 3d 5c 6s]
hashstack: folds
nimit2908: folds
fernz666: folds
bothras: raises $1000 to $1400
vimalchotai001: calls $1200
TurnOnTuneInDropOut: folds
*** FLOP *** [Ah 6d 8s]
vimalchotai001: checks
bothras: checks
*** TURN *** [Ah 6d 8s] [5d]
vimalchotai001: bets $1200
bothras: folds
Uncalled bet ($1200) returned to vimalchotai001
vimalchotai001 collected $3072 from pot
vimalchotai001: doesn't show hand
*** SUMMARY ***
Total pot $3200 | Rake $128
Board [Ah 6d 8s 5d]
Seat 1: fernz666 folded before Flop (didn't bet)
Seat 2: bothras (button) folded on the Turn
Seat 3: vimalchotai001 (small blind) collected ($3072)
Seat 4: TurnOnTuneInDropOut (big blind) folded before Flop
Seat 5: hashstack folded before Flop (didn't bet)
Seat 6: nimit2908 folded before Flop (didn't bet)

PokerStars Hand #163848431: Omaha Pot Limit ($200/$400 USD) - 2020/10/24 06:08:22 ET
Table 'ADA874189191' 6-max Seat #4 is the button
Seat 1: fernz666 ($48664 in chips)
Seat 2: bothras ($46600 in chips)
Seat 3: vimalchotai001 ($27428 in chips)
Seat 4: TurnOnTuneInDropOut ($23400 in chips)
Seat 5: hashstack ($22778 in chips)
Seat 6: nimit2908 ($21895 in chips)
hashstack: posts small blind $200
nimit2908: posts big blind $400
*** HOLE CARDS ***
Dealt to TurnOnTuneInDropOut [4c Jd Ac 5c]
fernz666: raises $1000 to $1400
bothras: folds
vimalchotai001: folds
TurnOnTuneInDropOut: folds
hashstack: folds
nimit2908: folds
Uncalled bet ($1000) returned to fernz666
fernz666 collected $1000 from pot
fernz666: doesn't show hand
*** SUMMARY ***
Total pot $1000 | Rake $0
Seat 1: fernz666 collected ($1000)
Seat 2: bothras folded before Flop (didn't bet)
Seat 3: vimalchotai001 folded before Flop (didn't bet)
Seat 4: TurnOnTuneInDropOut (button) folded before Flop (didn't bet)
Seat 5: hashstack (small blind) folded before Flop
Seat 6: nimit2908 (big blind) folded before Flop

PokerStars Hand #163848437: Omaha Pot Limit ($200/$400 USD) - 2020/10/24 06:12:01 ET
Table 'ADA874189191' 6-max Seat #4 is the button
Seat 1: fernz666 ($57179 in chips)
Seat 2: bothras ($37360 in chips)
Seat 3: vimalchotai001 ($29212 in chips)
Seat 4: TurnOnTuneInDropOut ($32226 in chips)
Seat 5: hashstack ($22178 in chips)
Seat 6: nimit2908 ($17695 in chips)
hashstack: posts small blind $200
nimit2908: posts big blind $400
*** HOLE CARDS ***
Dealt to TurnOnTuneInDropOut [7s 4h 2s 6s]
fernz666: folds
bothras: folds
vimalchotai001: folds
TurnOnTuneInDropOut: folds
hashstack: calls $200
nimit2908: raises $800 to $1200
hashstack: calls $800
*** FLOP *** [4s Qc Ts]
hashstack: checks
nimit2908: bets $1800
hashstack: raises $6000 to $7800
nimit2908: folds
Uncalled bet ($6000) returned to hashstack
hashstack collected $5759 from pot
hashstack: doesn't show hand
*** SUMMARY ***
Total pot $6000 | Rake $241
Board [4s Qc Ts]
Seat 1: fernz666 folded before Flop (didn't bet)
Seat 2: bothras folded before Flop (didn't bet)
Seat 3: vimalchotai001 folded before Flop (didn't bet)
Seat 4: TurnOnTuneInDropOut (button) folded before Flop (didn't bet)
Seat 5: hashstack (small blind) collected ($5759)
Seat 6: nimit2908 (big blind) folded on the Flop

PokerStars Hand #163848438: Omaha Pot Limit ($200/$400 USD) - 2020/10/24 06:12:42 ET
Table 'ADA874189191' 6-max Seat #5 is the button
Seat 1: fernz666 ($57179 in chips)
Seat 2: bothras ($37360 in chips)
Seat 3: vimalchotai001 ($29212 in chips)
Seat 4: TurnOnTuneInDropOut ($32226 in chips)
Seat 5: hashstack ($24937 in chips)
Seat 6: nimit2908 ($14695 in chips)
nimit2908: posts small blind $200
fernz666: posts big blind $400
*** HOLE CARDS ***
Dealt to TurnOnTuneInDropOut [Ks Tc 7d 9d]
bothras: folds
vimalchotai001: folds
TurnOnTuneInDropOut: raises $1000 to $1400
hashstack: calls $1400
nimit2908: calls $1200
fernz666: folds
*** FLOP *** [7s 6d 2d]
nimit2908: checks
TurnOnTuneInDropOut: checks
hashstack: checks
*** TURN *** [7s 6d 2d] [As]
nimit2908: checks
TurnOnTuneInDropOut: checks
hashstack: checks
*** RIVER *** [7s 6d 2d As] [Ad]
nimit2908: checks
TurnOnTuneInDropOut: checks
hashstack: bets $2250
nimit2908: folds
TurnOnTuneInDropOut: calls $2250
*** SHOW DOWN ***
TurnOnTuneInDropOut: shows [Ks Tc 7d 9d]
hashstack: shows [Qh Td Js 2s]
TurnOnTuneInDropOut collected $8735 from pot
*** SUMMARY ***
Total pot $9100 | Rake $365
Board [7s 6d 2d As Ad]
Seat 1: fernz666 (big blind) folded before Flop
Seat 2: bothras folded before Flop (didn't bet)
Seat 3: vimalchotai001 folded before Flop (didn't bet)
Seat 4: TurnOnTuneInDropOut showed [Ks Tc 7d 9d] and won ($8735)
Seat 5: hashstack (button) showed [Qh Td Js 2s] and lost
Seat 6: nimit2908 (small blind) folded on the River

PokerStars Hand #163848440: Omaha Pot Limit ($200/$400 USD) - 2020/10/24 06:14:19 ET
Table 'ADA874189191' 6-max Seat #1 is the button
Seat 1: fernz666 ($56579 in chips)
Seat 2: bothras ($36960 in chips)
Seat 3: vimalchotai001 ($28812 in chips)
Seat 4: TurnOnTuneInDropOut ($50806 in chips)
Seat 5: hashstack ($21287 in chips)
bothras: posts small blind $200
vimalchotai001: posts big blind $400
*** HOLE CARDS ***
Dealt to TurnOnTuneInDropOut [2c Kd Qd Td]
TurnOnTuneInDropOut: folds
hashstack: folds
fernz666: folds
bothras: folds
Uncalled bet ($200) returned to vimalchotai001
vimalchotai001 collected $400 from pot
vimalchotai001: doesn't show hand
*** SUMMARY ***
Total pot $400 | Rake $0
Seat 1: fernz666 (button) folded before Flop (didn't bet)
Seat 2: bothras (small blind) folded before Flop
Seat 3: vimalchotai001 (big blind) collected ($400)
Seat 4: TurnOnTuneInDropOut folded before Flop (didn't bet)
Seat 5: hashstack folded before Flop (didn't bet)

PokerStars Hand #163848441: Omaha Pot Limit ($200/$400 USD) - 2020/10/24 06:14:32 ET
Table 'ADA874189191' 6-max Seat #2 is the button
Seat 1: fernz666 ($56579 in chips)
Seat 2: bothras ($36760 in chips)
Seat 3: vimalchotai001 ($29012 in chips)
Seat 4: TurnOnTuneInDropOut ($50806 in chips)
Seat 5: hashstack ($21287 in chips)
vimalchotai001: posts small blind $200
TurnOnTuneInDropOut: posts big blind $400
*** HOLE CARDS ***
Dealt to TurnOnTuneInDropOut [9d Kh 2c 9s]
hashstack: folds
fernz666: raises $1000 to $1400
bothras: folds
vimalchotai001: calls $1200
TurnOnTuneInDropOut: folds
*** FLOP *** [4d 5c 7d]
vimalchotai001: checks
fernz666: checks
*** TURN *** [4d 5c 7d] [Kd]
vimalchotai001: bets $800
fernz666: folds
Uncalled bet ($800) returned to vimalchotai001
vimalchotai001 collected $3072 from pot
vimalchotai001: doesn't show hand
*** SUMMARY ***
Total pot $3200 | Rake $128
Board [4d 5c 7d Kd]
Seat 1: fernz666 folded on the Turn
Seat 2: bothras (button) folded before Flop (didn't bet)
Seat 3: vimalchotai001 (small blind) collected ($3072)
Seat 4: TurnOnTuneInDropOut (big blind) folded before Flop
Seat 5: hashstack folded before Flop (didn't bet)

PokerStars Hand #163848442: Omaha Pot Limit ($200/$400 USD) - 2020/10/24 06:15:02 ET
Table 'ADA874189191' 6-max Seat #3 is the button
Seat 1: fernz666 ($55179 in chips)
Seat 2: bothras ($36760 in chips)
Seat 3: vimalchotai001 ($30684 in chips)
Seat 4: TurnOnTuneInDropOut ($50406 in chips)
Seat 5: hashstack ($21287 in chips)
TurnOnTuneInDropOut: posts small blind $200
hashstack: posts big blind $400
*** HOLE CARDS ***
Dealt to TurnOnTuneInDropOut [6c 7s Tc 8d]
fernz666: raises $1000 to $1400
bothras: folds
vimalchotai001: folds
TurnOnTuneInDropOut: folds
hashstack: folds
Uncalled bet ($1000) returned to fernz666
fernz666 collected $1000 from pot
fernz666: doesn't show hand
*** SUMMARY ***
Total pot $1000 | Rake $0
Seat 1: fernz666 collected ($1000)
Seat 2: bothras folded before Flop (didn't bet)
Seat 3: vimalchotai001 (button) folded before Flop (didn't bet)
Seat 4: TurnOnTuneInDropOut (small blind) folded before Flop
Seat 5: hashstack (big blind) folded before Flop

PokerStars Hand #163848443: Omaha Pot Limit ($200/$400 USD) - 2020/10/24 06:15:20 ET
Table 'ADA874189191' 6-max Seat #4 is the button
Seat 1: fernz666 ($55779 in chips)
Seat 2: bothras ($36760 in chips)
Seat 3: vimalchotai001 ($30684 in chips)
Seat 4: TurnOnTuneInDropOut ($50206 in chips)
Seat 5: hashstack ($20887 in chips)
hashstack: posts small blind $200
fernz666: posts big blind $400
*** HOLE CARDS ***
Dealt to TurnOnTuneInDropOut [Th 7c 3h 8s]
bothras: folds
vimalchotai001: folds
TurnOnTuneInDropOut: raises $1000 to $1400
hashstack: folds
fernz666: folds
Uncalled bet ($1000) returned to TurnOnTuneInDropOut
TurnOnTuneInDropOut collected $1000 from pot
TurnOnTuneInDropOut: doesn't show hand
*** SUMMARY ***
Total pot $1000 | Rake $0
Seat 1: fernz666 (big blind) folded before Flop
Seat 2: bothras folded before Flop (didn't bet)
Seat 3: vimalchotai001 folded before Flop (didn't bet)
Seat 4: TurnOnTuneInDropOut (button) collected ($1000)
Seat 5: hashstack (small blind) folded before Flop

PokerStars Hand #163848445: Omaha Pot Limit ($200/$400 USD) - 2020/10/24 06:16:06 ET
Table 'ADA874189191' 6-max Seat #1 is the button
Seat 1: fernz666 ($55179 in chips)
Seat 2: bothras ($37320 in chips)
Seat 3: vimalchotai001 ($30284 in chips)
Seat 4: TurnOnTuneInDropOut ($50806 in chips)
Seat 5: hashstack ($20687 in chips)
bothras: posts small blind $200
vimalchotai001: posts big blind $400
*** HOLE CARDS ***
Dealt to TurnOnTuneInDropOut [Ad Kc 5h 9d]
TurnOnTuneInDropOut: folds
hashstack: folds
fernz666: raises $1000 to $1400
bothras: folds
vimalchotai001: calls $1000
*** FLOP *** [7h Qc Qh]
vimalchotai001: checks
fernz666: bets $1900
vimalchotai001: calls $1900
*** TURN *** [7h Qc Qh] [Qs]
vimalchotai001: checks
fernz666: bets $4200
vimalchotai001: calls $4200
*** RIVER *** [7h Qc Qh Qs] [As]
vimalchotai001: bets $3200
fernz666: folds
Uncalled bet ($3200) returned to vimalchotai001
vimalchotai001 collected $14590 from pot
vimalchotai001: doesn't show hand
*** SUMMARY ***
Total pot $15200 | Rake $610
Board [7h Qc Qh Qs As]
Seat 1: fernz666 (button) folded on the River
Seat 2: bothras (small blind) folded before Flop
Seat 3: vimalchotai001 (big blind) collected ($14590)
Seat 4: TurnOnTuneInDropOut folded before Flop (didn't bet)
Seat 5: hashstack folded before Flop (didn't bet)

PokerStars Hand #163848450: Omaha Pot Limit ($200/$400 USD) - 2020/10/24 06:19:33 ET
Table 'ADA874189191' 6-max Seat #1 is the button
Seat 1: fernz666 ($47079 in chips)
Seat 2: bothras ($38952 in chips)
Seat 3: vimalchotai001 ($35726 in chips)
Seat 4: TurnOnTuneInDropOut ($53965 in chips)
Seat 5: hashstack ($17439 in chips)
bothras: posts small blind $200
vimalchotai001: posts big blind $400
*** HOLE CARDS ***
Dealt to TurnOnTuneInDropOut [Jc 3d 4s 9c]
TurnOnTuneInDropOut: folds
hashstack: folds
fernz666: raises $1000 to $1400
bothras: folds
vimalchotai001: calls $1000
*** FLOP *** [Ts Kd Qd]
vimalchotai001: bets $800
fernz666: raises $3250 to $4050
vimalchotai001: calls $3250
*** TURN *** [Ts Kd Qd] [5c]
vimalchotai001: bets $1200
fernz666: raises $9825 to $11025
vimalchotai001: folds
Uncalled bet ($9825) returned to fernz666
fernz666 collected $12959 from pot
fernz666: doesn't show hand
*** SUMMARY ***
Total pot $13500 | Rake $541
Board [Ts Kd Qd 5c]
Seat 1: fernz666 (button) collected ($12959)
Seat 2: bothras (small blind) folded before Flop
Seat 3: vimalchotai001 (big blind) folded on the Turn
Seat 4: TurnOnTuneInDropOut folded before Flop (didn't bet)
Seat 5: hashstack folded before Flop (didn't bet)

PokerStars Hand #163848451: Omaha Pot Limit ($200/$400 USD) - 2020/10/24 06:20:19 ET
Table 'ADA874189191' 6-max Seat #2 is the button
Seat 1: fernz666 ($53388 in chips)
Seat 2: bothras ($38752 in chips)
Seat 3: vimalchotai001 ($29076 in chips)
Seat 4: TurnOnTuneInDropOut ($53965 in chips)
Seat 5: hashstack ($17439 in chips)
vimalchotai001: posts small blind $200
TurnOnTuneInDropOut: posts big blind $400
*** HOLE CARDS ***
Dealt to TurnOnTuneInDropOut [9s Jc 7s 2h]
hashstack: raises $400 to $800
fernz666: folds
bothras: calls $800
vimalchotai001: folds
TurnOnTuneInDropOut: folds
*** FLOP *** [8s Qh 4c]
hashstack: checks
bothras: checks
*** TURN *** [8s Qh 4c] [4s]
hashstack: bets $1500
bothras: folds
Uncalled bet ($1500) returned to hashstack
hashstack collected $2112 from pot
hashstack: doesn't show hand
*** SUMMARY ***
Total pot $2200 | Rake $88
Board [8s Qh 4c 4s]
Seat 1: fernz666 folded before Flop (didn't bet)
Seat 2: bothras (button) folded on the Turn
Seat 3: vimalchotai001 (small blind) folded before Flop
Seat 4: TurnOnTuneInDropOut (big blind) folded before Flop
Seat 5: hashstack collected ($2112)

PokerStars Hand #163848452: Omaha Pot Limit ($200/$400 USD) - 2020/10/24 06:20:58 ET
Table 'ADA874189191' 6-max Seat #3 is the button
Seat 1: fernz666 ($53388 in chips)
Seat 2: bothras ($37952 in chips)
Seat 3: vimalchotai001 ($28876 in chips)
Seat 4: TurnOnTuneInDropOut ($53565 in chips)
Seat 5: hashstack ($18751 in chips)
TurnOnTuneInDropOut: posts small blind $200
hashstack: posts big blind $400
*** HOLE CARDS ***
Dealt to TurnOnTuneInDropOut [4d 2c 4c Qd]
fernz666: folds
bothras: raises $1000 to $1400
vimalchotai001: folds
TurnOnTuneInDropOut: folds
hashstack: calls $1000
*** FLOP *** [2d Jh 8s]
hashstack: checks
bothras: bets $2250
hashstack: folds
Uncalled bet ($2250) returned to bothras
bothras collected $2880 from pot
bothras: doesn't show hand
*** SUMMARY ***
Total pot $3000 | Rake $120
Board [2d Jh 8s]
Seat 1: fernz666 folded before Flop (didn't bet)
Seat 2: bothras collected ($2880)
Seat 3: vimalchotai001 (button) folded before Flop (didn't bet)
Seat 4: TurnOnTuneInDropOut (small blind) folded before Flop
Seat 5: hashstack (big blind) folded on the Flop

PokerStars Hand #163848454: Omaha Pot Limit ($200/$400 USD) - 2020/10/24 06:22:13 ET
Table 'ADA874189191' 6-max Seat #5 is the button
Seat 1: fernz666 ($36037 in chips)
Seat 2: bothras ($39432 in chips)
Seat 3: vimalchotai001 ($28476 in chips)
Seat 4: TurnOnTuneInDropOut ($51565 in chips)
Seat 5: hashstack ($36102 in chips)
fernz666: posts small blind $200
bothras: posts big blind $400
*** HOLE CARDS ***
Dealt to TurnOnTuneInDropOut [Jh Tc 9d 9c]
vimalchotai001: folds
TurnOnTuneInDropOut: raises $1000 to $1400
hashstack: folds
fernz666: folds
bothras: calls $1000
*** FLOP *** [Ad 4h Qh]
bothras: checks
TurnOnTuneInDropOut: bets $1980
bothras: calls $1980
*** TURN *** [Ad 4h Qh] [7h]
bothras: checks
TurnOnTuneInDropOut: bets $2854
bothras: folds
Uncalled bet ($2854) returned to TurnOnTuneInDropOut
TurnOnTuneInDropOut collected $6681 from pot
TurnOnTuneInDropOut: doesn't show hand
*** SUMMARY ***
Total pot $6960 | Rake $279
Board [Ad 4h Qh 7h]
Seat 1: fernz666 (small blind) folded before Flop
Seat 2: bothras (big blind) folded on the Turn
Seat 3: vimalchotai001 folded before Flop (didn't bet)
Seat 4: TurnOnTuneInDropOut collected ($6681)
Seat 5: hashstack (button) folded before Flop (didn't bet)

PokerStars Hand #163848455: Omaha Pot Limit ($200/$400 USD) - 2020/10/24 06:22:50 ET
Table 'ADA874189191' 6-max Seat #1 is the button
Seat 1: fernz666 ($48000 in chips)
Seat 2: bothras ($36052 in chips)
Seat 3: vimalchotai001 ($28476 in chips)
Seat 4: TurnOnTuneInDropOut ($54866 in chips)
Seat 5: hashstack ($36102 in chips)
bothras: posts small blind $200
vimalchotai001: posts big blind $400
*** HOLE CARDS ***
Dealt to TurnOnTuneInDropOut [4d 6s 3c 4c]
TurnOnTuneInDropOut: folds
hashstack: folds
fernz666: folds
bothras: folds
Uncalled bet ($200) returned to vimalchotai001
vimalchotai001 collected $400 from pot
vimalchotai001: doesn't show hand
*** SUMMARY ***
Total pot $400 | Rake $0
Seat 1: fernz666 (button) folded before Flop (didn't bet)
Seat 2: bothras (small blind) folded before Flop
Seat 3: vimalchotai001 (big blind) collected ($400)
Seat 4: TurnOnTuneInDropOut folded before Flop (didn't bet)
Seat 5: hashstack folded before Flop (didn't bet)

PokerStars Hand #163848456: Omaha Pot Limit ($200/$400 USD) - 2020/10/24 06:23:02 ET
Table 'ADA874189191' 6-max Seat #2 is the button
Seat 1: fernz666 ($48000 in chips)
Seat 2: bothras ($35852 in chips)
Seat 3: vimalchotai001 ($28676 in chips)
Seat 4: TurnOnTuneInDropOut ($54866 in chips)
Seat 5: hashstack ($36102 in chips)
vimalchotai001: posts small blind $200
TurnOnTuneInDropOut: posts big blind $400
*** HOLE CARDS ***
Dealt to TurnOnTuneInDropOut [5c 9c Jd Qd]
hashstack: folds
fernz666: folds
bothras: folds
vimalchotai001: calls $200
TurnOnTuneInDropOut: raises $800 to $1200
vimalchotai001: calls $800
*** FLOP *** [7s 9h 6h]
vimalchotai001: checks
TurnOnTuneInDropOut: checks
*** TURN *** [7s 9h 6h] [2h]
vimalchotai001: checks
TurnOnTuneInDropOut: checks
*** RIVER *** [7s 9h 6h 2h] [Ah]
vimalchotai001: checks
TurnOnTuneInDropOut: checks
*** SHOW DOWN ***
vimalchotai001: shows [As 8d Js 9d]
vimalchotai001 collected $2304 from pot
*** SUMMARY ***
Total pot $2400 | Rake $96
Board [7s 9h 6h 2h Ah]
Seat 1: fernz666 folded before Flop (didn't bet)
Seat 2: bothras (button) folded before Flop (didn't bet)
Seat 3: vimalchotai001 (small blind) showed [As 8d Js 9d] and won ($2304)
Seat 4: TurnOnTuneInDropOut (big blind)
Seat 5: hashstack folded before Flop (didn't bet)

PokerStars Hand #163848457: Omaha Pot Limit ($200/$400 USD) - 2020/10/24 06:23:53 ET
Table 'ADA874189191' 6-max Seat #3 is the button
Seat 1: fernz666 ($48000 in chips)
Seat 2: bothras ($35852 in chips)
Seat 3: vimalchotai001 ($29780 in chips)
Seat 4: TurnOnTuneInDropOut ($53666 in chips)
TurnOnTuneInDropOut: posts small blind $200
fernz666: posts big blind $400
*** HOLE CARDS ***
Dealt to TurnOnTuneInDropOut [8d 8c 4h Js]
bothras: folds
vimalchotai001: folds
TurnOnTuneInDropOut: folds
Uncalled bet ($200) returned to fernz666
fernz666 collected $400 from pot
fernz666: doesn't show hand
*** SUMMARY ***
Total pot $400 | Rake $0
Seat 1: fernz666 (big blind) collected ($400)
Seat 2: bothras folded before Flop (didn't bet)
Seat 3: vimalchotai001 (button) folded before Flop (didn't bet)
Seat 4: TurnOnTuneInDropOut (small blind) folded before Flop

PokerStars Hand #163848459: Omaha Pot Limit ($200/$400 USD) - 2020/10/24 06:24:53 ET
Table 'ADA874189191' 6-max Seat #1 is the button
Seat 1: fernz666 ($48000 in chips)
Seat 2: bothras ($36412 in chips)
Seat 3: vimalchotai001 ($29380 in chips)
Seat 4: TurnOnTuneInDropOut ($53466 in chips)
bothras: posts small blind $200
vimalchotai001: posts big blind $400
*** HOLE CARDS ***
Dealt to TurnOnTuneInDropOut [Ac 6h 3c Ks]
TurnOnTuneInDropOut: folds
fernz666: folds
bothras: calls $200
vimalchotai001: checks
*** FLOP *** [6d Kc Th]
bothras: bets $480
vimalchotai001: folds
Uncalled bet ($480) returned to bothras
bothras collected $768 from pot
bothras: doesn't show hand
*** SUMMARY ***
Total pot $800 | Rake $32
Board [6d Kc Th]
Seat 1: fernz666 (button) folded before Flop (didn't bet)
Seat 2: bothras (small blind) collected ($768)
Seat 3: vimalchotai001 (big blind) folded on the Flop
Seat 4: TurnOnTuneInDropOut folded before Flop (didn't bet)

PokerStars Hand #1922877784: Omaha Pot Limit ($200/$400 USD) - 2020/10/23 12:20:03 ET
Table 'ADA179504417' 6-max Seat #4 is the button
Seat 1: kaushal222 ($9309 in chips)
Seat 2: soundfsilenz ($90274 in chips)
Seat 3: TurnOnTuneInDropOut ($29400 in chips)
Seat 4: karanchawla09 ($18891 in chips)
Seat 5: PokerMessi ($91597 in chips)
Seat 6: slotmachine ($51871 in chips)
PokerMessi: posts small blind $200
slotmachine: posts big blind $400
*** HOLE CARDS ***
Dealt to TurnOnTuneInDropOut [4c 9d 5c 4h]
kaushal222: folds
soundfsilenz: folds
TurnOnTuneInDropOut: folds
karanchawla09: calls $400
PokerMessi: folds
slotmachine: checks
*** FLOP *** [As 3h 8c]
slotmachine: checks
karanchawla09: checks
*** TURN *** [As 3h 8c] [Jc]
slotmachine: checks
karanchawla09: checks
*** RIVER *** [As 3h 8c Jc] [8d]
slotmachine: checks
karanchawla09: bets $400
slotmachine: folds
Uncalled bet ($400) returned to karanchawla09
karanchawla09 collected $960 from pot
karanchawla09: doesn't show hand
*** SUMMARY ***
Total pot $1000 | Rake $40
Board [As 3h 8c Jc 8d]
Seat 1: kaushal222 folded before Flop (didn't bet)
Seat 2: soundfsilenz folded before Flop (didn't bet)
Seat 3: TurnOnTuneInDropOut folded before Flop (didn't bet)
Seat 4: karanchawla09 (button) collected ($960)
Seat 5: PokerMessi (small blind) folded before Flop
Seat 6: slotmachine (big blind) folded on the River

PokerStars Hand #1922877785: Omaha Pot Limit ($200/$400 USD) - 2020/10/23 12:20:56 ET
Table 'ADA179504417' 6-max Seat #5 is the button
Seat 1: kaushal222 ($9309 in chips)
Seat 2: soundfsilenz ($90274 in chips)
Seat 3: TurnOnTuneInDropOut ($29400 in chips)
Seat 4: karanchawla09 ($19451 in chips)
Seat 5: PokerMessi ($91397 in chips)
Seat 6: slotmachine ($51471 in chips)
slotmachine: posts small blind $200
kaushal222: posts big blind $400
*** HOLE CARDS ***
Dealt to TurnOnTuneInDropOut [Qh 8h Ks 6d]
soundfsilenz: folds
TurnOnTuneInDropOut: folds
karanchawla09: calls $400
PokerMessi: folds
slotmachine: folds
kaushal222: checks
*** FLOP *** [Td 3d As]
kaushal222: checks
karanchawla09: checks
*** TURN *** [Td 3d As] [4h]
kaushal222: checks
karanchawla09: checks
*** RIVER *** [Td 3d As 4h] [4c]
kaushal222: bets $400
karanchawla09: calls $400
*** SHOW DOWN ***
kaushal222: shows [9c 4s 7h Ac]
karanchawla09: mucks hand
kaushal222 collected $1728 from pot
*** SUMMARY ***
Total pot $1800 | Rake $72
Board [Td 3d As 4h 4c]
Seat 1: kaushal222 (big blind) showed [9c 4s 7h Ac] and won ($1728)
Seat 2: soundfsilenz folded before Flop (didn't bet)
Seat 3: TurnOnTuneInDropOut folded before Flop (didn't bet)
Seat 4: karanchawla09 mucked
Seat 5: PokerMessi (button) folded before Flop (didn't bet)
Seat 6: slotmachine (small blind) folded before Flop

PokerStars Hand #1922877786: Omaha Pot Limit ($200/$400 USD) - 2020/10/23 12:22:38 ET
Table 'ADA179504417' 6-max Seat #6 is the button
Seat 1: kaushal222 ($10237 in chips)
Seat 2: soundfsilenz ($90274 in chips)
Seat 3: TurnOnTuneInDropOut ($29400 in chips)
Seat 4: karanchawla09 ($18651 in chips)
Seat 5: PokerMessi ($91397 in chips)
Seat 6: slotmachine ($51271 in chips)
kaushal222: posts small blind $200
soundfsilenz: posts big blind $400
*** HOLE CARDS ***
Dealt to TurnOnTuneInDropOut [Qh 8s Jd 2c]
TurnOnTuneInDropOut: folds
karanchawla09: calls $400
PokerMessi: folds
slotmachine: folds
kaushal222: calls $200
soundfsilenz: checks
*** FLOP *** [Ts 6s Qs]
kaushal222: checks
soundfsilenz: checks
karanchawla09: bets $1200
kaushal222: folds
soundfsilenz: folds
Uncalled bet ($1200) returned to karanchawla09
karanchawla09 collected $1152 from pot
karanchawla09: doesn't show hand
*** SUMMARY ***
Total pot $1200 | Rake $48
Board [Ts 6s Qs]
Seat 1: kaushal222 (small blind) folded on the Flop
Seat 2: soundfsilenz (big blind) folded on the Flop
Seat 3: TurnOnTuneInDropOut folded before Flop (didn't bet)
Seat 4: karanchawla09 collected ($1152)
Seat 5: PokerMessi folded before Flop (didn't bet)
Seat 6: slotmachine (button) folded before Flop (didn't bet)

PokerStars Hand #1922877864: Omaha Pot Limit ($200/$400 USD) - 2020/10/23 13:43:38 ET
Table 'ADA179504417' 6-max Seat #2 is the button
Seat 1: ag2703 ($87187 in chips)
Seat 2: MadMonkey ($12161 in chips)
Seat 3: kimjongun ($73123 in chips)
Seat 4: TurnOnTuneInDropOut ($30000 in chips)
Seat 5: soundfsilenz ($44947 in chips)
Seat 6: slotmachine ($72776 in chips)
kimjongun: posts small blind $200
TurnOnTuneInDropOut: posts big blind $400
*** HOLE CARDS ***
Dealt to TurnOnTuneInDropOut [5d 2c 2d 5h]
soundfsilenz: folds
slotmachine: folds
ag2703: folds
MadMonkey: folds
kimjongun: folds
Uncalled bet ($200) returned to TurnOnTuneInDropOut
TurnOnTuneInDropOut collected $400 from pot
TurnOnTuneInDropOut: doesn't show hand
*** SUMMARY ***
Total pot $400 | Rake $0
Seat 1: ag2703 folded before Flop (didn't bet)
Seat 2: MadMonkey (button) folded before Flop (didn't bet)
Seat 3: kimjongun (small blind) folded before Flop
Seat 4: TurnOnTuneInDropOut (big blind) collected ($400)
Seat 5: soundfsilenz folded before Flop (didn't bet)
Seat 6: slotmachine folded before Flop (didn't bet)

PokerStars Hand #1922877867: Omaha Pot Limit ($200/$400 USD) - 2020/10/23 13:45:50 ET
Table 'ADA179504417' 6-max Seat #5 is the button
Seat 1: ag2703 ($86387 in chips)
Seat 2: MadMonkey ($13857 in chips)
Seat 3: kimjongun ($73523 in chips)
Seat 4: TurnOnTuneInDropOut ($30000 in chips)
Seat 5: soundfsilenz ($43947 in chips)
Seat 6: slotmachine ($72376 in chips)
slotmachine: posts small blind $200
ag2703: posts big blind $400
*** HOLE CARDS ***
Dealt to TurnOnTuneInDropOut [Qh Kh 4d 6d]
MadMonkey: folds
kimjongun: folds
TurnOnTuneInDropOut: raises $1000 to $1400
soundfsilenz: raises $3400 to $4800
slotmachine: folds
ag2703: calls $4400
TurnOnTuneInDropOut: folds
*** FLOP *** [4c 4h 6c]
ag2703: checks
soundfsilenz: bets $7504
ag2703: folds
Uncalled bet ($7504) returned to soundfsilenz
soundfsilenz collected $10751 from pot
soundfsilenz: doesn't show hand
*** SUMMARY ***
Total pot $11200 | Rake $449
Board [4c 4h 6c]
Seat 1: ag2703 (big blind) folded on the Flop
Seat 2: MadMonkey folded before Flop (didn't bet)
Seat 3: kimjongun folded before Flop (didn't bet)
Seat 4: TurnOnTuneInDropOut folded before Flop
Seat 5: soundfsilenz (button) collected ($10751)
Seat 6: slotmachine (small blind) folded before Flop

PokerStars Hand #1922877868: Omaha Pot Limit ($200/$400 USD) - 2020/10/23 13:47:19 ET
Table 'ADA179504417' 6-max Seat #6 is the button
Seat 1: ag2703 ($81587 in chips)
Seat 2: MadMonkey ($13857 in chips)
Seat 3: kimjongun ($73523 in chips)
Seat 4: TurnOnTuneInDropOut ($28600 in chips)
Seat 5: soundfsilenz ($49898 in chips)
Seat 6: slotmachine ($72176 in chips)
ag2703: posts small blind $200
MadMonkey: posts big blind $400
*** HOLE CARDS ***
Dealt to TurnOnTuneInDropOut [8h 3d Ac 2h]
kimjongun: raises $600 to $1000
TurnOnTuneInDropOut: folds
soundfsilenz: folds
slotmachine: calls $1000
ag2703: calls $800
MadMonkey: calls $600
*** FLOP *** [Td Jh 6s]
ag2703: checks
MadMonkey: bets $400
kimjongun: calls $400
slotmachine: calls $400
ag2703: raises $5600 to $6000
MadMonkey: folds
kimjongun: folds
slotmachine: folds
Uncalled bet ($5600) returned to ag2703
ag2703: shows [Js 5s 5c Ah]
ag2703 collected $5375 from pot
*** SUMMARY ***
Total pot $5600 | Rake $225
Board [Td Jh 6s]
Seat 1: ag2703 (small blind) collected ($5375)
Seat 2: MadMonkey (big blind) folded on the Flop
Seat 3: kimjongun folded on the Flop
Seat 4: TurnOnTuneInDropOut folded before Flop (didn't bet)
Seat 5: soundfsilenz folded before Flop (didn't bet)
Seat 6: slotmachine (button) folded on the Flop

PokerStars Hand #1922877869: Omaha Pot Limit ($200/$400 USD) - 2020/10/23 13:48:54 ET
Table 'ADA179504417' 6-max Seat #1 is the button
Seat 1: ag2703 ($85562 in chips)
Seat 2: MadMonkey ($12457 in chips)
Seat 3: kimjongun ($72123 in chips)
Seat 4: TurnOnTuneInDropOut ($28600 in chips)
Seat 5: soundfsilenz ($49898 in chips)
Seat 6: slotmachine ($70776 in chips)
MadMonkey: posts small blind $200
kimjongun: posts big blind $400
*** HOLE CARDS ***
Dealt to TurnOnTuneInDropOut [Ac 5h 6d 8c]
TurnOnTuneInDropOut: folds
soundfsilenz: raises $1000 to $1400
slotmachine: folds
ag2703: folds
MadMonkey: calls $1200
kimjongun: calls $1000
*** FLOP *** [9c 5d Kh]
MadMonkey: bets $4200
kimjongun: folds
soundfsilenz: raises $8568 to $12768
MadMonkey: calls $6857 and is all-in
Uncalled bet ($1711) returned to soundfsilenz
*** TURN *** [9c 5d Kh] [Ad]
*** RIVER *** [9c 5d Kh Ad] [Jd]
*** SHOW DOWN ***
MadMonkey: shows [9h Qc 9s 3h]
soundfsilenz: shows [Ks Th Jh Ts]
MadMonkey collected $25514 from pot
*** SUMMARY ***
Total pot $26314 | Rake $800
Board [9c 5d Kh Ad Jd]
Seat 1: ag2703 (button) folded before Flop (didn't bet)
Seat 2: MadMonkey (small blind) showed [9h Qc 9s 3h] and won ($25514)
Seat 3: kimjongun (big blind) folded on the Flop
Seat 4: TurnOnTuneInDropOut folded before Flop (didn't bet)
Seat 5: soundfsilenz showed [Ks Th Jh Ts] and lost
Seat 6: slotmachine folded before Flop (didn't bet)

PokerStars Hand #1922877870: Omaha Pot Limit ($200/$400 USD) - 2020/10/23 13:49:50 ET
Table 'ADA179504417' 6-max Seat #2 is the button
Seat 1: ag2703 ($85562 in chips)
Seat 2: MadMonkey ($25514 in chips)
Seat 3: kimjongun ($70723 in chips)
Seat 4: TurnOnTuneInDropOut ($28600 in chips)
Seat 5: soundfsilenz ($37441 in chips)
Seat 6: slotmachine ($70776 in chips)
kimjongun: posts small blind $200
TurnOnTuneInDropOut: posts big blind $400
*** HOLE CARDS ***
Dealt to TurnOnTuneInDropOut [9c Ad Qd 7d]
soundfsilenz: raises $1000 to $1400
slotmachine: folds
ag2703: folds
MadMonkey: folds
kimjongun: folds
TurnOnTuneInDropOut: folds
Uncalled bet ($1000) returned to soundfsilenz
soundfsilenz collected $1000 from pot
soundfsilenz: doesn't show hand
*** SUMMARY ***
Total pot $1000 | Rake $0
Seat 1: ag2703 folded before Flop (didn't bet)
Seat 2: MadMonkey (button) folded before Flop (didn't bet)
Seat 3: kimjongun (small blind) folded before Flop
Seat 4: TurnOnTuneInDropOut (big blind) folded before Flop
Seat 5: soundfsilenz collected ($1000)
Seat 6: slotmachine folded before Flop (didn't bet)

PokerStars Hand #1922877873: Omaha Pot Limit ($200/$400 USD) - 2020/10/23 13:52:01 ET
Table 'ADA179504417' 6-max Seat #5 is the button
Seat 1: ag2703 ($83272 in chips)
Seat 2: MadMonkey ($25514 in chips)
Seat 3: kimjongun ($73720 in chips)
Seat 4: TurnOnTuneInDropOut ($28000 in chips)
Seat 5: soundfsilenz ($37441 in chips)
Seat 6: slotmachine ($70376 in chips)
slotmachine: posts small blind $200
ag2703: posts big blind $400
*** HOLE CARDS ***
Dealt to TurnOnTuneInDropOut [Th 3d Jc Td]
MadMonkey: folds
kimjongun: folds
TurnOnTuneInDropOut: folds
soundfsilenz: folds
slotmachine: folds
Uncalled bet ($200) returned to ag2703
ag2703 collected $400 from pot
ag2703: doesn't show hand
*** SUMMARY ***
Total pot $400 | Rake $0
Seat 1: ag2703 (big blind) collected ($400)
Seat 2: MadMonkey folded before Flop (didn't bet)
Seat 3: kimjongun folded before Flop (didn't bet)
Seat 4: TurnOnTuneInDropOut folded before Flop (didn't bet)
Seat 5: soundfsilenz (button) folded before Flop (didn't bet)
Seat 6: slotmachine (small blind) folded before Flop

PokerStars Hand #1922877874: Omaha Pot Limit ($200/$400 USD) - 2020/10/23 13:52:27 ET
Table 'ADA179504417' 6-max Seat #6 is the button
Seat 1: ag2703 ($83472 in chips)
Seat 2: MadMonkey ($25514 in chips)
Seat 3: kimjongun ($73720 in chips)
Seat 4: TurnOnTuneInDropOut ($28000 in chips)
Seat 5: soundfsilenz ($37441 in chips)
Seat 6: slotmachine ($70176 in chips)
ag2703: posts small blind $200
MadMonkey: posts big blind $400
*** HOLE CARDS ***
Dealt to TurnOnTuneInDropOut [Qs Jd Th 5d]
kimjongun: folds
TurnOnTuneInDropOut: folds
soundfsilenz: raises $1000 to $1400
slotmachine: folds
ag2703: folds
MadMonkey: folds
Uncalled bet ($1000) returned to soundfsilenz
soundfsilenz collected $1000 from pot
soundfsilenz: doesn't show hand
*** SUMMARY ***
Total pot $1000 | Rake $0
Seat 1: ag2703 (small blind) folded before Flop
Seat 2: MadMonkey (big blind) folded before Flop
Seat 3: kimjongun folded before Flop (didn't bet)
Seat 4: TurnOnTuneInDropOut folded before Flop (didn't bet)
Seat 5: soundfsilenz collected ($1000)
Seat 6: slotmachine (button) folded before Flop (didn't bet)

PokerStars Hand #1922877875: Omaha Pot Limit ($200/$400 USD) - 2020/10/23 13:53:01 ET
Table 'ADA179504417' 6-max Seat #1 is the button
Seat 1: ag2703 ($83272 in chips)
Seat 2: MadMonkey ($25114 in chips)
Seat 3: kimjongun ($73720 in chips)
Seat 4: TurnOnTuneInDropOut ($28000 in chips)
Seat 5: soundfsilenz ($38041 in chips)
Seat 6: slotmachine ($70176 in chips)
MadMonkey: posts small blind $200
kimjongun: posts big blind $400
*** HOLE CARDS ***
Dealt to TurnOnTuneInDropOut [Jh 4h Ah 3s]
TurnOnTuneInDropOut: folds
soundfsilenz: folds
slotmachine: folds
ag2703: calls $400
MadMonkey: calls $200
kimjongun: checks
*** FLOP *** [9d 8s 4c]
MadMonkey: bets $400
kimjongun: folds
ag2703: calls $400
*** TURN *** [9d 8s 4c] [3d]
MadMonkey: checks
ag2703: checks
*** RIVER *** [9d 8s 4c 3d] [Kc]
MadMonkey: checks
ag2703: bets $2000
MadMonkey: folds
Uncalled bet ($2000) returned to ag2703
ag2703 collected $1920 from pot
ag2703: doesn't show hand
*** SUMMARY ***
Total pot $2000 | Rake $80
Board [9d 8s 4c 3d Kc]
Seat 1: ag2703 (button) collected ($1920)
Seat 2: MadMonkey (small blind) folded on the River
Seat 3: kimjongun (big blind) folded on the Flop
Seat 4: TurnOnTuneInDropOut folded before Flop (didn't bet)
Seat 5: soundfsilenz folded before Flop (didn't bet)
Seat 6: slotmachine folded before Flop (didn't bet)

PokerStars Hand #1922877876: Omaha Pot Limit ($200/$400 USD) - 2020/10/23 13:54:15 ET
Table 'ADA179504417' 6-max Seat #2 is the button
Seat 1: ag2703 ($84392 in chips)
Seat 2: MadMonkey ($24314 in chips)
Seat 3: kimjongun ($73320 in chips)
Seat 4: TurnOnTuneInDropOut ($28000 in chips)
Seat 5: soundfsilenz ($38041 in chips)
Seat 6: slotmachine ($70176 in chips)
kimjongun: posts small blind $200
TurnOnTuneInDropOut: posts big blind $400
*** HOLE CARDS ***
Dealt to TurnOnTuneInDropOut [6c Td Ac 8h]
soundfsilenz: raises $1000 to $1400
slotmachine: folds
ag2703: folds
MadMonkey: folds
kimjongun: folds
TurnOnTuneInDropOut: calls $1000
*** FLOP *** [5d Qs Ks]
TurnOnTuneInDropOut: checks
soundfsilenz: bets $2010
TurnOnTuneInDropOut: folds
Uncalled bet ($2010) returned to soundfsilenz
soundfsilenz collected $2880 from pot
soundfsilenz: doesn't show hand
*** SUMMARY ***
Total pot $3000 | Rake $120
Board [5d Qs Ks]
Seat 1: ag2703 folded before Flop (didn't bet)
Seat 2: MadMonkey (button) folded before Flop (didn't bet)
Seat 3: kimjongun (small blind) folded before Flop
Seat 4: TurnOnTuneInDropOut (big blind) folded on the Flop
Seat 5: soundfsilenz collected ($2880)
Seat 6: slotmachine folded before Flop (didn't bet)

PokerStars Hand #1922877877: Omaha Pot Limit ($200/$400 USD) - 2020/10/23 13:55:04 ET
Table 'ADA179504417' 6-max Seat #3 is the button
Seat 1: ag2703 ($84392 in chips)
Seat 2: MadMonkey ($24314 in chips)
Seat 3: kimjongun ($73120 in chips)
Seat 4: TurnOnTuneInDropOut ($26600 in chips)
Seat 5: soundfsilenz ($39521 in chips)
Seat 6: slotmachine ($70176 in chips)
TurnOnTuneInDropOut: posts small blind $200
soundfsilenz: posts big blind $400
*** HOLE CARDS ***
Dealt to TurnOnTuneInDropOut [4c 7c Jh 3h]
slotmachine: folds
ag2703: folds
MadMonkey: folds
kimjongun: folds
TurnOnTuneInDropOut: folds
Uncalled bet ($200) returned to soundfsilenz
soundfsilenz collected $400 from pot
soundfsilenz: doesn't show hand
*** SUMMARY ***
Total pot $400 | Rake $0
Seat 1: ag2703 folded before Flop (didn't bet)
Seat 2: MadMonkey folded before Flop (didn't bet)
Seat 3: kimjongun (button) folded before Flop (didn't bet)
Seat 4: TurnOnTuneInDropOut (small blind) folded before Flop
Seat 5: soundfsilenz (big blind) collected ($400)
Seat 6: slotmachine folded before Flop (didn't bet)

PokerStars Hand #1922877879: Omaha Pot Limit ($200/$400 USD) - 2020/10/23 13:56:30 ET
Table 'ADA179504417' 6-max Seat #5 is the button
Seat 1: ag2703 ($82592 in chips)
Seat 2: MadMonkey ($24314 in chips)
Seat 3: kimjongun ($73120 in chips)
Seat 4: TurnOnTuneInDropOut ($28632 in chips)
Seat 5: soundfsilenz ($39521 in chips)
Seat 6: slotmachine ($69776 in chips)
slotmachine: posts small blind $200
ag2703: posts big blind $400
*** HOLE CARDS ***
Dealt to TurnOnTuneInDropOut [7h 3d Ts Jh]
MadMonkey: folds
kimjongun: folds
TurnOnTuneInDropOut: folds
soundfsilenz: folds
slotmachine: folds
Uncalled bet ($200) returned to ag2703
ag2703 collected $400 from pot
ag2703: doesn't show hand
*** SUMMARY ***
Total pot $400 | Rake $0
Seat 1: ag2703 (big blind) collected ($400)
Seat 2: MadMonkey folded before Flop (didn't bet)
Seat 3: kimjongun folded before Flop (didn't bet)
Seat 4: TurnOnTuneInDropOut folded before Flop (didn't bet)
Seat 5: soundfsilenz (button) folded before Flop (didn't bet)
Seat 6: slotmachine (small blind) folded before Flop

PokerStars Hand #1922877880: Omaha Pot Limit ($200/$400 USD) - 2020/10/23 13:56:56 ET
Table 'ADA179504417' 6-max Seat #6 is the button
Seat 1: ag2703 ($82792 in chips)
Seat 2: MadMonkey ($24314 in chips)
Seat 3: kimjongun ($73120 in chips)
Seat 4: TurnOnTuneInDropOut ($28632 in chips)
Seat 5: soundfsilenz ($39521 in chips)
Seat 6: slotmachine ($69576 in chips)
ag2703: posts small blind $200
MadMonkey: posts big blind $400
*** HOLE CARDS ***
Dealt to TurnOnTuneInDropOut [Ts As 6d 4d]
kimjongun: folds
TurnOnTuneInDropOut: raises $1000 to $1400
soundfsilenz: folds
slotmachine: folds
ag2703: calls $1200
MadMonkey: folds
*** FLOP *** [Kd Jh 7d]
ag2703: checks
TurnOnTuneInDropOut: checks
*** TURN *** [Kd Jh 7d] [4c]
ag2703: checks
TurnOnTuneInDropOut: checks
*** RIVER *** [Kd Jh 7d 4c] [5h]
ag2703: bets $3200
TurnOnTuneInDropOut: folds
Uncalled bet ($3200) returned to ag2703
ag2703: shows [6h Th Td Kc]
ag2703 collected $3072 from pot
*** SUMMARY ***
Total pot $3200 | Rake $128
Board [Kd Jh 7d 4c 5h]
Seat 1: ag2703 (small blind) collected ($3072)
Seat 2: MadMonkey (big blind) folded before Flop
Seat 3: kimjongun folded before Flop (didn't bet)
Seat 4: TurnOnTuneInDropOut folded on the River
Seat 5: soundfsilenz folded before Flop (didn't bet)
Seat 6: slotmachine (button) folded before Flop (didn't bet)

PokerStars Hand #1922877881: Omaha Pot Limit ($200/$400 USD) - 2020/10/23 13:58:19 ET
Table 'ADA179504417' 6-max Seat #1 is the button
Seat 1: ag2703 ($84464 in chips)
Seat 2: MadMonkey ($23914 in chips)
Seat 3: kimjongun ($73120 in chips)
Seat 4: TurnOnTuneInDropOut ($27232 in chips)
Seat 5: soundfsilenz ($39521 in chips)
Seat 6: slotmachine ($69576 in chips)
MadMonkey: posts small blind $200
kimjongun: posts big blind $400
*** HOLE CARDS ***
Dealt to TurnOnTuneInDropOut [6h Jh 2s As]
TurnOnTuneInDropOut: folds
soundfsilenz: folds
slotmachine: folds
ag2703: raises $1000 to $1400
MadMonkey: calls $1200
kimjongun: calls $1000
*** FLOP *** [6d 4s Js]
MadMonkey: bets $2100
kimjongun: calls $2100
ag2703: raises $10500 to $12600
MadMonkey: folds
kimjongun: folds
Uncalled bet ($10500) returned to ag2703
ag2703 collected $10079 from pot
ag2703: doesn't show hand
*** SUMMARY ***
Total pot $10500 | Rake $421
Board [6d 4s Js]
Seat 1: ag2703 (button) collected ($10079)
Seat 2: MadMonkey (small blind) folded on the Flop
Seat 3: kimjongun (big blind) folded on the Flop
Seat 4: TurnOnTuneInDropOut folded before Flop (didn't bet)
Seat 5: soundfsilenz folded before Flop (didn't bet)
Seat 6: slotmachine folded before Flop (didn't bet)

PokerStars Hand #1922877885: Omaha Pot Limit ($200/$400 USD) - 2020/10/23 14:02:09 ET
Table 'ADA179504417' 6-max Seat #5 is the button
Seat 1: ag2703 ($89803 in chips)
Seat 2: MadMonkey ($20414 in chips)
Seat 3: kimjongun ($71652 in chips)
Seat 4: TurnOnTuneInDropOut ($27232 in chips)
Seat 5: soundfsilenz ($38921 in chips)
Seat 6: slotmachine ($69176 in chips)
slotmachine: posts small blind $200
ag2703: posts big blind $400
*** HOLE CARDS ***
Dealt to TurnOnTuneInDropOut [3h Js 9h 3c]
MadMonkey: raises $400 to $800
kimjongun: raises $2200 to $3000
TurnOnTuneInDropOut: folds
soundfsilenz: folds
slotmachine: folds
ag2703: calls $2600
MadMonkey: calls $2200
*** FLOP *** [Jd 6d 6s]
ag2703: checks
MadMonkey: checks
kimjongun: bets $3220
ag2703: calls $3220
MadMonkey: folds
*** TURN *** [Jd 6d 6s] [Qs]
ag2703: checks
kimjongun: checks
*** RIVER *** [Jd 6d 6s Qs] [8s]
ag2703: checks
kimjongun: checks
*** SHOW DOWN ***
ag2703: shows [7d 7c Ad 4c]
kimjongun: mucks hand
ag2703 collected $15013 from pot
*** SUMMARY ***
Total pot $15640 | Rake $627
Board [Jd 6d 6s Qs 8s]
Seat 1: ag2703 (big blind) showed [7d 7c Ad 4c] and won ($15013)
Seat 2: MadMonkey folded on the Flop
Seat 3: kimjongun mucked
Seat 4: TurnOnTuneInDropOut folded before Flop (didn't bet)
Seat 5: soundfsilenz (button) folded before Flop (didn't bet)
Seat 6: slotmachine (small blind) folded before Flop

PokerStars Hand #1922877886: Omaha Pot Limit ($200/$400 USD) - 2020/10/23 14:02:55 ET
Table 'ADA179504417' 6-max Seat #6 is the button
Seat 1: ag2703 ($98596 in chips)
Seat 2: MadMonkey ($17414 in chips)
Seat 3: kimjongun ($65432 in chips)
Seat 4: TurnOnTuneInDropOut ($27232 in chips)
Seat 5: soundfsilenz ($38921 in chips)
Seat 6: slotmachine ($68976 in chips)
ag2703: posts small blind $200
MadMonkey: posts big blind $400
*** HOLE CARDS ***
Dealt to TurnOnTuneInDropOut [Ts 6d Ad Th]
kimjongun: folds
TurnOnTuneInDropOut: raises $1000 to $1400
soundfsilenz: folds
slotmachine: calls $1400
ag2703: calls $1200
MadMonkey: folds
*** FLOP *** [Tc 4h 9s]
ag2703: checks
TurnOnTuneInDropOut: bets $4050
slotmachine: folds
ag2703: folds
Uncalled bet ($4050) returned to TurnOnTuneInDropOut
TurnOnTuneInDropOut collected $4416 from pot
TurnOnTuneInDropOut: doesn't show hand
*** SUMMARY ***
Total pot $4600 | Rake $184
Board [Tc 4h 9s]
Seat 1: ag2703 (small blind) folded on the Flop
Seat 2: MadMonkey (big blind) folded before Flop
Seat 3: kimjongun folded before Flop (didn't bet)
Seat 4: TurnOnTuneInDropOut collected ($4416)
Seat 5: soundfsilenz folded before Flop (didn't bet)
Seat 6: slotmachine (button) folded on the Flop

PokerStars Hand #1922877887: Omaha Pot Limit ($200/$400 USD) - 2020/10/23 14:03:44 ET
Table 'ADA179504417' 6-max Seat #1 is the button
Seat 1: ag2703 ($97196 in chips)
Seat 2: MadMonkey ($17014 in chips)
Seat 3: kimjongun ($65432 in chips)
Seat 4: TurnOnTuneInDropOut ($30248 in chips)
Seat 5: soundfsilenz ($38921 in chips)
Seat 6: slotmachine ($67576 in chips)
MadMonkey: posts small blind $200
kimjongun: posts big blind $400
*** HOLE CARDS ***
Dealt to TurnOnTuneInDropOut [5d 4d 9h 9c]
TurnOnTuneInDropOut: folds
soundfsilenz: folds
slotmachine: raises $1000 to $1400
ag2703: calls $1400
MadMonkey: folds
kimjongun: raises $4400 to $5800
slotmachine: calls $4400
ag2703: calls $4400
*** FLOP *** [Kc Th 7c]
kimjongun: checks
slotmachine: bets $11616
ag2703: calls $11616
kimjongun: folds
*** TURN *** [Kc Th 7c] [5s]
slotmachine: bets $33424
ag2703: folds
Uncalled bet ($33424) returned to slotmachine
slotmachine collected $40032 from pot
slotmachine: doesn't show hand
*** SUMMARY ***
Total pot $40832 | Rake $800
Board [Kc Th 7c 5s]
Seat 1: ag2703 (button) folded on the Turn
Seat 2: MadMonkey (small blind) folded before Flop
Seat 3: kimjongun (big blind) folded on the Flop
Seat 4: TurnOnTuneInDropOut folded before Flop (didn't bet)
Seat 5: soundfsilenz folded before Flop (didn't bet)
Seat 6: slotmachine collected ($40032)

PokerStars Hand #1922877894: Omaha Pot Limit ($200/$400 USD) - 2020/10/23 14:11:04 ET
Table 'ADA179504417' 6-max Seat #3 is the button
Seat 1: ag2703 ($78190 in chips)
Seat 2: MadMonkey ($16774 in chips)
Seat 3: kimjongun ($63801 in chips)
Seat 4: TurnOnTuneInDropOut ($29848 in chips)
Seat 5: soundfsilenz ($37521 in chips)
Seat 6: slotmachine ($88800 in chips)
TurnOnTuneInDropOut: posts small blind $200
soundfsilenz: posts big blind $400
*** HOLE CARDS ***
Dealt to TurnOnTuneInDropOut [9d 9h 9s Ad]
slotmachine: raises $1000 to $1400
ag2703: folds
MadMonkey: calls $1400
kimjongun: calls $1400
TurnOnTuneInDropOut: folds
soundfsilenz: folds
*** FLOP *** [8c 2c Js]
slotmachine: checks
MadMonkey: checks
kimjongun: bets $2400
slotmachine: folds
MadMonkey: folds
Uncalled bet ($2400) returned to kimjongun
kimjongun collected $4608 from pot
kimjongun: doesn't show hand
*** SUMMARY ***
Total pot $4800 | Rake $192
Board [8c 2c Js]
Seat 1: ag2703 folded before Flop (didn't bet)
Seat 2: MadMonkey folded on the Flop
Seat 3: kimjongun (button) collected ($4608)
Seat 4: TurnOnTuneInDropOut (small blind) folded before Flop
Seat 5: soundfsilenz (big blind) folded before Flop
Seat 6: slotmachine folded on the Flop

PokerStars Hand #1922877896: Omaha Pot Limit ($200/$400 USD) - 2020/10/23 14:13:26 ET
Table 'ADA179504417' 6-max Seat #5 is the button
Seat 1: ag2703 ($72190 in chips)
Seat 2: MadMonkey ($21469 in chips)
Seat 3: kimjongun ($67009 in chips)
Seat 4: TurnOnTuneInDropOut ($29648 in chips)
Seat 5: soundfsilenz ($36921 in chips)
Seat 6: slotmachine ($87000 in chips)
slotmachine: posts small blind $200
ag2703: posts big blind $400
*** HOLE CARDS ***
Dealt to TurnOnTuneInDropOut [Kh 4s 3c As]
MadMonkey: folds
kimjongun: folds
TurnOnTuneInDropOut: raises $1000 to $1400
soundfsilenz: calls $1400
slotmachine: folds
ag2703: calls $1000
*** FLOP *** [9h Ad Qh]
ag2703: checks
TurnOnTuneInDropOut: bets $2904
soundfsilenz: calls $2904
ag2703: calls $2904
*** TURN *** [9h Ad Qh] [Jd]
ag2703: checks
TurnOnTuneInDropOut: checks
soundfsilenz: checks
*** RIVER *** [9h Ad Qh Jd] [7s]
ag2703: checks
TurnOnTuneInDropOut: checks
soundfsilenz: checks
*** SHOW DOWN ***
ag2703: shows [Ac 5d Qd 5s]
soundfsilenz: mucks hand
ag2703 collected $12586 from pot
*** SUMMARY ***
Total pot $13112 | Rake $526
Board [9h Ad Qh Jd 7s]
Seat 1: ag2703 (big blind) showed [Ac 5d Qd 5s] and won ($12586)
Seat 2: MadMonkey folded before Flop (didn't bet)
Seat 3: kimjongun folded before Flop (didn't bet)
Seat 4: TurnOnTuneInDropOut
Seat 5: soundfsilenz (button) mucked
Seat 6: slotmachine (small blind) folded before Flop

PokerStars Hand #1922877897: Omaha Pot Limit ($200/$400 USD) - 2020/10/23 14:15:12 ET
Table 'ADA179504417' 6-max Seat #6 is the button
Seat 1: ag2703 ($80472 in chips)
Seat 2: MadMonkey ($21469 in chips)
Seat 3: kimjongun ($67009 in chips)
Seat 4: TurnOnTuneInDropOut ($25344 in chips)
Seat 5: soundfsilenz ($32617 in chips)
Seat 6: slotmachine ($86800 in chips)
ag2703: posts small blind $200
MadMonkey: posts big blind $400
*** HOLE CARDS ***
Dealt to TurnOnTuneInDropOut [4d 7s 4h Jd]
kimjongun: folds
TurnOnTuneInDropOut: folds
soundfsilenz: raises $1000 to $1400
slotmachine: folds
ag2703: folds
MadMonkey: folds
Uncalled bet ($1000) returned to soundfsilenz
soundfsilenz collected $1000 from pot
soundfsilenz: doesn't show hand
*** SUMMARY ***
Total pot $1000 | Rake $0
Seat 1: ag2703 (small blind) folded before Flop
Seat 2: MadMonkey (big blind) folded before Flop
Seat 3: kimjongun folded before Flop (didn't bet)
Seat 4: TurnOnTuneInDropOut folded before Flop (didn't bet)
Seat 5: soundfsilenz collected ($1000)
Seat 6: slotmachine (button) folded before Flop (didn't bet)

PokerStars Hand #1922877898: Omaha Pot Limit ($200/$400 USD) - 2020/10/23 14:15:58 ET
Table 'ADA179504417' 6-max Seat #1 is the button
Seat 1: ag2703 ($80272 in chips)
Seat 2: MadMonkey ($21069 in chips)
Seat 3: kimjongun ($67009 in chips)
Seat 4: TurnOnTuneInDropOut ($48000 in chips)
Seat 5: soundfsilenz ($33217 in chips)
Seat 6: slotmachine ($86800 in chips)
MadMonkey: posts small blind $200
kimjongun: posts big blind $400
*** HOLE CARDS ***
Dealt to TurnOnTuneInDropOut [Kc Qc Jh Qh]
TurnOnTuneInDropOut: raises $1000 to $1400
soundfsilenz: folds
slotmachine: calls $1400
ag2703: folds
MadMonkey: folds
kimjongun: folds
*** FLOP *** [9h Kd 7h]
TurnOnTuneInDropOut: checks
slotmachine: bets $3400
TurnOnTuneInDropOut: calls $3400
*** TURN *** [9h Kd 7h] [Js]
TurnOnTuneInDropOut: checks
slotmachine: bets $5100
TurnOnTuneInDropOut: raises $13425 to $18525
slotmachine: calls $13425
*** RIVER *** [9h Kd 7h Js] [7d]
TurnOnTuneInDropOut: checks
slotmachine: bets $35438
TurnOnTuneInDropOut: folds
Uncalled bet ($35438) returned to slotmachine
slotmachine collected $46450 from pot
slotmachine: doesn't show hand
*** SUMMARY ***
Total pot $47250 | Rake $800
Board [9h Kd 7h Js 7d]
Seat 1: ag2703 (button) folded before Flop (didn't bet)
Seat 2: MadMonkey (small blind) folded before Flop
Seat 3: kimjongun (big blind) folded before Flop
Seat 4: TurnOnTuneInDropOut folded on the River
Seat 5: soundfsilenz folded before Flop (didn't bet)
Seat 6: slotmachine collected ($46450)

PokerStars Hand #1922877904: Omaha Pot Limit ($200/$400 USD) - 2020/10/23 14:23:44 ET
Table 'ADA179504417' 6-max Seat #2 is the button
Seat 1: ag2703 ($74572 in chips)
Seat 2: MadMonkey ($25040 in chips)
Seat 3: kimjongun ($66009 in chips)
Seat 4: TurnOnTuneInDropOut ($48000 in chips)
Seat 5: soundfsilenz ($35376 in chips)
Seat 6: slotmachine ($109325 in chips)
kimjongun: posts small blind $200
TurnOnTuneInDropOut: posts big blind $400
*** HOLE CARDS ***
Dealt to TurnOnTuneInDropOut [5h Tc As Js]
soundfsilenz: folds
slotmachine: raises $1000 to $1400
ag2703: folds
MadMonkey: calls $1400
kimjongun: folds
TurnOnTuneInDropOut: calls $1000
*** FLOP *** [3s 6c Qc]
TurnOnTuneInDropOut: checks
slotmachine: checks
MadMonkey: checks
*** TURN *** [3s 6c Qc] [2c]
TurnOnTuneInDropOut: checks
slotmachine: checks
MadMonkey: checks
*** RIVER *** [3s 6c Qc 2c] [Kc]
TurnOnTuneInDropOut: checks
slotmachine: checks
MadMonkey: checks
*** SHOW DOWN ***
slotmachine: mucks hand
MadMonkey: shows [Ks 7c 7d Kd]
MadMonkey collected $4224 from pot
*** SUMMARY ***
Total pot $4400 | Rake $176
Board [3s 6c Qc 2c Kc]
Seat 1: ag2703 folded before Flop (didn't bet)
Seat 2: MadMonkey (button) showed [Ks 7c 7d Kd] and won ($4224)
Seat 3: kimjongun (small blind) folded before Flop
Seat 4: TurnOnTuneInDropOut (big blind)
Seat 5: soundfsilenz folded before Flop (didn't bet)
Seat 6: slotmachine mucked

PokerStars Hand #1922877906: Omaha Pot Limit ($200/$400 USD) - 2020/10/23 14:26:23 ET
Table 'ADA179504417' 6-max Seat #4 is the button
Seat 1: ag2703 ($75132 in chips)
Seat 3: kimjongun ($65809 in chips)
Seat 4: TurnOnTuneInDropOut ($46400 in chips)
Seat 5: soundfsilenz ($34976 in chips)
Seat 6: slotmachine ($107925 in chips)
soundfsilenz: posts small blind $200
slotmachine: posts big blind $400
*** HOLE CARDS ***
Dealt to TurnOnTuneInDropOut [9s 9c Th Tc]
ag2703: raises $400 to $800
kimjongun: folds
TurnOnTuneInDropOut: raises $2200 to $3000
soundfsilenz: folds
slotmachine: folds
ag2703: calls $2200
*** FLOP *** [7h 2s Kh]
ag2703: checks
TurnOnTuneInDropOut: bets $3300
ag2703: calls $3300
*** TURN *** [7h 2s Kh] [Td]
ag2703: checks
TurnOnTuneInDropOut: bets $13200
ag2703: folds
Uncalled bet ($13200) returned to TurnOnTuneInDropOut
TurnOnTuneInDropOut collected $12671 from pot
TurnOnTuneInDropOut: doesn't show hand
*** SUMMARY ***
Total pot $13200 | Rake $529
Board [7h 2s Kh Td]
Seat 1: ag2703 folded on the Turn
Seat 3: kimjongun folded before Flop (didn't bet)
Seat 4: TurnOnTuneInDropOut (button) collected ($12671)
Seat 5: soundfsilenz (small blind) folded before Flop
Seat 6: slotmachine (big blind) folded before Flop

PokerStars Hand #1922877907: Omaha Pot Limit ($200/$400 USD) - 2020/10/23 14:27:24 ET
Table 'ADA179504417' 6-max Seat #5 is the button
Seat 1: ag2703 ($68832 in chips)
Seat 4: TurnOnTuneInDropOut ($52771 in chips)
Seat 5: soundfsilenz ($34776 in chips)
Seat 6: slotmachine ($107525 in chips)
slotmachine: posts small blind $200
ag2703: posts big blind $400
*** HOLE CARDS ***
Dealt to TurnOnTuneInDropOut [8c 4d 8s Tc]
TurnOnTuneInDropOut: folds
soundfsilenz: folds
slotmachine: raises $800 to $1200
ag2703: calls $800
*** FLOP *** [8d 6c 7h]
slotmachine: checks
ag2703: bets $2400
slotmachine: folds
Uncalled bet ($2400) returned to ag2703
ag2703 collected $2304 from pot
ag2703: doesn't show hand
*** SUMMARY ***
Total pot $2400 | Rake $96
Board [8d 6c 7h]
Seat 1: ag2703 (big blind) collected ($2304)
Seat 4: TurnOnTuneInDropOut folded before Flop (didn't bet)
Seat 5: soundfsilenz (button) folded before Flop (didn't bet)
Seat 6: slotmachine (small blind) folded on the Flop

PokerStars Hand #1922877908: Omaha Pot Limit ($200/$400 USD) - 2020/10/23 14:28:02 ET
Table 'ADA179504417' 6-max Seat #6 is the button
Seat 1: ag2703 ($69936 in chips)
Seat 2: CarlJung ($12000 in chips)
Seat 4: TurnOnTuneInDropOut ($52771 in chips)
Seat 5: soundfsilenz ($34776 in chips)
Seat 6: slotmachine ($106325 in chips)
ag2703: posts small blind $200
CarlJung: posts big blind $400
*** HOLE CARDS ***
Dealt to TurnOnTuneInDropOut [8h 9c 3c 3s]
TurnOnTuneInDropOut: folds
soundfsilenz: folds
slotmachine: raises $1000 to $1400
ag2703: folds
CarlJung: calls $1000
*** FLOP *** [8d 6h 9s]
CarlJung: checks
slotmachine: bets $1980
CarlJung: folds
Uncalled bet ($1980) returned to slotmachine
slotmachine collected $2880 from pot
slotmachine: doesn't show hand
*** SUMMARY ***
Total pot $3000 | Rake $120
Board [8d 6h 9s]
Seat 1: ag2703 (small blind) folded before Flop
Seat 2: CarlJung (big blind) folded on the Flop
Seat 4: TurnOnTuneInDropOut folded before Flop (didn't bet)
Seat 5: soundfsilenz folded before Flop (didn't bet)
Seat 6: slotmachine (button) collected ($2880)

PokerStars Hand #1922877909: Omaha Pot Limit ($200/$400 USD) - 2020/10/23 14:28:45 ET
Table 'ADA179504417' 6-max Seat #1 is the button
Seat 1: ag2703 ($69736 in chips)
Seat 2: CarlJung ($10600 in chips)
Seat 3: kimjongun ($65809 in chips)
Seat 4: TurnOnTuneInDropOut ($52771 in chips)
Seat 5: soundfsilenz ($34776 in chips)
Seat 6: slotmachine ($107805 in chips)
CarlJung: posts small blind $200
kimjongun: posts big blind $400
*** HOLE CARDS ***
Dealt to TurnOnTuneInDropOut [As 9s Kh Ah]
TurnOnTuneInDropOut: raises $1000 to $1400
soundfsilenz: folds
slotmachine: folds
ag2703: calls $1400
CarlJung: folds
kimjongun: folds
*** FLOP *** [Jc Ad 3h]
TurnOnTuneInDropOut: bets $2550
ag2703: folds
Uncalled bet ($2550) returned to TurnOnTuneInDropOut
TurnOnTuneInDropOut collected $3264 from pot
TurnOnTuneInDropOut: doesn't show hand
*** SUMMARY ***
Total pot $3400 | Rake $136
Board [Jc Ad 3h]
Seat 1: ag2703 (button) folded on the Flop
Seat 2: CarlJung (small blind) folded before Flop
Seat 3: kimjongun (big blind) folded before Flop
Seat 4: TurnOnTuneInDropOut collected ($3264)
Seat 5: soundfsilenz folded before Flop (didn't bet)
Seat 6: slotmachine folded before Flop (didn't bet)

PokerStars Hand #1922877910: Omaha Pot Limit ($200/$400 USD) - 2020/10/23 14:29:30 ET
Table 'ADA179504417' 6-max Seat #2 is the button
Seat 1: ag2703 ($68336 in chips)
Seat 2: CarlJung ($10400 in chips)
Seat 3: kimjongun ($65409 in chips)
Seat 4: TurnOnTuneInDropOut ($54635 in chips)
Seat 5: soundfsilenz ($34776 in chips)
Seat 6: slotmachine ($107805 in chips)
kimjongun: posts small blind $200
TurnOnTuneInDropOut: posts big blind $400
*** HOLE CARDS ***
Dealt to TurnOnTuneInDropOut [2d Ts 9h Td]
soundfsilenz: folds
slotmachine: raises $1000 to $1400
ag2703: folds
CarlJung: folds
kimjongun: folds
TurnOnTuneInDropOut: folds
Uncalled bet ($1000) returned to slotmachine
slotmachine collected $1000 from pot
slotmachine: doesn't show hand
*** SUMMARY ***
Total pot $1000 | Rake $0
Seat 1: ag2703 folded before Flop (didn't bet)
Seat 2: CarlJung (button) folded before Flop (didn't bet)
Seat 3: kimjongun (small blind) folded before Flop
Seat 4: TurnOnTuneInDropOut (big blind) folded before Flop
Seat 5: soundfsilenz folded before Flop (didn't bet)
Seat 6: slotmachine collected ($1000)

PokerStars Hand #1922877911: Omaha Pot Limit ($200/$400 USD) - 2020/10/23 14:30:03 ET
Table 'ADA179504417' 6-max Seat #3 is the button
Seat 1: ag2703 ($68336 in chips)
Seat 2: CarlJung ($10400 in chips)
Seat 3: kimjongun ($65209 in chips)
Seat 4: TurnOnTuneInDropOut ($54235 in chips)
Seat 5: soundfsilenz ($34776 in chips)
Seat 6: slotmachine ($108405 in chips)
TurnOnTuneInDropOut: posts small blind $200
soundfsilenz: posts big blind $400
*** HOLE CARDS ***
Dealt to TurnOnTuneInDropOut [2h 2d 4d 8s]
slotmachine: raises $1000 to $1400
ag2703: folds
CarlJung: folds
kimjongun: folds
TurnOnTuneInDropOut: folds
soundfsilenz: folds
Uncalled bet ($1000) returned to slotmachine
slotmachine collected $1000 from pot
slotmachine: doesn't show hand
*** SUMMARY ***
Total pot $1000 | Rake $0
Seat 1: ag2703 folded before Flop (didn't bet)
Seat 2: CarlJung folded before Flop (didn't bet)
Seat 3: kimjongun (button) folded before Flop (didn't bet)
Seat 4: TurnOnTuneInDropOut (small blind) folded before Flop
Seat 5: soundfsilenz (big blind) folded before Flop
Seat 6: slotmachine collected ($1000)

PokerStars Hand #1922877913: Omaha Pot Limit ($200/$400 USD) - 2020/10/23 14:31:55 ET
Table 'ADA179504417' 6-max Seat #5 is the button
Seat 1: ag2703 ($66536 in chips)
Seat 2: CarlJung ($10400 in chips)
Seat 3: kimjongun ($65209 in chips)
Seat 4: TurnOnTuneInDropOut ($56267 in chips)
Seat 5: soundfsilenz ($34176 in chips)
Seat 6: slotmachine ($108605 in chips)
slotmachine: posts small blind $200
ag2703: posts big blind $400
*** HOLE CARDS ***
Dealt to TurnOnTuneInDropOut [7s 8d 6c 4d]
CarlJung: folds
kimjongun: folds
TurnOnTuneInDropOut: folds
soundfsilenz: raises $1000 to $1400
slotmachine: folds
ag2703: calls $1000
*** FLOP *** [Qs 7h 8h]
ag2703: checks
soundfsilenz: bets $2010
ag2703: calls $2010
*** TURN *** [Qs 7h 8h] [Qc]
ag2703: checks
soundfsilenz: checks
*** RIVER *** [Qs 7h 8h Qc] [9c]
ag2703: bets $7020
soundfsilenz: folds
Uncalled bet ($7020) returned to ag2703
ag2703 collected $6738 from pot
ag2703: doesn't show hand
*** SUMMARY ***
Total pot $7020 | Rake $282
Board [Qs 7h 8h Qc 9c]
Seat 1: ag2703 (big blind) collected ($6738)
Seat 2: CarlJung folded before Flop (didn't bet)
Seat 3: kimjongun folded before Flop (didn't bet)
Seat 4: TurnOnTuneInDropOut folded before Flop (didn't bet)
Seat 5: soundfsilenz (button) folded on the River
Seat 6: slotmachine (small blind) folded before Flop

PokerStars Hand #1922877914: Omaha Pot Limit ($200/$400 USD) - 2020/10/23 14:33:32 ET
Table 'ADA179504417' 6-max Seat #6 is the button
Seat 1: ag2703 ($69864 in chips)
Seat 2: CarlJung ($10400 in chips)
Seat 3: kimjongun ($65209 in chips)
Seat 4: TurnOnTuneInDropOut ($56267 in chips)
Seat 5: soundfsilenz ($30766 in chips)
Seat 6: slotmachine ($108405 in chips)
ag2703: posts small blind $200
CarlJung: posts big blind $400
*** HOLE CARDS ***
Dealt to TurnOnTuneInDropOut [5d 5s 8h Ad]
kimjongun: folds
TurnOnTuneInDropOut: folds
soundfsilenz: folds
slotmachine: raises $1000 to $1400
ag2703: folds
CarlJung: calls $1000
*** FLOP *** [Td 6h Ac]
CarlJung: checks
slotmachine: checks
*** TURN *** [Td 6h Ac] [Ah]
CarlJung: checks
slotmachine: checks
*** RIVER *** [Td 6h Ac Ah] [4h]
CarlJung: bets $1590
slotmachine: folds
Uncalled bet ($1590) returned to CarlJung
CarlJung collected $2880 from pot
CarlJung: doesn't show hand
*** SUMMARY ***
Total pot $3000 | Rake $120
Board [Td 6h Ac Ah 4h]
Seat 1: ag2703 (small blind) folded before Flop
Seat 2: CarlJung (big blind) collected ($2880)
Seat 3: kimjongun folded before Flop (didn't bet)
Seat 4: TurnOnTuneInDropOut folded before Flop (didn't bet)
Seat 5: soundfsilenz folded before Flop (didn't bet)
Seat 6: slotmachine (button) folded on the River

PokerStars Hand #1922877915: Omaha Pot Limit ($200/$400 USD) - 2020/10/23 14:34:49 ET
Table 'ADA179504417' 6-max Seat #1 is the button
Seat 1: ag2703 ($69664 in chips)
Seat 2: CarlJung ($11880 in chips)
Seat 3: kimjongun ($65209 in chips)
Seat 4: TurnOnTuneInDropOut ($56267 in chips)
Seat 5: soundfsilenz ($30766 in chips)
Seat 6: slotmachine ($107005 in chips)
CarlJung: posts small blind $200
kimjongun: posts big blind $400
*** HOLE CARDS ***
Dealt to TurnOnTuneInDropOut [Kc As Jh 3h]
TurnOnTuneInDropOut: folds
soundfsilenz: folds
slotmachine: folds
ag2703: raises $1000 to $1400
CarlJung: folds
kimjongun: folds
Uncalled bet ($1000) returned to ag2703
ag2703 collected $1000 from pot
ag2703: doesn't show hand
*** SUMMARY ***
Total pot $1000 | Rake $0
Seat 1: ag2703 (button) collected ($1000)
Seat 2: CarlJung (small blind) folded before Flop
Seat 3: kimjongun (big blind) folded before Flop
Seat 4: TurnOnTuneInDropOut folded before Flop (didn't bet)
Seat 5: soundfsilenz folded before Flop (didn't bet)
Seat 6: slotmachine folded before Flop (didn't bet)

PokerStars Hand #1922877916: Omaha Pot Limit ($200/$400 USD) - 2020/10/23 14:35:23 ET
Table 'ADA179504417' 6-max Seat #2 is the button
Seat 1: ag2703 ($70264 in chips)
Seat 2: CarlJung ($11680 in chips)
Seat 3: kimjongun ($64809 in chips)
Seat 4: TurnOnTuneInDropOut ($56267 in chips)
Seat 5: soundfsilenz ($30766 in chips)
Seat 6: slotmachine ($107005 in chips)
kimjongun: posts small blind $200
TurnOnTuneInDropOut: posts big blind $400
*** HOLE CARDS ***
Dealt to TurnOnTuneInDropOut [8h Ks Jc Th]
soundfsilenz: raises $1000 to $1400
slotmachine: calls $1400
ag2703: folds
CarlJung: folds
kimjongun: folds
TurnOnTuneInDropOut: folds
*** FLOP *** [Ts 6d 9d]
soundfsilenz: checks
slotmachine: bets $1700
soundfsilenz: folds
Uncalled bet ($1700) returned to slotmachine
slotmachine collected $3264 from pot
slotmachine: doesn't show hand
*** SUMMARY ***
Total pot $3400 | Rake $136
Board [Ts 6d 9d]
Seat 1: ag2703 folded before Flop (didn't bet)
Seat 2: CarlJung (button) folded before Flop (didn't bet)
Seat 3: kimjongun (small blind) folded before Flop
Seat 4: TurnOnTuneInDropOut (big blind) folded before Flop
Seat 5: soundfsilenz folded on the Flop
Seat 6: slotmachine collected ($3264)

PokerStars Hand #1922877918: Omaha Pot Limit ($200/$400 USD) - 2020/10/23 14:38:18 ET
Table 'ADA179504417' 6-max Seat #4 is the button
Seat 1: ag2703 ($69864 in chips)
Seat 2: CarlJung ($11680 in chips)
Seat 3: kimjongun ($64609 in chips)
Seat 4: TurnOnTuneInDropOut ($55667 in chips)
Seat 5: soundfsilenz ($29926 in chips)
Seat 6: slotmachine ($108869 in chips)
soundfsilenz: posts small blind $200
slotmachine: posts big blind $400
*** HOLE CARDS ***
Dealt to TurnOnTuneInDropOut [Ah 5c 5d 9h]
ag2703: raises $1000 to $1400
CarlJung: folds
kimjongun: folds
TurnOnTuneInDropOut: folds
soundfsilenz: calls $1200
slotmachine: folds
*** FLOP *** [Kh Qs Th]
soundfsilenz: checks
ag2703: checks
*** TURN *** [Kh Qs Th] [Qd]
soundfsilenz: bets $1728
ag2703: calls $1728
*** RIVER *** [Kh Qs Th Qd] [4h]
soundfsilenz: checks
ag2703: bets $6656
soundfsilenz: folds
Uncalled bet ($6656) returned to ag2703
ag2703 collected $6389 from pot
ag2703: doesn't show hand
*** SUMMARY ***
Total pot $6656 | Rake $267
Board [Kh Qs Th Qd 4h]
Seat 1: ag2703 collected ($6389)
Seat 2: CarlJung folded before Flop (didn't bet)
Seat 3: kimjongun folded before Flop (didn't bet)
Seat 4: TurnOnTuneInDropOut (button) folded before Flop (didn't bet)
Seat 5: soundfsilenz (small blind) folded on the River
Seat 6: slotmachine (big blind) folded before Flop

PokerStars Hand #1922877919: Omaha Pot Limit ($200/$400 USD) - 2020/10/23 14:39:56 ET
Table 'ADA179504417' 6-max Seat #5 is the button
Seat 1: ag2703 ($73125 in chips)
Seat 2: CarlJung ($11680 in chips)
Seat 3: kimjongun ($64609 in chips)
Seat 4: TurnOnTuneInDropOut ($55667 in chips)
Seat 5: soundfsilenz ($26798 in chips)
Seat 6: slotmachine ($108469 in chips)
slotmachine: posts small blind $200
ag2703: posts big blind $400
*** HOLE CARDS ***
Dealt to TurnOnTuneInDropOut [Th 2d 8c 7c]
CarlJung: raises $1000 to $1400
kimjongun: folds
TurnOnTuneInDropOut: folds
soundfsilenz: folds
slotmachine: folds
ag2703: folds
Uncalled bet ($1000) returned to CarlJung
CarlJung collected $1000 from pot
CarlJung: doesn't show hand
*** SUMMARY ***
Total pot $1000 | Rake $0
Seat 1: ag2703 (big blind) folded before Flop
Seat 2: CarlJung collected ($1000)
Seat 3: kimjongun folded before Flop (didn't bet)
Seat 4: TurnOnTuneInDropOut folded before Flop (didn't bet)
Seat 5: soundfsilenz (button) folded before Flop (didn't bet)
Seat 6: slotmachine (small blind) folded before Flop

PokerStars Hand #1922877920: Omaha Pot Limit ($200/$400 USD) - 2020/10/23 14:40:29 ET
Table 'ADA179504417' 6-max Seat #6 is the button
Seat 1: ag2703 ($72725 in chips)
Seat 2: CarlJung ($12280 in chips)
Seat 3: kimjongun ($64609 in chips)
Seat 4: TurnOnTuneInDropOut ($55667 in chips)
Seat 5: soundfsilenz ($26798 in chips)
Seat 6: slotmachine ($108269 in chips)
ag2703: posts small blind $200
CarlJung: posts big blind $400
*** HOLE CARDS ***
Dealt to TurnOnTuneInDropOut [9c 4h Ts 8c]
kimjongun: raises $600 to $1000
TurnOnTuneInDropOut: folds
soundfsilenz: folds
slotmachine: raises $2600 to $3600
ag2703: calls $3400
CarlJung: folds
kimjongun: calls $2600
*** FLOP *** [9s 7c 7d]
ag2703: checks
kimjongun: checks
slotmachine: bets $3696
ag2703: folds
kimjongun: raises $10015 to $13711
slotmachine: calls $10015
*** TURN *** [9s 7c 7d] [8s]
kimjongun: bets $13518
slotmachine: calls $13518
*** RIVER *** [9s 7c 7d 8s] [8h]
kimjongun: bets $33780 and is all-in
slotmachine: folds
Uncalled bet ($33780) returned to kimjongun
kimjongun collected $64858 from pot
kimjongun: doesn't show hand
*** SUMMARY ***
Total pot $65658 | Rake $800
Board [9s 7c 7d 8s 8h]
Seat 1: ag2703 (small blind) folded on the Flop
Seat 2: CarlJung (big blind) folded before Flop
Seat 3: kimjongun collected ($64858)
Seat 4: TurnOnTuneInDropOut folded before Flop (didn't bet)
Seat 5: soundfsilenz folded before Flop (didn't bet)
Seat 6: slotmachine (button) folded on the River

PokerStars Hand #1922877921: Omaha Pot Limit ($200/$400 USD) - 2020/10/23 14:43:01 ET
Table 'ADA179504417' 6-max Seat #1 is the button
Seat 1: ag2703 ($69125 in chips)
Seat 2: CarlJung ($11880 in chips)
Seat 3: kimjongun ($98638 in chips)
Seat 4: TurnOnTuneInDropOut ($55667 in chips)
Seat 5: soundfsilenz ($42000 in chips)
Seat 6: slotmachine ($77440 in chips)
CarlJung: posts small blind $200
kimjongun: posts big blind $400
*** HOLE CARDS ***
Dealt to TurnOnTuneInDropOut [Ks 3c 7s 5c]
TurnOnTuneInDropOut: folds
soundfsilenz: raises $1000 to $1400
slotmachine: folds
ag2703: folds
CarlJung: calls $1200
kimjongun: raises $4200 to $5600
soundfsilenz: calls $4200
CarlJung: calls $4200
*** FLOP *** [6h Jh Ad]
CarlJung: bets $6280 and is all-in
kimjongun: calls $6280
soundfsilenz: folds
*** TURN *** [6h Jh Ad] [9s]
*** RIVER *** [6h Jh Ad 9s] [2c]
*** SHOW DOWN ***
CarlJung: shows [Ah Jd Td 9c]
kimjongun: shows [Kh Qs As 2h]
CarlJung collected $28560 from pot
*** SUMMARY ***
Total pot $29360 | Rake $800
Board [6h Jh Ad 9s 2c]
Seat 1: ag2703 (button) folded before Flop (didn't bet)
Seat 2: CarlJung (small blind) showed [Ah Jd Td 9c] and won ($28560)
Seat 3: kimjongun (big blind) showed [Kh Qs As 2h] and lost
Seat 4: TurnOnTuneInDropOut folded before Flop (didn't bet)
Seat 5: soundfsilenz folded on the Flop
Seat 6: slotmachine folded before Flop (didn't bet)

PokerStars Hand #1922878042: Omaha Pot Limit ($200/$400 USD) - 2020/10/23 16:34:53 ET
Table 'ADA179504417' 6-max Seat #1 is the button
Seat 1: ag2703 ($24783 in chips)
Seat 2: singlajimitesh ($44087 in chips)
Seat 3: TurnOnTuneInDropOut ($30000 in chips)
Seat 4: craftplayer ($29172 in chips)
singlajimitesh: posts small blind $200
TurnOnTuneInDropOut: posts big blind $400
*** HOLE CARDS ***
Dealt to TurnOnTuneInDropOut [Th 3d Ac 4c]
craftplayer: raises $400 to $800
ag2703: folds
singlajimitesh: calls $600
TurnOnTuneInDropOut: calls $400
*** FLOP *** [Td 3s 3h]
singlajimitesh: checks
TurnOnTuneInDropOut: checks
craftplayer: checks
*** TURN *** [Td 3s 3h] [2h]
singlajimitesh: bets $1200
TurnOnTuneInDropOut: calls $1200
craftplayer: folds
*** RIVER *** [Td 3s 3h 2h] [5s]
singlajimitesh: checks
TurnOnTuneInDropOut: bets $4800
singlajimitesh: folds
Uncalled bet ($4800) returned to TurnOnTuneInDropOut
TurnOnTuneInDropOut collected $4608 from pot
TurnOnTuneInDropOut: doesn't show hand
*** SUMMARY ***
Total pot $4800 | Rake $192
Board [Td 3s 3h 2h 5s]
Seat 1: ag2703 (button) folded before Flop (didn't bet)
Seat 2: singlajimitesh (small blind) folded on the River
Seat 3: TurnOnTuneInDropOut (big blind) collected ($4608)
Seat 4: craftplayer folded on the Turn

PokerStars Hand #1922878048: Omaha Pot Limit ($200/$400 USD) - 2020/10/23 16:41:30 ET
Table 'ADA179504417' 6-max Seat #3 is the button
Seat 1: ag2703 ($9868 in chips)
Seat 2: singlajimitesh ($60469 in chips)
Seat 3: TurnOnTuneInDropOut ($48000 in chips)
Seat 4: craftplayer ($75784 in chips)
craftplayer: posts small blind $200
ag2703: posts big blind $400
*** HOLE CARDS ***
Dealt to TurnOnTuneInDropOut [5s Jc Kh Kc]
singlajimitesh: raises $400 to $800
TurnOnTuneInDropOut: raises $2200 to $3000
craftplayer: folds
ag2703: folds
singlajimitesh: calls $2200
*** FLOP *** [6d Jd 7s]
singlajimitesh: checks
TurnOnTuneInDropOut: checks
*** TURN *** [6d Jd 7s] [3d]
singlajimitesh: checks
TurnOnTuneInDropOut: checks
*** RIVER *** [6d Jd 7s 3d] [4d]
singlajimitesh: bets $3300
TurnOnTuneInDropOut: folds
Uncalled bet ($3300) returned to singlajimitesh
singlajimitesh collected $6335 from pot
singlajimitesh: doesn't show hand
*** SUMMARY ***
Total pot $6600 | Rake $265
Board [6d Jd 7s 3d 4d]
Seat 1: ag2703 (big blind) folded before Flop
Seat 2: singlajimitesh collected ($6335)
Seat 3: TurnOnTuneInDropOut (button) folded on the River
Seat 4: craftplayer (small blind) folded before Flop

PokerStars Hand #1922878049: Omaha Pot Limit ($200/$400 USD) - 2020/10/23 16:42:24 ET
Table 'ADA179504417' 6-max Seat #4 is the button
Seat 1: ag2703 ($9468 in chips)
Seat 2: singlajimitesh ($63804 in chips)
Seat 3: TurnOnTuneInDropOut ($45000 in chips)
Seat 4: craftplayer ($75584 in chips)
ag2703: posts small blind $200
singlajimitesh: posts big blind $400
*** HOLE CARDS ***
Dealt to TurnOnTuneInDropOut [Kc 5c Td 5h]
TurnOnTuneInDropOut: folds
craftplayer: raises $1000 to $1400
ag2703: folds
singlajimitesh: raises $3000 to $4400
craftplayer: calls $3000
*** FLOP *** [Qs Tc 9c]
singlajimitesh: checks
craftplayer: bets $4500
singlajimitesh: calls $4500
*** TURN *** [Qs Tc 9c] [9d]
singlajimitesh: checks
craftplayer: bets $9000
singlajimitesh: calls $9000
*** RIVER *** [Qs Tc 9c 9d] [7h]
singlajimitesh: checks
craftplayer: bets $27000
singlajimitesh: folds
Uncalled bet ($27000) returned to craftplayer
craftplayer collected $35200 from pot
craftplayer: doesn't show hand
*** SUMMARY ***
Total pot $36000 | Rake $800
Board [Qs Tc 9c 9d 7h]
Seat 1: ag2703 (small blind) folded before Flop
Seat 2: singlajimitesh (big blind) folded on the River
Seat 3: TurnOnTuneInDropOut folded before Flop (didn't bet)
Seat 4: craftplayer (button) collected ($35200)

PokerStars Hand #1922878050: Omaha Pot Limit ($200/$400 USD) - 2020/10/23 16:43:44 ET
Table 'ADA179504417' 6-max Seat #1 is the button
Seat 1: ag2703 ($9268 in chips)
Seat 2: singlajimitesh ($45904 in chips)
Seat 3: TurnOnTuneInDropOut ($48000 in chips)
Seat 4: craftplayer ($92884 in chips)
singlajimitesh: posts small blind $200
TurnOnTuneInDropOut: posts big blind $400
*** HOLE CARDS ***
Dealt to TurnOnTuneInDropOut [5s Qh Qd 2d]
craftplayer: raises $400 to $800
ag2703: calls $800
singlajimitesh: raises $2800 to $3600
TurnOnTuneInDropOut: folds
craftplayer: calls $2800
ag2703: folds
*** FLOP *** [4c 2h 7d]
singlajimitesh: checks
craftplayer: checks
*** TURN *** [4c 2h 7d] [Ts]
singlajimitesh: checks
craftplayer: checks
*** RIVER *** [4c 2h 7d Ts] [3d]
singlajimitesh: checks
craftplayer: checks
*** SHOW DOWN ***
singlajimitesh: shows [Ah Kd 9h Ks]
craftplayer: mucks hand
singlajimitesh collected $8063 from pot
*** SUMMARY ***
Total pot $8400 | Rake $337
Board [4c 2h 7d Ts 3d]
Seat 1: ag2703 (button) folded before Flop
Seat 2: singlajimitesh (small blind) showed [Ah Kd 9h Ks] and won ($8063)
Seat 3: TurnOnTuneInDropOut (big blind) folded before Flop
Seat 4: craftplayer mucked

PokerStars Hand #1922878052: Omaha Pot Limit ($200/$400 USD) - 2020/10/23 16:45:14 ET
Table 'ADA179504417' 6-max Seat #3 is the button
Seat 1: ag2703 ($8468 in chips)
Seat 2: singlajimitesh ($48967 in chips)
Seat 3: TurnOnTuneInDropOut ($47400 in chips)
Seat 4: craftplayer ($90764 in chips)
craftplayer: posts small blind $200
ag2703: posts big blind $400
*** HOLE CARDS ***
Dealt to TurnOnTuneInDropOut [2s 3h 9c 8h]
singlajimitesh: raises $1000 to $1400
TurnOnTuneInDropOut: folds
craftplayer: folds
ag2703: folds
Uncalled bet ($1000) returned to singlajimitesh
singlajimitesh collected $1000 from pot
singlajimitesh: doesn't show hand
*** SUMMARY ***
Total pot $1000 | Rake $0
Seat 1: ag2703 (big blind) folded before Flop
Seat 2: singlajimitesh collected ($1000)
Seat 3: TurnOnTuneInDropOut (button) folded before Flop (didn't bet)
Seat 4: craftplayer (small blind) folded before Flop

PokerStars Hand #1922878053: Omaha Pot Limit ($200/$400 USD) - 2020/10/23 16:45:30 ET
Table 'ADA179504417' 6-max Seat #4 is the button
Seat 1: ag2703 ($8068 in chips)
Seat 2: singlajimitesh ($49567 in chips)
Seat 3: TurnOnTuneInDropOut ($47400 in chips)
Seat 4: craftplayer ($90564 in chips)
ag2703: posts small blind $200
singlajimitesh: posts big blind $400
*** HOLE CARDS ***
Dealt to TurnOnTuneInDropOut [8c 2s 3c Jd]
TurnOnTuneInDropOut: folds
craftplayer: raises $1000 to $1400
ag2703: folds
singlajimitesh: calls $1000
*** FLOP *** [Js 5s Kc]
singlajimitesh: checks
craftplayer: bets $1500
singlajimitesh: folds
Uncalled bet ($1500) returned to craftplayer
craftplayer collected $2880 from pot
craftplayer: doesn't show hand
*** SUMMARY ***
Total pot $3000 | Rake $120
Board [Js 5s Kc]
Seat 1: ag2703 (small blind) folded before Flop
Seat 2: singlajimitesh (big blind) folded on the Flop
Seat 3: TurnOnTuneInDropOut folded before Flop (didn't bet)
Seat 4: craftplayer (button) collected ($2880)

PokerStars Hand #1922878054: Omaha Pot Limit ($200/$400 USD) - 2020/10/23 16:46:07 ET
Table 'ADA179504417' 6-max Seat #2 is the button
Seat 2: singlajimitesh ($48167 in chips)
Seat 3: TurnOnTuneInDropOut ($47400 in chips)
Seat 4: craftplayer ($92044 in chips)
TurnOnTuneInDropOut: posts small blind $200
craftplayer: posts big blind $400
*** HOLE CARDS ***
Dealt to TurnOnTuneInDropOut [7h Ks 6s 4h]
singlajimitesh: raises $1000 to $1400
TurnOnTuneInDropOut: folds
craftplayer: calls $1000
*** FLOP *** [4c 3c 5s]
craftplayer: checks
singlajimitesh: bets $3000
craftplayer: raises $9000 to $12000
singlajimitesh: folds
Uncalled bet ($9000) returned to craftplayer
craftplayer collected $8639 from pot
craftplayer: doesn't show hand
*** SUMMARY ***
Total pot $9000 | Rake $361
Board [4c 3c 5s]
Seat 2: singlajimitesh (button) folded on the Flop
Seat 3: TurnOnTuneInDropOut (small blind) folded before Flop
Seat 4: craftplayer (big blind) collected ($8639)

PokerStars Hand #1922878056: Omaha Pot Limit ($200/$400 USD) - 2020/10/23 16:47:59 ET
Table 'ADA179504417' 6-max Seat #4 is the button
Seat 2: singlajimitesh ($43367 in chips)
Seat 3: TurnOnTuneInDropOut ($54390 in chips)
Seat 4: craftplayer ($88883 in chips)
singlajimitesh: posts small blind $200
TurnOnTuneInDropOut: posts big blind $400
*** HOLE CARDS ***
Dealt to TurnOnTuneInDropOut [9s Js Kh 3d]
craftplayer: raises $1000 to $1400
singlajimitesh: calls $1200
TurnOnTuneInDropOut: folds
*** FLOP *** [Jd 6d Ts]
singlajimitesh: checks
craftplayer: checks
*** TURN *** [Jd 6d Ts] [4d]
singlajimitesh: checks
craftplayer: bets $2400
singlajimitesh: folds
Uncalled bet ($2400) returned to craftplayer
craftplayer collected $3072 from pot
craftplayer: doesn't show hand
*** SUMMARY ***
Total pot $3200 | Rake $128
Board [Jd 6d Ts 4d]
Seat 2: singlajimitesh (small blind) folded on the Turn
Seat 3: TurnOnTuneInDropOut (big blind) folded before Flop
Seat 4: craftplayer (button) collected ($3072)

PokerStars Hand #1922878057: Omaha Pot Limit ($200/$400 USD) - 2020/10/23 16:48:55 ET
Table 'ADA179504417' 6-max Seat #2 is the button
Seat 2: singlajimitesh ($41967 in chips)
Seat 3: TurnOnTuneInDropOut ($53990 in chips)
Seat 4: craftplayer ($90555 in chips)
TurnOnTuneInDropOut: posts small blind $200
craftplayer: posts big blind $400
*** HOLE CARDS ***
Dealt to TurnOnTuneInDropOut [2c 9s 5c Kc]
singlajimitesh: raises $1000 to $1400
TurnOnTuneInDropOut: folds
craftplayer: calls $1000
*** FLOP *** [Kd 7c 7h]
craftplayer: checks
singlajimitesh: bets $1500
craftplayer: folds
Uncalled bet ($1500) returned to singlajimitesh
singlajimitesh collected $2880 from pot
singlajimitesh: doesn't show hand
*** SUMMARY ***
Total pot $3000 | Rake $120
Board [Kd 7c 7h]
Seat 2: singlajimitesh (button) collected ($2880)
Seat 3: TurnOnTuneInDropOut (small blind) folded before Flop
Seat 4: craftplayer (big blind) folded on the Flop

PokerStars Hand #1922878058: Omaha Pot Limit ($200/$400 USD) - 2020/10/23 16:49:49 ET
Table 'ADA179504417' 6-max Seat #3 is the button
Seat 2: singlajimitesh ($43447 in chips)
Seat 3: TurnOnTuneInDropOut ($53790 in chips)
Seat 4: craftplayer ($89155 in chips)
craftplayer: posts small blind $200
singlajimitesh: posts big blind $400
*** HOLE CARDS ***
Dealt to TurnOnTuneInDropOut [3h Qd 8h Qs]
TurnOnTuneInDropOut: raises $1000 to $1400
craftplayer: folds
singlajimitesh: calls $1000
*** FLOP *** [2d 2s 5c]
singlajimitesh: checks
TurnOnTuneInDropOut: bets $990
singlajimitesh: calls $990
*** TURN *** [2d 2s 5c] [3c]
singlajimitesh: checks
TurnOnTuneInDropOut: checks
*** RIVER *** [2d 2s 5c 3c] [2h]
singlajimitesh: bets $2490
TurnOnTuneInDropOut: calls $2490
*** SHOW DOWN ***
singlajimitesh: shows [5h Kh Qh Kc]
singlajimitesh collected $9561 from pot
*** SUMMARY ***
Total pot $9960 | Rake $399
Board [2d 2s 5c 3c 2h]
Seat 2: singlajimitesh (big blind) showed [5h Kh Qh Kc] and won ($9561)
Seat 3: TurnOnTuneInDropOut (button)
Seat 4: craftplayer (small blind) folded before Flop

PokerStars Hand #1922878059: Omaha Pot Limit ($200/$400 USD) - 2020/10/23 16:50:39 ET
Table 'ADA179504417' 6-max Seat #4 is the button
Seat 2: singlajimitesh ($48128 in chips)
Seat 3: TurnOnTuneInDropOut ($48910 in chips)
Seat 4: craftplayer ($88955 in chips)
singlajimitesh: posts small blind $200
TurnOnTuneInDropOut: posts big blind $400
*** HOLE CARDS ***
Dealt to TurnOnTuneInDropOut [8h Kd 9s 4c]
craftplayer: raises $400 to $800
singlajimitesh: raises $2000 to $2800
TurnOnTuneInDropOut: folds
craftplayer: calls $2000
*** FLOP *** [Js Qc Qd]
singlajimitesh: checks
craftplayer: bets $3000
singlajimitesh: calls $3000
*** TURN *** [Js Qc Qd] [5s]
singlajimitesh: checks
craftplayer: bets $6800
singlajimitesh: calls $6800
*** RIVER *** [Js Qc Qd 5s] [2c]
singlajimitesh: checks
craftplayer: bets $19200
singlajimitesh: calls $19200
*** SHOW DOWN ***
singlajimitesh: mucks hand
craftplayer: shows [9h Jc Qh 2s]
craftplayer collected $63300 from pot
*** SUMMARY ***
Total pot $64000 | Rake $700
Board [Js Qc Qd 5s 2c]
Seat 2: singlajimitesh (small blind) mucked
Seat 3: TurnOnTuneInDropOut (big blind) folded before Flop
Seat 4: craftplayer (button) showed [9h Jc Qh 2s] and won ($63300)

PokerStars Hand #1922878060: Omaha Pot Limit ($200/$400 USD) - 2020/10/23 16:51:33 ET
Table 'ADA179504417' 6-max Seat #2 is the button
Seat 2: singlajimitesh ($16328 in chips)
Seat 3: TurnOnTuneInDropOut ($48510 in chips)
Seat 4: craftplayer ($120455 in chips)
TurnOnTuneInDropOut: posts small blind $200
craftplayer: posts big blind $400
*** HOLE CARDS ***
Dealt to TurnOnTuneInDropOut [3h 2s Ah 5d]
singlajimitesh: raises $1000 to $1400
TurnOnTuneInDropOut: folds
craftplayer: calls $1000
*** FLOP *** [Ad 6h Th]
craftplayer: checks
singlajimitesh: checks
*** TURN *** [Ad 6h Th] [Kd]
craftplayer: bets $2250
singlajimitesh: calls $2250
*** RIVER *** [Ad 6h Th Kd] [Qd]
craftplayer: checks
singlajimitesh: checks
*** SHOW DOWN ***
craftplayer: shows [Qc 2c Kc Jd]
singlajimitesh: mucks hand
craftplayer collected $7199 from pot
*** SUMMARY ***
Total pot $7500 | Rake $301
Board [Ad 6h Th Kd Qd]
Seat 2: singlajimitesh (button) mucked
Seat 3: TurnOnTuneInDropOut (small blind) folded before Flop
Seat 4: craftplayer (big blind) showed [Qc 2c Kc Jd] and won ($7199)

PokerStars Hand #1922878061: Omaha Pot Limit ($200/$400 USD) - 2020/10/23 16:52:08 ET
Table 'ADA179504417' 6-max Seat #3 is the button
Seat 2: singlajimitesh ($12678 in chips)
Seat 3: TurnOnTuneInDropOut ($48310 in chips)
Seat 4: craftplayer ($124004 in chips)
craftplayer: posts small blind $200
singlajimitesh: posts big blind $400
*** HOLE CARDS ***
Dealt to TurnOnTuneInDropOut [7d 4c As Qc]
TurnOnTuneInDropOut: raises $1000 to $1400
craftplayer: calls $1200
singlajimitesh: raises $4200 to $5600
TurnOnTuneInDropOut: folds
craftplayer: calls $4200
*** FLOP *** [Th 8d Jc]
craftplayer: checks
singlajimitesh: bets $7078 and is all-in
craftplayer: calls $7078
*** TURN *** [Th 8d Jc] [7h]
*** RIVER *** [Th 8d Jc 7h] [Js]
*** SHOW DOWN ***
craftplayer: shows [Ts Td 7c 9d]
singlajimitesh: shows [Ac 3h Kh Tc]
craftplayer collected $26056 from pot
*** SUMMARY ***
Total pot $26756 | Rake $700
Board [Th 8d Jc 7h Js]
Seat 2: singlajimitesh (big blind) showed [Ac 3h Kh Tc] and lost
Seat 3: TurnOnTuneInDropOut (button) folded before Flop
Seat 4: craftplayer (small blind) showed [Ts Td 7c 9d] and won ($26056)

PokerStars Hand #1740871411: Omaha Pot Limit ($200/$400 USD) - 2020/10/23 12:35:57 ET
Table 'ADA409467368' 6-max Seat #5 is the button
Seat 2: Sam565 ($9168 in chips)
Seat 3: TurnOnTuneInDropOut ($30000 in chips)
Seat 4: ag2703 ($27020 in chips)
Seat 5: slotmachine ($56542 in chips)
Sam565: posts small blind $200
TurnOnTuneInDropOut: posts big blind $400
*** HOLE CARDS ***
Dealt to TurnOnTuneInDropOut [Jc 3d Qh Jd]
ag2703: raises $400 to $800
slotmachine: folds
Sam565: raises $2000 to $2800
TurnOnTuneInDropOut: folds
ag2703: calls $2000
*** FLOP *** [Kd 7h Kh]
Sam565: bets $6000
ag2703: folds
Uncalled bet ($6000) returned to Sam565
Sam565 collected $5759 from pot
Sam565: doesn't show hand
*** SUMMARY ***
Total pot $6000 | Rake $241
Board [Kd 7h Kh]
Seat 2: Sam565 (small blind) collected ($5759)
Seat 3: TurnOnTuneInDropOut (big blind) folded before Flop
Seat 4: ag2703 folded on the Flop
Seat 5: slotmachine (button) folded before Flop (didn't bet)

PokerStars Hand #1740871412: Omaha Pot Limit ($200/$400 USD) - 2020/10/23 12:36:48 ET
Table 'ADA409467368' 6-max Seat #2 is the button
Seat 2: Sam565 ($12127 in chips)
Seat 3: TurnOnTuneInDropOut ($29600 in chips)
Seat 4: ag2703 ($24220 in chips)
Seat 5: slotmachine ($56542 in chips)
TurnOnTuneInDropOut: posts small blind $200
ag2703: posts big blind $400
*** HOLE CARDS ***
Dealt to TurnOnTuneInDropOut [2h Qd Qc 9h]
slotmachine: raises $1000 to $1400
Sam565: calls $1400
TurnOnTuneInDropOut: folds
ag2703: folds
*** FLOP *** [4s 7c 8h]
slotmachine: checks
Sam565: bets $3400
slotmachine: folds
Uncalled bet ($3400) returned to Sam565
Sam565 collected $3264 from pot
Sam565: doesn't show hand
*** SUMMARY ***
Total pot $3400 | Rake $136
Board [4s 7c 8h]
Seat 2: Sam565 (button) collected ($3264)
Seat 3: TurnOnTuneInDropOut (small blind) folded before Flop
Seat 4: ag2703 (big blind) folded before Flop
Seat 5: slotmachine folded on the Flop

PokerStars Hand #1740871414: Omaha Pot Limit ($200/$400 USD) - 2020/10/23 12:39:05 ET
Table 'ADA409467368' 6-max Seat #4 is the button
Seat 2: Sam565 ($16607 in chips)
Seat 3: TurnOnTuneInDropOut ($46200 in chips)
Seat 4: ag2703 ($23620 in chips)
Seat 5: slotmachine ($54742 in chips)
Seat 6: Shr181 ($34327 in chips)
slotmachine: posts small blind $200
Shr181: posts big blind $400
*** HOLE CARDS ***
Dealt to TurnOnTuneInDropOut [Tc 7h Kd 7d]
Sam565: folds
TurnOnTuneInDropOut: folds
ag2703: folds
slotmachine: folds
Uncalled bet ($200) returned to Shr181
Shr181 collected $400 from pot
Shr181: doesn't show hand
*** SUMMARY ***
Total pot $400 | Rake $0
Seat 2: Sam565 folded before Flop (didn't bet)
Seat 3: TurnOnTuneInDropOut folded before Flop (didn't bet)
Seat 4: ag2703 (button) folded before Flop (didn't bet)
Seat 5: slotmachine (small blind) folded before Flop
Seat 6: Shr181 (big blind) collected ($400)

PokerStars Hand #1740871415: Omaha Pot Limit ($200/$400 USD) - 2020/10/23 12:39:30 ET
Table 'ADA409467368' 6-max Seat #5 is the button
Seat 2: Sam565 ($16607 in chips)
Seat 3: TurnOnTuneInDropOut ($46200 in chips)
Seat 4: ag2703 ($23620 in chips)
Seat 5: slotmachine ($54542 in chips)
Seat 6: Shr181 ($34527 in chips)
Shr181: posts small blind $200
Sam565: posts big blind $400
*** HOLE CARDS ***
Dealt to TurnOnTuneInDropOut [Qd 9h 9s 2h]
TurnOnTuneInDropOut: folds
ag2703: folds
slotmachine: raises $1000 to $1400
Shr181: calls $1200
Sam565: calls $1000
*** FLOP *** [5s 5h 4s]
Shr181: checks
Sam565: checks
slotmachine: bets $1386
Shr181: calls $1386
Sam565: folds
*** TURN *** [5s 5h 4s] [2c]
Shr181: bets $1200
slotmachine: calls $1200
*** RIVER *** [5s 5h 4s 2c] [Jd]
Shr181: checks
slotmachine: checks
*** SHOW DOWN ***
Shr181: mucks hand
slotmachine: shows [2s Ah Ad 4d]
slotmachine collected $8996 from pot
*** SUMMARY ***
Total pot $9372 | Rake $376
Board [5s 5h 4s 2c Jd]
Seat 2: Sam565 (big blind) folded on the Flop
Seat 3: TurnOnTuneInDropOut folded before Flop (didn't bet)
Seat 4: ag2703 folded before Flop (didn't bet)
Seat 5: slotmachine (button) showed [2s Ah Ad 4d] and won ($8996)
Seat 6: Shr181 (small blind) mucked

PokerStars Hand #228844228: Omaha Pot Limit ($200/$400 USD) - 2020/10/23 13:31:41 ET
Table 'ADA409467368' 6-max Seat #5 is the button
Seat 1: soundfsilenz ($47568 in chips)
Seat 2: Aksxone ($8924 in chips)
Seat 3: kimjongun ($32488 in chips)
Seat 4: ag2703 ($55841 in chips)
Seat 5: slotmachine ($62066 in chips)
Seat 6: TurnOnTuneInDropOut ($29600 in chips)
TurnOnTuneInDropOut: posts small blind $200
soundfsilenz: posts big blind $400
*** HOLE CARDS ***
Dealt to TurnOnTuneInDropOut [3s 6c Ks Jd]
Aksxone: raises $800 to $1200
kimjongun: folds
ag2703: folds
slotmachine: raises $3000 to $4200
TurnOnTuneInDropOut: folds
soundfsilenz: folds
Aksxone: calls $3000
*** FLOP *** [Js 7s 8c]
Aksxone: bets $4724 and is all-in
slotmachine: calls $4724
*** TURN *** [Js 7s 8c] [9h]
*** RIVER *** [Js 7s 8c 9h] [9d]
*** SHOW DOWN ***
Aksxone: shows [2s 5d 7h 7d]
slotmachine: shows [Qd 2c Qc As]
Aksxone collected $17708 from pot
*** SUMMARY ***
Total pot $18448 | Rake $740
Board [Js 7s 8c 9h 9d]
Seat 1: soundfsilenz (big blind) folded before Flop
Seat 2: Aksxone showed [2s 5d 7h 7d] and won ($17708)
Seat 3: kimjongun folded before Flop (didn't bet)
Seat 4: ag2703 folded before Flop (didn't bet)
Seat 5: slotmachine (button) showed [Qd 2c Qc As] and lost
Seat 6: TurnOnTuneInDropOut (small blind) folded before Flop

PokerStars Hand #228844229: Omaha Pot Limit ($200/$400 USD) - 2020/10/23 13:32:26 ET
Table 'ADA409467368' 6-max Seat #6 is the button
Seat 1: soundfsilenz ($47168 in chips)
Seat 2: Aksxone ($17708 in chips)
Seat 3: kimjongun ($32488 in chips)
Seat 4: ag2703 ($55841 in chips)
Seat 5: slotmachine ($53142 in chips)
Seat 6: TurnOnTuneInDropOut ($29400 in chips)
soundfsilenz: posts small blind $200
Aksxone: posts big blind $400
*** HOLE CARDS ***
Dealt to TurnOnTuneInDropOut [Qs 4c Ad 7h]
kimjongun: raises $600 to $1000
ag2703: folds
slotmachine: raises $2600 to $3600
TurnOnTuneInDropOut: folds
soundfsilenz: folds
Aksxone: folds
kimjongun: calls $2600
*** FLOP *** [7s Tc 8s]
kimjongun: checks
slotmachine: checks
*** TURN *** [7s Tc 8s] [Kd]
kimjongun: bets $5148
slotmachine: calls $5148
*** RIVER *** [7s Tc 8s Kd] [8d]
kimjongun: bets $18096
slotmachine: calls $18096
*** SHOW DOWN ***
kimjongun: mucks hand
slotmachine: shows [9h 5c Kh 7c]
slotmachine collected $53488 from pot
*** SUMMARY ***
Total pot $54288 | Rake $800
Board [7s Tc 8s Kd 8d]
Seat 1: soundfsilenz (small blind) folded before Flop
Seat 2: Aksxone (big blind) folded before Flop
Seat 3: kimjongun mucked
Seat 4: ag2703 folded before Flop (didn't bet)
Seat 5: slotmachine showed [9h 5c Kh 7c] and won ($53488)
Seat 6: TurnOnTuneInDropOut (button) folded before Flop (didn't bet)

PokerStars Hand #228844230: Omaha Pot Limit ($200/$400 USD) - 2020/10/23 13:34:03 ET
Table 'ADA409467368' 6-max Seat #1 is the button
Seat 1: soundfsilenz ($46968 in chips)
Seat 2: Aksxone ($17308 in chips)
Seat 3: kimjongun ($30000 in chips)
Seat 4: ag2703 ($55841 in chips)
Seat 5: slotmachine ($79786 in chips)
Seat 6: TurnOnTuneInDropOut ($29400 in chips)
Aksxone: posts small blind $200
kimjongun: posts big blind $400
*** HOLE CARDS ***
Dealt to TurnOnTuneInDropOut [6h Ts Ks Ad]
ag2703: folds
slotmachine: folds
TurnOnTuneInDropOut: raises $1000 to $1400
soundfsilenz: raises $3400 to $4800
Aksxone: folds
kimjongun: calls $4400
TurnOnTuneInDropOut: folds
*** FLOP *** [7d 8c 3c]
kimjongun: checks
soundfsilenz: bets $7504
kimjongun: calls $7504
*** TURN *** [7d 8c 3c] [3d]
kimjongun: bets $17696 and is all-in
soundfsilenz: calls $17696
*** RIVER *** [7d 8c 3c 3d] [8d]
*** SHOW DOWN ***
kimjongun: shows [7h Th Qd Kd]
soundfsilenz: shows [Qc Jh Ac Td]
kimjongun collected $60800 from pot
*** SUMMARY ***
Total pot $61600 | Rake $800
Board [7d 8c 3c 3d 8d]
Seat 1: soundfsilenz (button) showed [Qc Jh Ac Td] and lost
Seat 2: Aksxone (small blind) folded before Flop
Seat 3: kimjongun (big blind) showed [7h Th Qd Kd] and won ($60800)
Seat 4: ag2703 folded before Flop (didn't bet)
Seat 5: slotmachine folded before Flop (didn't bet)
Seat 6: TurnOnTuneInDropOut folded before Flop

PokerStars Hand #228844231: Omaha Pot Limit ($200/$400 USD) - 2020/10/23 13:35:24 ET
Table 'ADA409467368' 6-max Seat #2 is the button
Seat 1: soundfsilenz ($16968 in chips)
Seat 2: Aksxone ($17108 in chips)
Seat 3: kimjongun ($60800 in chips)
Seat 4: ag2703 ($55841 in chips)
Seat 5: slotmachine ($79786 in chips)
Seat 6: TurnOnTuneInDropOut ($28000 in chips)
kimjongun: posts small blind $200
ag2703: posts big blind $400
*** HOLE CARDS ***
Dealt to TurnOnTuneInDropOut [Kd 3s 8h 7c]
slotmachine: folds
TurnOnTuneInDropOut: folds
soundfsilenz: folds
Aksxone: folds
kimjongun: folds
Uncalled bet ($200) returned to ag2703
ag2703 collected $400 from pot
ag2703: doesn't show hand
*** SUMMARY ***
Total pot $400 | Rake $0
Seat 1: soundfsilenz folded before Flop (didn't bet)
Seat 2: Aksxone (button) folded before Flop (didn't bet)
Seat 3: kimjongun (small blind) folded before Flop
Seat 4: ag2703 (big blind) collected ($400)
Seat 5: slotmachine folded before Flop (didn't bet)
Seat 6: TurnOnTuneInDropOut folded before Flop (didn't bet)

PokerStars Hand #228844232: Omaha Pot Limit ($200/$400 USD) - 2020/10/23 13:35:43 ET
Table 'ADA409467368' 6-max Seat #3 is the button
Seat 1: soundfsilenz ($28969 in chips)
Seat 2: Aksxone ($17108 in chips)
Seat 3: kimjongun ($60600 in chips)
Seat 4: ag2703 ($56041 in chips)
Seat 5: slotmachine ($79786 in chips)
Seat 6: TurnOnTuneInDropOut ($28000 in chips)
ag2703: posts small blind $200
slotmachine: posts big blind $400
*** HOLE CARDS ***
Dealt to TurnOnTuneInDropOut [9h 4d 2d 7c]
TurnOnTuneInDropOut: folds
soundfsilenz: raises $1000 to $1400
Aksxone: calls $1400
kimjongun: folds
ag2703: folds
slotmachine: folds
*** FLOP *** [Tc Qc 2s]
soundfsilenz: bets $2278
Aksxone: folds
Uncalled bet ($2278) returned to soundfsilenz
soundfsilenz collected $3264 from pot
soundfsilenz: doesn't show hand
*** SUMMARY ***
Total pot $3400 | Rake $136
Board [Tc Qc 2s]
Seat 1: soundfsilenz collected ($3264)
Seat 2: Aksxone folded on the Flop
Seat 3: kimjongun (button) folded before Flop (didn't bet)
Seat 4: ag2703 (small blind) folded before Flop
Seat 5: slotmachine (big blind) folded before Flop
Seat 6: TurnOnTuneInDropOut folded before Flop (didn't bet)

PokerStars Hand #228844233: Omaha Pot Limit ($200/$400 USD) - 2020/10/23 13:36:22 ET
Table 'ADA409467368' 6-max Seat #4 is the button
Seat 1: soundfsilenz ($30833 in chips)
Seat 2: Aksxone ($15708 in chips)
Seat 3: kimjongun ($60600 in chips)
Seat 4: ag2703 ($55841 in chips)
Seat 5: slotmachine ($79386 in chips)
Seat 6: TurnOnTuneInDropOut ($28000 in chips)
slotmachine: posts small blind $200
TurnOnTuneInDropOut: posts big blind $400
*** HOLE CARDS ***
Dealt to TurnOnTuneInDropOut [Qs Jc 3d Ad]
soundfsilenz: folds
Aksxone: raises $1000 to $1400
kimjongun: folds
ag2703: folds
slotmachine: folds
TurnOnTuneInDropOut: calls $1000
*** FLOP *** [7h 7s Kd]
TurnOnTuneInDropOut: checks
Aksxone: checks
*** TURN *** [7h 7s Kd] [3c]
TurnOnTuneInDropOut: checks
Aksxone: checks
*** RIVER *** [7h 7s Kd 3c] [Qc]
TurnOnTuneInDropOut: checks
Aksxone: bets $3000
TurnOnTuneInDropOut: calls $3000
*** SHOW DOWN ***
TurnOnTuneInDropOut: shows [Qs Jc 3d Ad]
Aksxone: mucks hand
TurnOnTuneInDropOut collected $8639 from pot
*** SUMMARY ***
Total pot $9000 | Rake $361
Board [7h 7s Kd 3c Qc]
Seat 1: soundfsilenz folded before Flop (didn't bet)
Seat 2: Aksxone mucked
Seat 3: kimjongun folded before Flop (didn't bet)
Seat 4: ag2703 (button) folded before Flop (didn't bet)
Seat 5: slotmachine (small blind) folded before Flop
Seat 6: TurnOnTuneInDropOut (big blind) showed [Qs Jc 3d Ad] and won ($8639)

PokerStars Hand #228844235: Omaha Pot Limit ($200/$400 USD) - 2020/10/23 13:38:20 ET
Table 'ADA409467368' 6-max Seat #6 is the button
Seat 1: soundfsilenz ($42434 in chips)
Seat 2: Aksxone ($10908 in chips)
Seat 3: kimjongun ($60600 in chips)
Seat 4: ag2703 ($55841 in chips)
Seat 5: slotmachine ($80186 in chips)
Seat 6: TurnOnTuneInDropOut ($32039 in chips)
soundfsilenz: posts small blind $200
Aksxone: posts big blind $400
*** HOLE CARDS ***
Dealt to TurnOnTuneInDropOut [Qh 6h 2c Jh]
kimjongun: folds
ag2703: raises $400 to $800
slotmachine: raises $2200 to $3000
TurnOnTuneInDropOut: folds
soundfsilenz: folds
Aksxone: calls $2600
ag2703: calls $2200
*** FLOP *** [Qs Qc As]
Aksxone: checks
ag2703: checks
slotmachine: checks
*** TURN *** [Qs Qc As] [Jd]
Aksxone: bets $4600
ag2703: folds
slotmachine: folds
Uncalled bet ($4600) returned to Aksxone
Aksxone collected $8831 from pot
Aksxone: doesn't show hand
*** SUMMARY ***
Total pot $9200 | Rake $369
Board [Qs Qc As Jd]
Seat 1: soundfsilenz (small blind) folded before Flop
Seat 2: Aksxone (big blind) collected ($8831)
Seat 3: kimjongun folded before Flop (didn't bet)
Seat 4: ag2703 folded on the Turn
Seat 5: slotmachine folded on the Turn
Seat 6: TurnOnTuneInDropOut (button) folded before Flop (didn't bet)

PokerStars Hand #228844236: Omaha Pot Limit ($200/$400 USD) - 2020/10/23 13:39:53 ET
Table 'ADA409467368' 6-max Seat #1 is the button
Seat 1: soundfsilenz ($42234 in chips)
Seat 2: Aksxone ($16739 in chips)
Seat 3: kimjongun ($60600 in chips)
Seat 4: ag2703 ($52841 in chips)
Seat 5: slotmachine ($77186 in chips)
Seat 6: TurnOnTuneInDropOut ($32039 in chips)
Aksxone: posts small blind $200
kimjongun: posts big blind $400
*** HOLE CARDS ***
Dealt to TurnOnTuneInDropOut [3d 7c 2c 7h]
ag2703: folds
slotmachine: raises $1000 to $1400
TurnOnTuneInDropOut: folds
soundfsilenz: calls $1400
Aksxone: raises $4600 to $6000
kimjongun: folds
slotmachine: raises $13800 to $19800
soundfsilenz: folds
Aksxone: calls $10739 and is all-in
Uncalled bet ($3061) returned to slotmachine
*** FLOP *** [3h Js 2d]
*** TURN *** [3h Js 2d] [5c]
*** RIVER *** [3h Js 2d 5c] [Ts]
*** SHOW DOWN ***
Aksxone: shows [Kh Qc As Kd]
slotmachine: shows [Ah 5d 6s 9h]
Aksxone collected $34478 from pot
*** SUMMARY ***
Total pot $35278 | Rake $800
Board [3h Js 2d 5c Ts]
Seat 1: soundfsilenz (button) folded before Flop
Seat 2: Aksxone (small blind) showed [Kh Qc As Kd] and won ($34478)
Seat 3: kimjongun (big blind) folded before Flop
Seat 4: ag2703 folded before Flop (didn't bet)
Seat 5: slotmachine showed [Ah 5d 6s 9h] and lost
Seat 6: TurnOnTuneInDropOut folded before Flop (didn't bet)

PokerStars Hand #228844237: Omaha Pot Limit ($200/$400 USD) - 2020/10/23 13:40:39 ET
Table 'ADA409467368' 6-max Seat #2 is the button
Seat 1: soundfsilenz ($40834 in chips)
Seat 2: Aksxone ($34478 in chips)
Seat 3: kimjongun ($60200 in chips)
Seat 4: ag2703 ($52841 in chips)
Seat 5: slotmachine ($60447 in chips)
Seat 6: TurnOnTuneInDropOut ($32039 in chips)
kimjongun: posts small blind $200
ag2703: posts big blind $400
*** HOLE CARDS ***
Dealt to TurnOnTuneInDropOut [6d Kc 8s 4h]
slotmachine: folds
TurnOnTuneInDropOut: folds
soundfsilenz: raises $1000 to $1400
Aksxone: calls $1400
kimjongun: folds
ag2703: calls $1000
*** FLOP *** [4s 3s Qh]
ag2703: checks
soundfsilenz: checks
Aksxone: checks
*** TURN *** [4s 3s Qh] [5d]
ag2703: checks
soundfsilenz: bets $2948
Aksxone: calls $2948
ag2703: folds
*** RIVER *** [4s 3s Qh 5d] [Jd]
soundfsilenz: bets $6899
Aksxone: calls $6899
*** SHOW DOWN ***
soundfsilenz: mucks hand
Aksxone: shows [2d 2h Ah Jh]
Aksxone collected $23294 from pot
*** SUMMARY ***
Total pot $24094 | Rake $800
Board [4s 3s Qh 5d Jd]
Seat 1: soundfsilenz mucked
Seat 2: Aksxone (button) showed [2d 2h Ah Jh] and won ($23294)
Seat 3: kimjongun (small blind) folded before Flop
Seat 4: ag2703 (big blind) folded on the Turn
Seat 5: slotmachine folded before Flop (didn't bet)
Seat 6: TurnOnTuneInDropOut folded before Flop (didn't bet)

PokerStars Hand #228844238: Omaha Pot Limit ($200/$400 USD) - 2020/10/23 13:42:02 ET
Table 'ADA409467368' 6-max Seat #3 is the button
Seat 1: soundfsilenz ($29587 in chips)
Seat 2: Aksxone ($46525 in chips)
Seat 3: kimjongun ($60000 in chips)
Seat 4: ag2703 ($51441 in chips)
Seat 5: slotmachine ($60447 in chips)
Seat 6: TurnOnTuneInDropOut ($32039 in chips)
ag2703: posts small blind $200
slotmachine: posts big blind $400
*** HOLE CARDS ***
Dealt to TurnOnTuneInDropOut [2h Jh 4s 5h]
TurnOnTuneInDropOut: folds
soundfsilenz: folds
Aksxone: calls $400
kimjongun: folds
ag2703: folds
slotmachine: checks
*** FLOP *** [Ah 5d 7h]
slotmachine: checks
Aksxone: bets $750
slotmachine: folds
Uncalled bet ($750) returned to Aksxone
Aksxone collected $960 from pot
Aksxone: doesn't show hand
*** SUMMARY ***
Total pot $1000 | Rake $40
Board [Ah 5d 7h]
Seat 1: soundfsilenz folded before Flop (didn't bet)
Seat 2: Aksxone collected ($960)
Seat 3: kimjongun (button) folded before Flop (didn't bet)
Seat 4: ag2703 (small blind) folded before Flop
Seat 5: slotmachine (big blind) folded on the Flop
Seat 6: TurnOnTuneInDropOut folded before Flop (didn't bet)

PokerStars Hand #228844241: Omaha Pot Limit ($200/$400 USD) - 2020/10/23 13:45:38 ET
Table 'ADA409467368' 6-max Seat #6 is the button
Seat 1: soundfsilenz ($41188 in chips)
Seat 2: Aksxone ($37535 in chips)
Seat 3: kimjongun ($59600 in chips)
Seat 4: ag2703 ($61561 in chips)
Seat 5: slotmachine ($59847 in chips)
Seat 6: TurnOnTuneInDropOut ($31439 in chips)
soundfsilenz: posts small blind $200
Aksxone: posts big blind $400
*** HOLE CARDS ***
Dealt to TurnOnTuneInDropOut [Jh 5d 6s 4c]
kimjongun: folds
ag2703: raises $400 to $800
slotmachine: folds
TurnOnTuneInDropOut: folds
soundfsilenz: folds
Aksxone: raises $800 to $1600
ag2703: calls $800
*** FLOP *** [9c 8c 6h]
Aksxone: checks
ag2703: bets $3400
Aksxone: folds
Uncalled bet ($3400) returned to ag2703
ag2703 collected $3264 from pot
ag2703: doesn't show hand
*** SUMMARY ***
Total pot $3400 | Rake $136
Board [9c 8c 6h]
Seat 1: soundfsilenz (small blind) folded before Flop
Seat 2: Aksxone (big blind) folded on the Flop
Seat 3: kimjongun folded before Flop (didn't bet)
Seat 4: ag2703 collected ($3264)
Seat 5: slotmachine folded before Flop (didn't bet)
Seat 6: TurnOnTuneInDropOut (button) folded before Flop (didn't bet)

PokerStars Hand #228844242: Omaha Pot Limit ($200/$400 USD) - 2020/10/23 13:47:02 ET
Table 'ADA409467368' 6-max Seat #1 is the button
Seat 1: soundfsilenz ($40988 in chips)
Seat 2: Aksxone ($35935 in chips)
Seat 3: kimjongun ($59600 in chips)
Seat 4: ag2703 ($63225 in chips)
Seat 5: slotmachine ($59847 in chips)
Seat 6: TurnOnTuneInDropOut ($31439 in chips)
Aksxone: posts small blind $200
kimjongun: posts big blind $400
*** HOLE CARDS ***
Dealt to TurnOnTuneInDropOut [Qh 9h 8h 5c]
ag2703: folds
slotmachine: folds
TurnOnTuneInDropOut: folds
soundfsilenz: folds
Aksxone: calls $200
kimjongun: checks
*** FLOP *** [2c Kd Ks]
Aksxone: checks
kimjongun: checks
*** TURN *** [2c Kd Ks] [Kc]
Aksxone: bets $800
kimjongun: folds
Uncalled bet ($800) returned to Aksxone
Aksxone collected $768 from pot
Aksxone: doesn't show hand
*** SUMMARY ***
Total pot $800 | Rake $32
Board [2c Kd Ks Kc]
Seat 1: soundfsilenz (button) folded before Flop (didn't bet)
Seat 2: Aksxone (small blind) collected ($768)
Seat 3: kimjongun (big blind) folded on the Turn
Seat 4: ag2703 folded before Flop (didn't bet)
Seat 5: slotmachine folded before Flop (didn't bet)
Seat 6: TurnOnTuneInDropOut folded before Flop (didn't bet)

PokerStars Hand #228844243: Omaha Pot Limit ($200/$400 USD) - 2020/10/23 13:47:47 ET
Table 'ADA409467368' 6-max Seat #2 is the button
Seat 1: soundfsilenz ($40988 in chips)
Seat 2: Aksxone ($36303 in chips)
Seat 3: kimjongun ($59200 in chips)
Seat 4: ag2703 ($63225 in chips)
Seat 5: slotmachine ($59847 in chips)
Seat 6: TurnOnTuneInDropOut ($31439 in chips)
kimjongun: posts small blind $200
ag2703: posts big blind $400
*** HOLE CARDS ***
Dealt to TurnOnTuneInDropOut [3s 2d 7c Qs]
slotmachine: raises $1000 to $1400
TurnOnTuneInDropOut: folds
soundfsilenz: folds
Aksxone: calls $1400
kimjongun: folds
ag2703: calls $1000
*** FLOP *** [Js 5d Th]
ag2703: bets $4400
slotmachine: folds
Aksxone: raises $13200 to $17600
ag2703: raises $39600 to $57200
Aksxone: calls $17303 and is all-in
Uncalled bet ($22297) returned to ag2703
*** TURN *** [Js 5d Th] [4c]
*** RIVER *** [Js 5d Th 4c] [8s]
*** SHOW DOWN ***
ag2703: shows [7s Qd Jd Jc]
Aksxone: shows [4s 9s Jh Ts]
ag2703 collected $73406 from pot
*** SUMMARY ***
Total pot $74206 | Rake $800
Board [Js 5d Th 4c 8s]
Seat 1: soundfsilenz folded before Flop (didn't bet)
Seat 2: Aksxone (button) showed [4s 9s Jh Ts] and lost
Seat 3: kimjongun (small blind) folded before Flop
Seat 4: ag2703 (big blind) showed [7s Qd Jd Jc] and won ($73406)
Seat 5: slotmachine folded on the Flop
Seat 6: TurnOnTuneInDropOut folded before Flop (didn't bet)

PokerStars Hand #228844244: Omaha Pot Limit ($200/$400 USD) - 2020/10/23 13:49:13 ET
Table 'ADA409467368' 6-max Seat #3 is the button
Seat 1: soundfsilenz ($40988 in chips)
Seat 3: kimjongun ($59000 in chips)
Seat 4: ag2703 ($100328 in chips)
Seat 5: slotmachine ($58447 in chips)
Seat 6: TurnOnTuneInDropOut ($31439 in chips)
ag2703: posts small blind $200
slotmachine: posts big blind $400
*** HOLE CARDS ***
Dealt to TurnOnTuneInDropOut [9h Th 7s Ts]
TurnOnTuneInDropOut: raises $1000 to $1400
soundfsilenz: folds
kimjongun: folds
ag2703: folds
slotmachine: folds
Uncalled bet ($1000) returned to TurnOnTuneInDropOut
TurnOnTuneInDropOut collected $1000 from pot
TurnOnTuneInDropOut: doesn't show hand
*** SUMMARY ***
Total pot $1000 | Rake $0
Seat 1: soundfsilenz folded before Flop (didn't bet)
Seat 3: kimjongun (button) folded before Flop (didn't bet)
Seat 4: ag2703 (small blind) folded before Flop
Seat 5: slotmachine (big blind) folded before Flop
Seat 6: TurnOnTuneInDropOut collected ($1000)

PokerStars Hand #228844245: Omaha Pot Limit ($200/$400 USD) - 2020/10/23 13:49:39 ET
Table 'ADA409467368' 6-max Seat #4 is the button
Seat 1: soundfsilenz ($40988 in chips)
Seat 3: kimjongun ($59000 in chips)
Seat 4: ag2703 ($100128 in chips)
Seat 5: slotmachine ($58047 in chips)
Seat 6: TurnOnTuneInDropOut ($32039 in chips)
slotmachine: posts small blind $200
TurnOnTuneInDropOut: posts big blind $400
*** HOLE CARDS ***
Dealt to TurnOnTuneInDropOut [9d Qh Js 7h]
soundfsilenz: folds
kimjongun: folds
ag2703: raises $1000 to $1400
slotmachine: folds
TurnOnTuneInDropOut: calls $1000
*** FLOP *** [8d Kc 9s]
TurnOnTuneInDropOut: checks
ag2703: bets $3000
TurnOnTuneInDropOut: calls $3000
*** TURN *** [8d Kc 9s] [Kh]
TurnOnTuneInDropOut: checks
ag2703: checks
*** RIVER *** [8d Kc 9s Kh] [Ac]
TurnOnTuneInDropOut: checks
ag2703: bets $9000
TurnOnTuneInDropOut: folds
Uncalled bet ($9000) returned to ag2703
ag2703 collected $8639 from pot
ag2703: doesn't show hand
*** SUMMARY ***
Total pot $9000 | Rake $361
Board [8d Kc 9s Kh Ac]
Seat 1: soundfsilenz folded before Flop (didn't bet)
Seat 3: kimjongun folded before Flop (didn't bet)
Seat 4: ag2703 (button) collected ($8639)
Seat 5: slotmachine (small blind) folded before Flop
Seat 6: TurnOnTuneInDropOut (big blind) folded on the River

PokerStars Hand #228844248: Omaha Pot Limit ($200/$400 USD) - 2020/10/23 13:52:54 ET
Table 'ADA409467368' 6-max Seat #1 is the button
Seat 1: soundfsilenz ($41348 in chips)
Seat 2: Aksxone ($18426 in chips)
Seat 3: kimjongun ($64015 in chips)
Seat 4: ag2703 ($100167 in chips)
Seat 5: slotmachine ($57847 in chips)
Seat 6: TurnOnTuneInDropOut ($27439 in chips)
Aksxone: posts small blind $200
kimjongun: posts big blind $400
*** HOLE CARDS ***
Dealt to TurnOnTuneInDropOut [3c 7d 8d Ah]
ag2703: raises $400 to $800
slotmachine: folds
TurnOnTuneInDropOut: folds
soundfsilenz: folds
Aksxone: raises $2000 to $2800
kimjongun: folds
ag2703: calls $2000
*** FLOP *** [3h Td 6c]
Aksxone: bets $6000
ag2703: folds
Uncalled bet ($6000) returned to Aksxone
Aksxone collected $5759 from pot
Aksxone: doesn't show hand
*** SUMMARY ***
Total pot $6000 | Rake $241
Board [3h Td 6c]
Seat 1: soundfsilenz (button) folded before Flop (didn't bet)
Seat 2: Aksxone (small blind) collected ($5759)
Seat 3: kimjongun (big blind) folded before Flop
Seat 4: ag2703 folded on the Flop
Seat 5: slotmachine folded before Flop (didn't bet)
Seat 6: TurnOnTuneInDropOut folded before Flop (didn't bet)

PokerStars Hand #228844249: Omaha Pot Limit ($200/$400 USD) - 2020/10/23 13:53:34 ET
Table 'ADA409467368' 6-max Seat #2 is the button
Seat 1: soundfsilenz ($41348 in chips)
Seat 2: Aksxone ($21385 in chips)
Seat 3: kimjongun ($63615 in chips)
Seat 4: ag2703 ($97367 in chips)
Seat 5: slotmachine ($57847 in chips)
Seat 6: TurnOnTuneInDropOut ($27439 in chips)
kimjongun: posts small blind $200
ag2703: posts big blind $400
*** HOLE CARDS ***
Dealt to TurnOnTuneInDropOut [4c 5d 3d 2d]
slotmachine: folds
TurnOnTuneInDropOut: folds
soundfsilenz: folds
Aksxone: raises $1000 to $1400
kimjongun: folds
ag2703: calls $1000
*** FLOP *** [7c 6d 5h]
ag2703: checks
Aksxone: checks
*** TURN *** [7c 6d 5h] [Qc]
ag2703: checks
Aksxone: bets $3000
ag2703: folds
Uncalled bet ($3000) returned to Aksxone
Aksxone collected $2880 from pot
Aksxone: doesn't show hand
*** SUMMARY ***
Total pot $3000 | Rake $120
Board [7c 6d 5h Qc]
Seat 1: soundfsilenz folded before Flop (didn't bet)
Seat 2: Aksxone (button) collected ($2880)
Seat 3: kimjongun (small blind) folded before Flop
Seat 4: ag2703 (big blind) folded on the Turn
Seat 5: slotmachine folded before Flop (didn't bet)
Seat 6: TurnOnTuneInDropOut folded before Flop (didn't bet)

PokerStars Hand #228844250: Omaha Pot Limit ($200/$400 USD) - 2020/10/23 13:54:55 ET
Table 'ADA409467368' 6-max Seat #3 is the button
Seat 1: soundfsilenz ($41348 in chips)
Seat 2: Aksxone ($22865 in chips)
Seat 3: kimjongun ($63415 in chips)
Seat 4: ag2703 ($95967 in chips)
Seat 5: slotmachine ($57847 in chips)
Seat 6: TurnOnTuneInDropOut ($27439 in chips)
ag2703: posts small blind $200
slotmachine: posts big blind $400
*** HOLE CARDS ***
Dealt to TurnOnTuneInDropOut [5d 5s 8d 2h]
TurnOnTuneInDropOut: folds
soundfsilenz: folds
Aksxone: calls $400
kimjongun: raises $1400 to $1800
ag2703: calls $1600
slotmachine: calls $1400
Aksxone: calls $1400
*** FLOP *** [Td Jh 4s]
ag2703: bets $7200
slotmachine: folds
Aksxone: raises $13865 to $21065 and is all-in
kimjongun: folds
ag2703: calls $13865
*** TURN *** [Td Jh 4s] [Qc]
*** RIVER *** [Td Jh 4s Qc] [Ks]
*** SHOW DOWN ***
ag2703: shows [9c Ac Ts Js]
Aksxone: shows [Qh 8h 4d Tc]
ag2703 collected $48530 from pot
*** SUMMARY ***
Total pot $49330 | Rake $800
Board [Td Jh 4s Qc Ks]
Seat 1: soundfsilenz folded before Flop (didn't bet)
Seat 2: Aksxone showed [Qh 8h 4d Tc] and lost
Seat 3: kimjongun (button) folded on the Flop
Seat 4: ag2703 (small blind) showed [9c Ac Ts Js] and won ($48530)
Seat 5: slotmachine (big blind) folded on the Flop
Seat 6: TurnOnTuneInDropOut folded before Flop (didn't bet)

PokerStars Hand #228844251: Omaha Pot Limit ($200/$400 USD) - 2020/10/23 13:56:14 ET
Table 'ADA409467368' 6-max Seat #4 is the button
Seat 1: soundfsilenz ($41348 in chips)
Seat 3: kimjongun ($61615 in chips)
Seat 4: ag2703 ($121632 in chips)
Seat 5: slotmachine ($56047 in chips)
Seat 6: TurnOnTuneInDropOut ($27439 in chips)
slotmachine: posts small blind $200
TurnOnTuneInDropOut: posts big blind $400
*** HOLE CARDS ***
Dealt to TurnOnTuneInDropOut [Ad Td 7d 8s]
soundfsilenz: folds
kimjongun: folds
ag2703: raises $1000 to $1400
slotmachine: folds
TurnOnTuneInDropOut: calls $1000
*** FLOP *** [4s 5s Kh]
TurnOnTuneInDropOut: checks
ag2703: bets $3000
TurnOnTuneInDropOut: folds
Uncalled bet ($3000) returned to ag2703
ag2703 collected $2880 from pot
ag2703: doesn't show hand
*** SUMMARY ***
Total pot $3000 | Rake $120
Board [4s 5s Kh]
Seat 1: soundfsilenz folded before Flop (didn't bet)
Seat 3: kimjongun folded before Flop (didn't bet)
Seat 4: ag2703 (button) collected ($2880)
Seat 5: slotmachine (small blind) folded before Flop
Seat 6: TurnOnTuneInDropOut (big blind) folded on the Flop

PokerStars Hand #228844252: Omaha Pot Limit ($200/$400 USD) - 2020/10/23 13:56:51 ET
Table 'ADA409467368' 6-max Seat #5 is the button
Seat 1: soundfsilenz ($41348 in chips)
Seat 3: kimjongun ($61615 in chips)
Seat 4: ag2703 ($123112 in chips)
Seat 5: slotmachine ($55847 in chips)
Seat 6: TurnOnTuneInDropOut ($26039 in chips)
TurnOnTuneInDropOut: posts small blind $200
soundfsilenz: posts big blind $400
*** HOLE CARDS ***
Dealt to TurnOnTuneInDropOut [8d Kd 9s Kc]
kimjongun: folds
ag2703: folds
slotmachine: folds
TurnOnTuneInDropOut: raises $800 to $1200
soundfsilenz: calls $800
*** FLOP *** [Tc 2h 6h]
TurnOnTuneInDropOut: checks
soundfsilenz: checks
*** TURN *** [Tc 2h 6h] [9c]
TurnOnTuneInDropOut: checks
soundfsilenz: checks
*** RIVER *** [Tc 2h 6h 9c] [Qd]
TurnOnTuneInDropOut: checks
soundfsilenz: checks
*** SHOW DOWN ***
TurnOnTuneInDropOut: shows [8d Kd 9s Kc]
soundfsilenz: mucks hand
TurnOnTuneInDropOut collected $2304 from pot
*** SUMMARY ***
Total pot $2400 | Rake $96
Board [Tc 2h 6h 9c Qd]
Seat 1: soundfsilenz (big blind) mucked
Seat 3: kimjongun folded before Flop (didn't bet)
Seat 4: ag2703 folded before Flop (didn't bet)
Seat 5: slotmachine (button) folded before Flop (didn't bet)
Seat 6: TurnOnTuneInDropOut (small blind) showed [8d Kd 9s Kc] and won ($2304)

PokerStars Hand #228844255: Omaha Pot Limit ($200/$400 USD) - 2020/10/23 13:59:56 ET
Table 'ADA409467368' 6-max Seat #2 is the button
Seat 1: soundfsilenz ($35948 in chips)
Seat 2: Aksxone ($24612 in chips)
Seat 3: kimjongun ($61215 in chips)
Seat 4: ag2703 ($122312 in chips)
Seat 5: slotmachine ($55847 in chips)
Seat 6: TurnOnTuneInDropOut ($27143 in chips)
kimjongun: posts small blind $200
ag2703: posts big blind $400
*** HOLE CARDS ***
Dealt to TurnOnTuneInDropOut [Jd Js Kd 9h]
slotmachine: folds
TurnOnTuneInDropOut: raises $1000 to $1400
soundfsilenz: folds
Aksxone: calls $1400
kimjongun: folds
ag2703: folds
*** FLOP *** [Ks 8h Th]
TurnOnTuneInDropOut: checks
Aksxone: bets $3400
TurnOnTuneInDropOut: calls $3400
*** TURN *** [Ks 8h Th] [3s]
TurnOnTuneInDropOut: checks
Aksxone: checks
*** RIVER *** [Ks 8h Th 3s] [6h]
TurnOnTuneInDropOut: checks
Aksxone: bets $3200
TurnOnTuneInDropOut: folds
Uncalled bet ($3200) returned to Aksxone
Aksxone collected $9791 from pot
Aksxone: doesn't show hand
*** SUMMARY ***
Total pot $10200 | Rake $409
Board [Ks 8h Th 3s 6h]
Seat 1: soundfsilenz folded before Flop (didn't bet)
Seat 2: Aksxone (button) collected ($9791)
Seat 3: kimjongun (small blind) folded before Flop
Seat 4: ag2703 (big blind) folded before Flop
Seat 5: slotmachine folded before Flop (didn't bet)
Seat 6: TurnOnTuneInDropOut folded on the River

PokerStars Hand #228844256: Omaha Pot Limit ($200/$400 USD) - 2020/10/23 14:01:56 ET
Table 'ADA409467368' 6-max Seat #3 is the button
Seat 1: soundfsilenz ($35948 in chips)
Seat 2: Aksxone ($29603 in chips)
Seat 3: kimjongun ($61015 in chips)
Seat 4: ag2703 ($121912 in chips)
Seat 5: slotmachine ($55847 in chips)
Seat 6: TurnOnTuneInDropOut ($22343 in chips)
ag2703: posts small blind $200
slotmachine: posts big blind $400
*** HOLE CARDS ***
Dealt to TurnOnTuneInDropOut [9h Js Ts 8d]
TurnOnTuneInDropOut: raises $1000 to $1400
soundfsilenz: folds
Aksxone: calls $1400
kimjongun: folds
ag2703: folds
slotmachine: folds
*** FLOP *** [Tc As 4c]
TurnOnTuneInDropOut: checks
Aksxone: bets $3400
TurnOnTuneInDropOut: folds
Uncalled bet ($3400) returned to Aksxone
Aksxone collected $3264 from pot
Aksxone: doesn't show hand
*** SUMMARY ***
Total pot $3400 | Rake $136
Board [Tc As 4c]
Seat 1: soundfsilenz folded before Flop (didn't bet)
Seat 2: Aksxone collected ($3264)
Seat 3: kimjongun (button) folded before Flop (didn't bet)
Seat 4: ag2703 (small blind) folded before Flop
Seat 5: slotmachine (big blind) folded before Flop
Seat 6: TurnOnTuneInDropOut folded on the Flop

PokerStars Hand #228844259: Omaha Pot Limit ($200/$400 USD) - 2020/10/23 14:05:02 ET
Table 'ADA409467368' 6-max Seat #6 is the button
Seat 1: soundfsilenz ($35548 in chips)
Seat 2: Aksxone ($35626 in chips)
Seat 3: kimjongun ($59215 in chips)
Seat 4: ag2703 ($119912 in chips)
Seat 5: slotmachine ($55247 in chips)
Seat 6: TurnOnTuneInDropOut ($33163 in chips)
soundfsilenz: posts small blind $200
Aksxone: posts big blind $400
*** HOLE CARDS ***
Dealt to TurnOnTuneInDropOut [6d Jd 7c 3h]
kimjongun: folds
ag2703: raises $1000 to $1400
slotmachine: folds
TurnOnTuneInDropOut: folds
soundfsilenz: folds
Aksxone: calls $1000
*** FLOP *** [5d 2s Kc]
Aksxone: checks
ag2703: bets $3000
Aksxone: calls $3000
*** TURN *** [5d 2s Kc] [7d]
Aksxone: checks
ag2703: checks
*** RIVER *** [5d 2s Kc 7d] [4c]
Aksxone: checks
ag2703: checks
*** SHOW DOWN ***
Aksxone: mucks hand
ag2703: shows [Ah Td Ac 9h]
ag2703 collected $8639 from pot
*** SUMMARY ***
Total pot $9000 | Rake $361
Board [5d 2s Kc 7d 4c]
Seat 1: soundfsilenz (small blind) folded before Flop
Seat 2: Aksxone (big blind) mucked
Seat 3: kimjongun folded before Flop (didn't bet)
Seat 4: ag2703 showed [Ah Td Ac 9h] and won ($8639)
Seat 5: slotmachine folded before Flop (didn't bet)
Seat 6: TurnOnTuneInDropOut (button) folded before Flop (didn't bet)

PokerStars Hand #228844261: Omaha Pot Limit ($200/$400 USD) - 2020/10/23 14:06:43 ET
Table 'ADA409467368' 6-max Seat #2 is the button
Seat 1: soundfsilenz ($35948 in chips)
Seat 2: Aksxone ($31026 in chips)
Seat 3: kimjongun ($58815 in chips)
Seat 4: ag2703 ($124151 in chips)
Seat 5: slotmachine ($55247 in chips)
Seat 6: TurnOnTuneInDropOut ($33163 in chips)
kimjongun: posts small blind $200
ag2703: posts big blind $400
*** HOLE CARDS ***
Dealt to TurnOnTuneInDropOut [As 5d 8h 3h]
slotmachine: folds
TurnOnTuneInDropOut: folds
soundfsilenz: raises $1000 to $1400
Aksxone: folds
kimjongun: folds
ag2703: folds
Uncalled bet ($1000) returned to soundfsilenz
soundfsilenz collected $1000 from pot
soundfsilenz: doesn't show hand
*** SUMMARY ***
Total pot $1000 | Rake $0
Seat 1: soundfsilenz collected ($1000)
Seat 2: Aksxone (button) folded before Flop (didn't bet)
Seat 3: kimjongun (small blind) folded before Flop
Seat 4: ag2703 (big blind) folded before Flop
Seat 5: slotmachine folded before Flop (didn't bet)
Seat 6: TurnOnTuneInDropOut folded before Flop (didn't bet)

PokerStars Hand #228844262: Omaha Pot Limit ($200/$400 USD) - 2020/10/23 14:07:30 ET
Table 'ADA409467368' 6-max Seat #3 is the button
Seat 1: soundfsilenz ($36548 in chips)
Seat 2: Aksxone ($31026 in chips)
Seat 3: kimjongun ($58615 in chips)
Seat 4: ag2703 ($123751 in chips)
Seat 5: slotmachine ($55247 in chips)
Seat 6: TurnOnTuneInDropOut ($33163 in chips)
ag2703: posts small blind $200
slotmachine: posts big blind $400
*** HOLE CARDS ***
Dealt to TurnOnTuneInDropOut [4d Kc 7h 8s]
TurnOnTuneInDropOut: folds
soundfsilenz: folds
Aksxone: folds
kimjongun: raises $1000 to $1400
ag2703: calls $1200
slotmachine: folds
*** FLOP *** [Jh Td 3s]
ag2703: checks
kimjongun: checks
*** TURN *** [Jh Td 3s] [Jc]
ag2703: checks
kimjongun: checks
*** RIVER *** [Jh Td 3s Jc] [6d]
ag2703: checks
kimjongun: bets $2112
ag2703: calls $2112
*** SHOW DOWN ***
ag2703: shows [Qh Qs 5h 2s]
kimjongun: shows [Ac 9d 2h As]
kimjongun collected $7126 from pot
*** SUMMARY ***
Total pot $7424 | Rake $298
Board [Jh Td 3s Jc 6d]
Seat 1: soundfsilenz folded before Flop (didn't bet)
Seat 2: Aksxone folded before Flop (didn't bet)
Seat 3: kimjongun (button) showed [Ac 9d 2h As] and won ($7126)
Seat 4: ag2703 (small blind) showed [Qh Qs 5h 2s] and lost
Seat 5: slotmachine (big blind) folded before Flop
Seat 6: TurnOnTuneInDropOut folded before Flop (didn't bet)

PokerStars Hand #228844265: Omaha Pot Limit ($200/$400 USD) - 2020/10/23 14:10:19 ET
Table 'ADA409467368' 6-max Seat #6 is the button
Seat 1: soundfsilenz ($36148 in chips)
Seat 2: Aksxone ($31186 in chips)
Seat 3: kimjongun ($62229 in chips)
Seat 4: ag2703 ($121375 in chips)
Seat 5: slotmachine ($54447 in chips)
Seat 6: TurnOnTuneInDropOut ($32563 in chips)
soundfsilenz: posts small blind $200
Aksxone: posts big blind $400
*** HOLE CARDS ***
Dealt to TurnOnTuneInDropOut [2s Tc Ks 3h]
kimjongun: folds
ag2703: folds
slotmachine: raises $1000 to $1400
TurnOnTuneInDropOut: folds
soundfsilenz: folds
Aksxone: calls $1000
*** FLOP *** [Qh Jc Th]
Aksxone: bets $3000
slotmachine: calls $3000
*** TURN *** [Qh Jc Th] [7s]
Aksxone: bets $9000
slotmachine: folds
Uncalled bet ($9000) returned to Aksxone
Aksxone collected $8639 from pot
Aksxone: doesn't show hand
*** SUMMARY ***
Total pot $9000 | Rake $361
Board [Qh Jc Th 7s]
Seat 1: soundfsilenz (small blind) folded before Flop
Seat 2: Aksxone (big blind) collected ($8639)
Seat 3: kimjongun folded before Flop (didn't bet)
Seat 4: ag2703 folded before Flop (didn't bet)
Seat 5: slotmachine folded on the Turn
Seat 6: TurnOnTuneInDropOut (button) folded before Flop (didn't bet)

PokerStars Hand #228844266: Omaha Pot Limit ($200/$400 USD) - 2020/10/23 14:11:09 ET
Table 'ADA409467368' 6-max Seat #1 is the button
Seat 1: soundfsilenz ($35948 in chips)
Seat 2: Aksxone ($35425 in chips)
Seat 3: kimjongun ($62229 in chips)
Seat 4: ag2703 ($121375 in chips)
Seat 5: slotmachine ($50047 in chips)
Seat 6: TurnOnTuneInDropOut ($32563 in chips)
Aksxone: posts small blind $200
kimjongun: posts big blind $400
*** HOLE CARDS ***
Dealt to TurnOnTuneInDropOut [8s Th 2s Qd]
ag2703: folds
slotmachine: raises $1000 to $1400
TurnOnTuneInDropOut: folds
soundfsilenz: folds
Aksxone: calls $1200
kimjongun: raises $4200 to $5600
slotmachine: folds
Aksxone: calls $4200
*** FLOP *** [Qh Jc 8h]
Aksxone: checks
kimjongun: bets $9450
Aksxone: folds
Uncalled bet ($9450) returned to kimjongun
kimjongun collected $12095 from pot
kimjongun: doesn't show hand
*** SUMMARY ***
Total pot $12600 | Rake $505
Board [Qh Jc 8h]
Seat 1: soundfsilenz (button) folded before Flop (didn't bet)
Seat 2: Aksxone (small blind) folded on the Flop
Seat 3: kimjongun (big blind) collected ($12095)
Seat 4: ag2703 folded before Flop (didn't bet)
Seat 5: slotmachine folded before Flop
Seat 6: TurnOnTuneInDropOut folded before Flop (didn't bet)

PokerStars Hand #228844267: Omaha Pot Limit ($200/$400 USD) - 2020/10/23 14:12:32 ET
Table 'ADA409467368' 6-max Seat #2 is the button
Seat 1: soundfsilenz ($35948 in chips)
Seat 2: Aksxone ($29825 in chips)
Seat 3: kimjongun ($68724 in chips)
Seat 4: ag2703 ($121375 in chips)
Seat 5: slotmachine ($48647 in chips)
Seat 6: TurnOnTuneInDropOut ($32563 in chips)
kimjongun: posts small blind $200
ag2703: posts big blind $400
*** HOLE CARDS ***
Dealt to TurnOnTuneInDropOut [6d 8s 2h 8c]
slotmachine: folds
TurnOnTuneInDropOut: folds
soundfsilenz: raises $400 to $800
Aksxone: raises $2200 to $3000
kimjongun: folds
ag2703: calls $2600
soundfsilenz: folds
*** FLOP *** [Kd 2d 5d]
ag2703: checks
Aksxone: bets $7000
ag2703: folds
Uncalled bet ($7000) returned to Aksxone
Aksxone collected $6719 from pot
Aksxone: doesn't show hand
*** SUMMARY ***
Total pot $7000 | Rake $281
Board [Kd 2d 5d]
Seat 1: soundfsilenz folded before Flop
Seat 2: Aksxone (button) collected ($6719)
Seat 3: kimjongun (small blind) folded before Flop
Seat 4: ag2703 (big blind) folded on the Flop
Seat 5: slotmachine folded before Flop (didn't bet)
Seat 6: TurnOnTuneInDropOut folded before Flop (didn't bet)

PokerStars Hand #228844268: Omaha Pot Limit ($200/$400 USD) - 2020/10/23 14:13:37 ET
Table 'ADA409467368' 6-max Seat #3 is the button
Seat 1: soundfsilenz ($35148 in chips)
Seat 2: Aksxone ($33544 in chips)
Seat 3: kimjongun ($68524 in chips)
Seat 4: ag2703 ($118375 in chips)
Seat 5: slotmachine ($48647 in chips)
Seat 6: TurnOnTuneInDropOut ($32563 in chips)
ag2703: posts small blind $200
slotmachine: posts big blind $400
*** HOLE CARDS ***
Dealt to TurnOnTuneInDropOut [9d 4c 6h 9h]
TurnOnTuneInDropOut: folds
soundfsilenz: folds
Aksxone: calls $400
kimjongun: raises $1400 to $1800
ag2703: folds
slotmachine: folds
Aksxone: calls $1400
*** FLOP *** [3c Kh 8d]
Aksxone: checks
kimjongun: checks
*** TURN *** [3c Kh 8d] [Jc]
Aksxone: bets $4200
kimjongun: calls $4200
*** RIVER *** [3c Kh 8d Jc] [7c]
Aksxone: checks
kimjongun: bets $12600
Aksxone: calls $12600
*** SHOW DOWN ***
Aksxone: mucks hand
kimjongun: shows [Ac 4d Tc Qs]
kimjongun collected $37000 from pot
*** SUMMARY ***
Total pot $37800 | Rake $800
Board [3c Kh 8d Jc 7c]
Seat 1: soundfsilenz folded before Flop (didn't bet)
Seat 2: Aksxone mucked
Seat 3: kimjongun (button) showed [Ac 4d Tc Qs] and won ($37000)
Seat 4: ag2703 (small blind) folded before Flop
Seat 5: slotmachine (big blind) folded before Flop
Seat 6: TurnOnTuneInDropOut folded before Flop (didn't bet)

PokerStars Hand #228844269: Omaha Pot Limit ($200/$400 USD) - 2020/10/23 14:15:14 ET
Table 'ADA409467368' 6-max Seat #4 is the button
Seat 1: soundfsilenz ($35148 in chips)
Seat 2: Aksxone ($14944 in chips)
Seat 3: kimjongun ($86924 in chips)
Seat 4: ag2703 ($118175 in chips)
Seat 5: slotmachine ($48247 in chips)
Seat 6: TurnOnTuneInDropOut ($32563 in chips)
slotmachine: posts small blind $200
TurnOnTuneInDropOut: posts big blind $400
*** HOLE CARDS ***
Dealt to TurnOnTuneInDropOut [8d Ks 2s Jh]
soundfsilenz: folds
Aksxone: folds
kimjongun: folds
ag2703: raises $1000 to $1400
slotmachine: folds
TurnOnTuneInDropOut: folds
Uncalled bet ($1000) returned to ag2703
ag2703 collected $1000 from pot
ag2703: doesn't show hand
*** SUMMARY ***
Total pot $1000 | Rake $0
Seat 1: soundfsilenz folded before Flop (didn't bet)
Seat 2: Aksxone folded before Flop (didn't bet)
Seat 3: kimjongun folded before Flop (didn't bet)
Seat 4: ag2703 (button) collected ($1000)
Seat 5: slotmachine (small blind) folded before Flop
Seat 6: TurnOnTuneInDropOut (big blind) folded before Flop

PokerStars Hand #228844270: Omaha Pot Limit ($200/$400 USD) - 2020/10/23 14:15:35 ET
Table 'ADA409467368' 6-max Seat #5 is the button
Seat 1: soundfsilenz ($35148 in chips)
Seat 2: Aksxone ($14944 in chips)
Seat 3: kimjongun ($86924 in chips)
Seat 4: ag2703 ($118775 in chips)
Seat 5: slotmachine ($48047 in chips)
Seat 6: TurnOnTuneInDropOut ($32163 in chips)
TurnOnTuneInDropOut: posts small blind $200
soundfsilenz: posts big blind $400
*** HOLE CARDS ***
Dealt to TurnOnTuneInDropOut [4h 9c Ad Qs]
Aksxone: folds
kimjongun: raises $600 to $1000
ag2703: folds
slotmachine: folds
TurnOnTuneInDropOut: folds
soundfsilenz: folds
Uncalled bet ($600) returned to kimjongun
kimjongun collected $1000 from pot
kimjongun: doesn't show hand
*** SUMMARY ***
Total pot $1000 | Rake $0
Seat 1: soundfsilenz (big blind) folded before Flop
Seat 2: Aksxone folded before Flop (didn't bet)
Seat 3: kimjongun collected ($1000)
Seat 4: ag2703 folded before Flop (didn't bet)
Seat 5: slotmachine (button) folded before Flop (didn't bet)
Seat 6: TurnOnTuneInDropOut (small blind) folded before Flop

PokerStars Hand #228844272: Omaha Pot Limit ($200/$400 USD) - 2020/10/23 14:17:24 ET
Table 'ADA409467368' 6-max Seat #1 is the button
Seat 1: soundfsilenz ($34548 in chips)
Seat 2: Aksxone ($15872 in chips)
Seat 3: kimjongun ($87524 in chips)
Seat 4: ag2703 ($117975 in chips)
Seat 5: slotmachine ($48047 in chips)
Seat 6: TurnOnTuneInDropOut ($48000 in chips)
Aksxone: posts small blind $200
kimjongun: posts big blind $400
*** HOLE CARDS ***
Dealt to TurnOnTuneInDropOut [5d 7c Ks Jc]
ag2703: folds
slotmachine: folds
TurnOnTuneInDropOut: folds
soundfsilenz: raises $1000 to $1400
Aksxone: calls $1200
kimjongun: folds
*** FLOP *** [As Ad 9h]
Aksxone: checks
soundfsilenz: checks
*** TURN *** [As Ad 9h] [7d]
Aksxone: bets $3200
soundfsilenz: calls $3200
*** RIVER *** [As Ad 9h 7d] [Qs]
Aksxone: bets $9600
soundfsilenz: calls $9600
*** SHOW DOWN ***
Aksxone: shows [Tc 2c Ac 3d]
soundfsilenz: mucks hand
Aksxone collected $28000 from pot
*** SUMMARY ***
Total pot $28800 | Rake $800
Board [As Ad 9h 7d Qs]
Seat 1: soundfsilenz (button) mucked
Seat 2: Aksxone (small blind) showed [Tc 2c Ac 3d] and won ($28000)
Seat 3: kimjongun (big blind) folded before Flop
Seat 4: ag2703 folded before Flop (didn't bet)
Seat 5: slotmachine folded before Flop (didn't bet)
Seat 6: TurnOnTuneInDropOut folded before Flop (didn't bet)

PokerStars Hand #228844273: Omaha Pot Limit ($200/$400 USD) - 2020/10/23 14:19:10 ET
Table 'ADA409467368' 6-max Seat #2 is the button
Seat 1: soundfsilenz ($20348 in chips)
Seat 2: Aksxone ($29672 in chips)
Seat 3: kimjongun ($87124 in chips)
Seat 4: ag2703 ($117975 in chips)
Seat 5: slotmachine ($48047 in chips)
Seat 6: TurnOnTuneInDropOut ($48000 in chips)
kimjongun: posts small blind $200
ag2703: posts big blind $400
*** HOLE CARDS ***
Dealt to TurnOnTuneInDropOut [Qc 6d 2c 3s]
slotmachine: folds
TurnOnTuneInDropOut: folds
soundfsilenz: folds
Aksxone: calls $400
kimjongun: calls $200
ag2703: raises $400 to $800
Aksxone: calls $400
kimjongun: folds
*** FLOP *** [Jc 9h Kd]
ag2703: checks
Aksxone: checks
*** TURN *** [Jc 9h Kd] [9d]
ag2703: checks
Aksxone: checks
*** RIVER *** [Jc 9h Kd 9d] [Qs]
ag2703: checks
Aksxone: bets $2000
ag2703: folds
Uncalled bet ($2000) returned to Aksxone
Aksxone collected $1920 from pot
Aksxone: doesn't show hand
*** SUMMARY ***
Total pot $2000 | Rake $80
Board [Jc 9h Kd 9d Qs]
Seat 1: soundfsilenz folded before Flop (didn't bet)
Seat 2: Aksxone (button) collected ($1920)
Seat 3: kimjongun (small blind) folded before Flop
Seat 4: ag2703 (big blind) folded on the River
Seat 5: slotmachine folded before Flop (didn't bet)
Seat 6: TurnOnTuneInDropOut folded before Flop (didn't bet)

PokerStars Hand #228844274: Omaha Pot Limit ($200/$400 USD) - 2020/10/23 14:20:51 ET
Table 'ADA409467368' 6-max Seat #3 is the button
Seat 1: soundfsilenz ($44349 in chips)
Seat 2: Aksxone ($30792 in chips)
Seat 3: kimjongun ($86724 in chips)
Seat 4: ag2703 ($117175 in chips)
Seat 5: slotmachine ($48047 in chips)
Seat 6: TurnOnTuneInDropOut ($48000 in chips)
ag2703: posts small blind $200
slotmachine: posts big blind $400
*** HOLE CARDS ***
Dealt to TurnOnTuneInDropOut [6h 4d 6c 3s]
TurnOnTuneInDropOut: folds
soundfsilenz: raises $1000 to $1400
Aksxone: calls $1400
kimjongun: folds
ag2703: folds
slotmachine: folds
*** FLOP *** [Kc 9h Ad]
soundfsilenz: bets $2278
Aksxone: folds
Uncalled bet ($2278) returned to soundfsilenz
soundfsilenz collected $3264 from pot
soundfsilenz: doesn't show hand
*** SUMMARY ***
Total pot $3400 | Rake $136
Board [Kc 9h Ad]
Seat 1: soundfsilenz collected ($3264)
Seat 2: Aksxone folded on the Flop
Seat 3: kimjongun (button) folded before Flop (didn't bet)
Seat 4: ag2703 (small blind) folded before Flop
Seat 5: slotmachine (big blind) folded before Flop
Seat 6: TurnOnTuneInDropOut folded before Flop (didn't bet)

PokerStars Hand #228844277: Omaha Pot Limit ($200/$400 USD) - 2020/10/23 14:24:55 ET
Table 'ADA409467368' 6-max Seat #6 is the button
Seat 1: soundfsilenz ($45813 in chips)
Seat 2: Aksxone ($28992 in chips)
Seat 3: kimjongun ($86724 in chips)
Seat 4: ag2703 ($120823 in chips)
Seat 5: slotmachine ($47447 in chips)
Seat 6: TurnOnTuneInDropOut ($44852 in chips)
soundfsilenz: posts small blind $200
Aksxone: posts big blind $400
*** HOLE CARDS ***
Dealt to TurnOnTuneInDropOut [Jc As 4s Ah]
kimjongun: folds
ag2703: folds
slotmachine: folds
TurnOnTuneInDropOut: raises $1000 to $1400
soundfsilenz: folds
Aksxone: folds
Uncalled bet ($1000) returned to TurnOnTuneInDropOut
TurnOnTuneInDropOut collected $1000 from pot
TurnOnTuneInDropOut: doesn't show hand
*** SUMMARY ***
Total pot $1000 | Rake $0
Seat 1: soundfsilenz (small blind) folded before Flop
Seat 2: Aksxone (big blind) folded before Flop
Seat 3: kimjongun folded before Flop (didn't bet)
Seat 4: ag2703 folded before Flop (didn't bet)
Seat 5: slotmachine folded before Flop (didn't bet)
Seat 6: TurnOnTuneInDropOut (button) collected ($1000)

PokerStars Hand #228844278: Omaha Pot Limit ($200/$400 USD) - 2020/10/23 14:25:36 ET
Table 'ADA409467368' 6-max Seat #1 is the button
Seat 1: soundfsilenz ($45613 in chips)
Seat 2: Aksxone ($28592 in chips)
Seat 3: kimjongun ($86724 in chips)
Seat 4: ag2703 ($120823 in chips)
Seat 5: slotmachine ($47447 in chips)
Seat 6: TurnOnTuneInDropOut ($45452 in chips)
Aksxone: posts small blind $200
kimjongun: posts big blind $400
*** HOLE CARDS ***
Dealt to TurnOnTuneInDropOut [Qc 2d 4d Jc]
ag2703: folds
slotmachine: folds
TurnOnTuneInDropOut: folds
soundfsilenz: folds
Aksxone: folds
Uncalled bet ($200) returned to kimjongun
kimjongun collected $400 from pot
kimjongun: doesn't show hand
*** SUMMARY ***
Total pot $400 | Rake $0
Seat 1: soundfsilenz (button) folded before Flop (didn't bet)
Seat 2: Aksxone (small blind) folded before Flop
Seat 3: kimjongun (big blind) collected ($400)
Seat 4: ag2703 folded before Flop (didn't bet)
Seat 5: slotmachine folded before Flop (didn't bet)
Seat 6: TurnOnTuneInDropOut folded before Flop (didn't bet)

PokerStars Hand #228844279: Omaha Pot Limit ($200/$400 USD) - 2020/10/23 14:26:22 ET
Table 'ADA409467368' 6-max Seat #2 is the button
Seat 1: soundfsilenz ($45613 in chips)
Seat 2: Aksxone ($28392 in chips)
Seat 3: kimjongun ($86924 in chips)
Seat 4: ag2703 ($120823 in chips)
Seat 5: slotmachine ($47447 in chips)
Seat 6: TurnOnTuneInDropOut ($45452 in chips)
kimjongun: posts small blind $200
ag2703: posts big blind $400
*** HOLE CARDS ***
Dealt to TurnOnTuneInDropOut [Js 8h Kd 9c]
slotmachine: raises $1000 to $1400
TurnOnTuneInDropOut: folds
soundfsilenz: folds
Aksxone: calls $1400
kimjongun: folds
ag2703: calls $1000
*** FLOP *** [Jd Kh 2h]
ag2703: checks
slotmachine: checks
Aksxone: bets $4400
ag2703: folds
slotmachine: folds
Uncalled bet ($4400) returned to Aksxone
Aksxone collected $4224 from pot
Aksxone: doesn't show hand
*** SUMMARY ***
Total pot $4400 | Rake $176
Board [Jd Kh 2h]
Seat 1: soundfsilenz folded before Flop (didn't bet)
Seat 2: Aksxone (button) collected ($4224)
Seat 3: kimjongun (small blind) folded before Flop
Seat 4: ag2703 (big blind) folded on the Flop
Seat 5: slotmachine folded on the Flop
Seat 6: TurnOnTuneInDropOut folded before Flop (didn't bet)

PokerStars Hand #228844281: Omaha Pot Limit ($200/$400 USD) - 2020/10/23 14:29:39 ET
Table 'ADA409467368' 6-max Seat #5 is the button
Seat 1: soundfsilenz ($45613 in chips)
Seat 2: Aksxone ($25588 in chips)
Seat 4: ag2703 ($130386 in chips)
Seat 5: slotmachine ($40419 in chips)
Seat 6: TurnOnTuneInDropOut ($45052 in chips)
TurnOnTuneInDropOut: posts small blind $200
soundfsilenz: posts big blind $400
*** HOLE CARDS ***
Dealt to TurnOnTuneInDropOut [7c 4h 9h 9s]
Aksxone: raises $1000 to $1400
ag2703: calls $1400
slotmachine: folds
TurnOnTuneInDropOut: folds
soundfsilenz: folds
*** FLOP *** [Kc 8h 7d]
Aksxone: bets $3400
ag2703: calls $3400
*** TURN *** [Kc 8h 7d] [6s]
Aksxone: bets $10200
ag2703: raises $10200 to $20400
Aksxone: raises $388 to $20788 and is all-in
ag2703: calls $388
*** RIVER *** [Kc 8h 7d 6s] [Th]
*** SHOW DOWN ***
Aksxone: shows [6d 5c Ac 8d]
ag2703: shows [7s 7h 9d 6h]
ag2703 collected $50976 from pot
*** SUMMARY ***
Total pot $51776 | Rake $800
Board [Kc 8h 7d 6s Th]
Seat 1: soundfsilenz (big blind) folded before Flop
Seat 2: Aksxone showed [6d 5c Ac 8d] and lost
Seat 4: ag2703 showed [7s 7h 9d 6h] and won ($50976)
Seat 5: slotmachine (button) folded before Flop (didn't bet)
Seat 6: TurnOnTuneInDropOut (small blind) folded before Flop

PokerStars Hand #228844282: Omaha Pot Limit ($200/$400 USD) - 2020/10/23 14:30:38 ET
Table 'ADA409467368' 6-max Seat #6 is the button
Seat 1: soundfsilenz ($45213 in chips)
Seat 3: kimjongun ($86724 in chips)
Seat 4: ag2703 ($155774 in chips)
Seat 5: slotmachine ($40419 in chips)
Seat 6: TurnOnTuneInDropOut ($44852 in chips)
soundfsilenz: posts small blind $200
kimjongun: posts big blind $400
*** HOLE CARDS ***
Dealt to TurnOnTuneInDropOut [5c Kc Kh 3h]
ag2703: folds
slotmachine: folds
TurnOnTuneInDropOut: raises $1000 to $1400
soundfsilenz: folds
kimjongun: folds
Uncalled bet ($1000) returned to TurnOnTuneInDropOut
TurnOnTuneInDropOut collected $1000 from pot
TurnOnTuneInDropOut: doesn't show hand
*** SUMMARY ***
Total pot $1000 | Rake $0
Seat 1: soundfsilenz (small blind) folded before Flop
Seat 3: kimjongun (big blind) folded before Flop
Seat 4: ag2703 folded before Flop (didn't bet)
Seat 5: slotmachine folded before Flop (didn't bet)
Seat 6: TurnOnTuneInDropOut (button) collected ($1000)

PokerStars Hand #228844283: Omaha Pot Limit ($200/$400 USD) - 2020/10/23 14:31:16 ET
Table 'ADA409467368' 6-max Seat #1 is the button
Seat 1: soundfsilenz ($45013 in chips)
Seat 3: kimjongun ($86324 in chips)
Seat 4: ag2703 ($155774 in chips)
Seat 5: slotmachine ($40419 in chips)
Seat 6: TurnOnTuneInDropOut ($45452 in chips)
kimjongun: posts small blind $200
ag2703: posts big blind $400
*** HOLE CARDS ***
Dealt to TurnOnTuneInDropOut [6c 4c 9s 3h]
slotmachine: raises $1000 to $1400
TurnOnTuneInDropOut: folds
soundfsilenz: folds
kimjongun: folds
ag2703: calls $1000
*** FLOP *** [6s 7h 8s]
ag2703: checks
slotmachine: checks
*** TURN *** [6s 7h 8s] [3c]
ag2703: bets $3000
slotmachine: calls $3000
*** RIVER *** [6s 7h 8s 3c] [Kd]
ag2703: bets $9000
slotmachine: folds
Uncalled bet ($9000) returned to ag2703
ag2703 collected $8639 from pot
ag2703: doesn't show hand
*** SUMMARY ***
Total pot $9000 | Rake $361
Board [6s 7h 8s 3c Kd]
Seat 1: soundfsilenz (button) folded before Flop (didn't bet)
Seat 3: kimjongun (small blind) folded before Flop
Seat 4: ag2703 (big blind) collected ($8639)
Seat 5: slotmachine folded on the River
Seat 6: TurnOnTuneInDropOut folded before Flop (didn't bet)

PokerStars Hand #228844284: Omaha Pot Limit ($200/$400 USD) - 2020/10/23 14:32:30 ET
Table 'ADA409467368' 6-max Seat #3 is the button
Seat 1: soundfsilenz ($45013 in chips)
Seat 3: kimjongun ($86124 in chips)
Seat 4: ag2703 ($160013 in chips)
Seat 5: slotmachine ($48000 in chips)
Seat 6: TurnOnTuneInDropOut ($45452 in chips)
ag2703: posts small blind $200
slotmachine: posts big blind $400
*** HOLE CARDS ***
Dealt to TurnOnTuneInDropOut [Kh 2c 7c 3h]
TurnOnTuneInDropOut: folds
soundfsilenz: folds
kimjongun: raises $1000 to $1400
ag2703: folds
slotmachine: calls $1000
*** FLOP *** [7h 3s 9d]
slotmachine: checks
kimjongun: checks
*** TURN *** [7h 3s 9d] [Qd]
slotmachine: checks
kimjongun: bets $3000
slotmachine: folds
Uncalled bet ($3000) returned to kimjongun
kimjongun collected $2880 from pot
kimjongun: doesn't show hand
*** SUMMARY ***
Total pot $3000 | Rake $120
Board [7h 3s 9d Qd]
Seat 1: soundfsilenz folded before Flop (didn't bet)
Seat 3: kimjongun (button) collected ($2880)
Seat 4: ag2703 (small blind) folded before Flop
Seat 5: slotmachine (big blind) folded on the Turn
Seat 6: TurnOnTuneInDropOut folded before Flop (didn't bet)

PokerStars Hand #228844285: Omaha Pot Limit ($200/$400 USD) - 2020/10/23 14:33:16 ET
Table 'ADA409467368' 6-max Seat #4 is the button
Seat 1: soundfsilenz ($45013 in chips)
Seat 3: kimjongun ($87604 in chips)
Seat 4: ag2703 ($159813 in chips)
Seat 5: slotmachine ($46600 in chips)
Seat 6: TurnOnTuneInDropOut ($45452 in chips)
slotmachine: posts small blind $200
TurnOnTuneInDropOut: posts big blind $400
*** HOLE CARDS ***
Dealt to TurnOnTuneInDropOut [5d 9h Qh 6d]
soundfsilenz: raises $1000 to $1400
kimjongun: raises $3400 to $4800
ag2703: folds
slotmachine: folds
TurnOnTuneInDropOut: folds
soundfsilenz: raises $10200 to $15000
kimjongun: calls $10200
*** FLOP *** [Qs Ac Ad]
soundfsilenz: bets $30013 and is all-in
kimjongun: folds
Uncalled bet ($30013) returned to soundfsilenz
soundfsilenz collected $29800 from pot
soundfsilenz: doesn't show hand
*** SUMMARY ***
Total pot $30600 | Rake $800
Board [Qs Ac Ad]
Seat 1: soundfsilenz collected ($29800)
Seat 3: kimjongun folded on the Flop
Seat 4: ag2703 (button) folded before Flop (didn't bet)
Seat 5: slotmachine (small blind) folded before Flop
Seat 6: TurnOnTuneInDropOut (big blind) folded before Flop

PokerStars Hand #228844286: Omaha Pot Limit ($200/$400 USD) - 2020/10/23 14:35:01 ET
Table 'ADA409467368' 6-max Seat #5 is the button
Seat 1: soundfsilenz ($59813 in chips)
Seat 3: kimjongun ($72604 in chips)
Seat 4: ag2703 ($159813 in chips)
Seat 5: slotmachine ($46400 in chips)
Seat 6: TurnOnTuneInDropOut ($45052 in chips)
TurnOnTuneInDropOut: posts small blind $200
soundfsilenz: posts big blind $400
*** HOLE CARDS ***
Dealt to TurnOnTuneInDropOut [Qh 9d Qs 6s]
kimjongun: folds
ag2703: folds
slotmachine: raises $1000 to $1400
TurnOnTuneInDropOut: folds
soundfsilenz: folds
Uncalled bet ($1000) returned to slotmachine
slotmachine collected $1000 from pot
slotmachine: doesn't show hand
*** SUMMARY ***
Total pot $1000 | Rake $0
Seat 1: soundfsilenz (big blind) folded before Flop
Seat 3: kimjongun folded before Flop (didn't bet)
Seat 4: ag2703 folded before Flop (didn't bet)
Seat 5: slotmachine (button) collected ($1000)
Seat 6: TurnOnTuneInDropOut (small blind) folded before Flop

PokerStars Hand #228844287: Omaha Pot Limit ($200/$400 USD) - 2020/10/23 14:35:30 ET
Table 'ADA409467368' 6-max Seat #6 is the button
Seat 1: soundfsilenz ($59413 in chips)
Seat 3: kimjongun ($72604 in chips)
Seat 4: ag2703 ($159813 in chips)
Seat 5: slotmachine ($47000 in chips)
Seat 6: TurnOnTuneInDropOut ($44852 in chips)
soundfsilenz: posts small blind $200
kimjongun: posts big blind $400
*** HOLE CARDS ***
Dealt to TurnOnTuneInDropOut [5s 2s As 6d]
ag2703: raises $1000 to $1400
slotmachine: folds
TurnOnTuneInDropOut: folds
soundfsilenz: folds
kimjongun: folds
Uncalled bet ($1000) returned to ag2703
ag2703 collected $1000 from pot
ag2703: doesn't show hand
*** SUMMARY ***
Total pot $1000 | Rake $0
Seat 1: soundfsilenz (small blind) folded before Flop
Seat 3: kimjongun (big blind) folded before Flop
Seat 4: ag2703 collected ($1000)
Seat 5: slotmachine folded before Flop (didn't bet)
Seat 6: TurnOnTuneInDropOut (button) folded before Flop (didn't bet)

PokerStars Hand #228844288: Omaha Pot Limit ($200/$400 USD) - 2020/10/23 14:36:00 ET
Table 'ADA409467368' 6-max Seat #1 is the button
Seat 1: soundfsilenz ($59213 in chips)
Seat 3: kimjongun ($72204 in chips)
Seat 4: ag2703 ($160413 in chips)
Seat 5: slotmachine ($47000 in chips)
Seat 6: TurnOnTuneInDropOut ($44852 in chips)
kimjongun: posts small blind $200
ag2703: posts big blind $400
*** HOLE CARDS ***
Dealt to TurnOnTuneInDropOut [Jd Qc 3h 7d]
slotmachine: folds
TurnOnTuneInDropOut: folds
soundfsilenz: folds
kimjongun: folds
Uncalled bet ($200) returned to ag2703
ag2703 collected $400 from pot
ag2703: doesn't show hand
*** SUMMARY ***
Total pot $400 | Rake $0
Seat 1: soundfsilenz (button) folded before Flop (didn't bet)
Seat 3: kimjongun (small blind) folded before Flop
Seat 4: ag2703 (big blind) collected ($400)
Seat 5: slotmachine folded before Flop (didn't bet)
Seat 6: TurnOnTuneInDropOut folded before Flop (didn't bet)

PokerStars Hand #228844289: Omaha Pot Limit ($200/$400 USD) - 2020/10/23 14:36:25 ET
Table 'ADA409467368' 6-max Seat #3 is the button
Seat 1: soundfsilenz ($59213 in chips)
Seat 3: kimjongun ($72004 in chips)
Seat 4: ag2703 ($160613 in chips)
Seat 5: slotmachine ($47000 in chips)
Seat 6: TurnOnTuneInDropOut ($44852 in chips)
ag2703: posts small blind $200
slotmachine: posts big blind $400
*** HOLE CARDS ***
Dealt to TurnOnTuneInDropOut [5c 6d 8h Qs]
TurnOnTuneInDropOut: folds
soundfsilenz: folds
kimjongun: folds
ag2703: calls $200
slotmachine: checks
*** FLOP *** [7c 5d Jh]
ag2703: bets $800
slotmachine: calls $800
*** TURN *** [7c 5d Jh] [3d]
ag2703: checks
slotmachine: checks
*** RIVER *** [7c 5d Jh 3d] [6s]
ag2703: checks
slotmachine: bets $1200
ag2703: folds
Uncalled bet ($1200) returned to slotmachine
slotmachine collected $2304 from pot
slotmachine: doesn't show hand
*** SUMMARY ***
Total pot $2400 | Rake $96
Board [7c 5d Jh 3d 6s]
Seat 1: soundfsilenz folded before Flop (didn't bet)
Seat 3: kimjongun (button) folded before Flop (didn't bet)
Seat 4: ag2703 (small blind) folded on the River
Seat 5: slotmachine (big blind) collected ($2304)
Seat 6: TurnOnTuneInDropOut folded before Flop (didn't bet)

PokerStars Hand #228844291: Omaha Pot Limit ($200/$400 USD) - 2020/10/23 14:39:00 ET
Table 'ADA409467368' 6-max Seat #5 is the button
Seat 1: soundfsilenz ($59213 in chips)
Seat 4: ag2703 ($158013 in chips)
Seat 5: slotmachine ($47904 in chips)
Seat 6: TurnOnTuneInDropOut ($46332 in chips)
TurnOnTuneInDropOut: posts small blind $200
soundfsilenz: posts big blind $400
*** HOLE CARDS ***
Dealt to TurnOnTuneInDropOut [8c Ah Qh 2h]
ag2703: folds
slotmachine: raises $1000 to $1400
TurnOnTuneInDropOut: folds
soundfsilenz: folds
Uncalled bet ($1000) returned to slotmachine
slotmachine collected $1000 from pot
slotmachine: doesn't show hand
*** SUMMARY ***
Total pot $1000 | Rake $0
Seat 1: soundfsilenz (big blind) folded before Flop
Seat 4: ag2703 folded before Flop (didn't bet)
Seat 5: slotmachine (button) collected ($1000)
Seat 6: TurnOnTuneInDropOut (small blind) folded before Flop

PokerStars Hand #228844293: Omaha Pot Limit ($200/$400 USD) - 2020/10/23 14:40:13 ET
Table 'ADA409467368' 6-max Seat #1 is the button
Seat 1: soundfsilenz ($58613 in chips)
Seat 3: kimjongun ($71604 in chips)
Seat 4: ag2703 ($157613 in chips)
Seat 5: slotmachine ($49504 in chips)
Seat 6: TurnOnTuneInDropOut ($46132 in chips)
kimjongun: posts small blind $200
ag2703: posts big blind $400
*** HOLE CARDS ***
Dealt to TurnOnTuneInDropOut [7d 5d 6h Kd]
slotmachine: raises $1000 to $1400
TurnOnTuneInDropOut: folds
soundfsilenz: folds
kimjongun: raises $3200 to $4600
ag2703: folds
slotmachine: calls $3200
*** FLOP *** [6d Qs 8d]
kimjongun: checks
slotmachine: checks
*** TURN *** [6d Qs 8d] [Qc]
kimjongun: bets $4800
slotmachine: raises $12240 to $17040
kimjongun: raises $43680 to $60720
slotmachine: folds
Uncalled bet ($43680) returned to kimjongun
kimjongun collected $42880 from pot
kimjongun: doesn't show hand
*** SUMMARY ***
Total pot $43680 | Rake $800
Board [6d Qs 8d Qc]
Seat 1: soundfsilenz (button) folded before Flop (didn't bet)
Seat 3: kimjongun (small blind) collected ($42880)
Seat 4: ag2703 (big blind) folded before Flop
Seat 5: slotmachine folded on the Turn
Seat 6: TurnOnTuneInDropOut folded before Flop (didn't bet)

PokerStars Hand #228844294: Omaha Pot Limit ($200/$400 USD) - 2020/10/23 14:41:22 ET
Table 'ADA409467368' 6-max Seat #3 is the button
Seat 1: soundfsilenz ($58613 in chips)
Seat 3: kimjongun ($92844 in chips)
Seat 4: ag2703 ($157213 in chips)
Seat 5: slotmachine ($48000 in chips)
Seat 6: TurnOnTuneInDropOut ($46132 in chips)
ag2703: posts small blind $200
slotmachine: posts big blind $400
*** HOLE CARDS ***
Dealt to TurnOnTuneInDropOut [2h Td 8h 3h]
TurnOnTuneInDropOut: folds
soundfsilenz: raises $1000 to $1400
kimjongun: folds
ag2703: calls $1200
slotmachine: calls $1000
*** FLOP *** [4s 3s 9c]
ag2703: checks
slotmachine: checks
soundfsilenz: checks
*** TURN *** [4s 3s 9c] [Qd]
ag2703: checks
slotmachine: checks
soundfsilenz: checks
*** RIVER *** [4s 3s 9c Qd] [5d]
ag2703: checks
slotmachine: bets $3150
soundfsilenz: folds
ag2703: folds
Uncalled bet ($3150) returned to slotmachine
slotmachine collected $4032 from pot
slotmachine: doesn't show hand
*** SUMMARY ***
Total pot $4200 | Rake $168
Board [4s 3s 9c Qd 5d]
Seat 1: soundfsilenz folded on the River
Seat 3: kimjongun (button) folded before Flop (didn't bet)
Seat 4: ag2703 (small blind) folded on the River
Seat 5: slotmachine (big blind) collected ($4032)
Seat 6: TurnOnTuneInDropOut folded before Flop (didn't bet)

PokerStars Hand #228844364: Omaha Pot Limit ($200/$400 USD) - 2020/10/23 16:39:31 ET
Table 'ADA409467368' 6-max Seat #3 is the button
Seat 3: yatin47 ($50911 in chips)
Seat 4: hashstack ($22515 in chips)
Seat 5: TurnOnTuneInDropOut ($30000 in chips)
hashstack: posts small blind $200
TurnOnTuneInDropOut: posts big blind $400
*** HOLE CARDS ***
Dealt to TurnOnTuneInDropOut [7c 6h Kd 6s]
yatin47: folds
hashstack: raises $800 to $1200
TurnOnTuneInDropOut: folds
Uncalled bet ($800) returned to hashstack
hashstack collected $800 from pot
hashstack: doesn't show hand
*** SUMMARY ***
Total pot $800 | Rake $0
Seat 3: yatin47 (button) folded before Flop (didn't bet)
Seat 4: hashstack (small blind) collected ($800)
Seat 5: TurnOnTuneInDropOut (big blind) folded before Flop

PokerStars Hand #228844365: Omaha Pot Limit ($200/$400 USD) - 2020/10/23 16:39:46 ET
Table 'ADA409467368' 6-max Seat #4 is the button
Seat 3: yatin47 ($50911 in chips)
Seat 4: hashstack ($22915 in chips)
Seat 5: TurnOnTuneInDropOut ($29600 in chips)
TurnOnTuneInDropOut: posts small blind $200
yatin47: posts big blind $400
*** HOLE CARDS ***
Dealt to TurnOnTuneInDropOut [Ad 9s 5d 2h]
hashstack: raises $650 to $1050
TurnOnTuneInDropOut: folds
yatin47: calls $650
*** FLOP *** [As 7c 6d]
yatin47: checks
hashstack: bets $1725
yatin47: folds
Uncalled bet ($1725) returned to hashstack
hashstack collected $2208 from pot
hashstack: doesn't show hand
*** SUMMARY ***
Total pot $2300 | Rake $92
Board [As 7c 6d]
Seat 3: yatin47 (big blind) folded on the Flop
Seat 4: hashstack (button) collected ($2208)
Seat 5: TurnOnTuneInDropOut (small blind) folded before Flop

PokerStars Hand #228844366: Omaha Pot Limit ($200/$400 USD) - 2020/10/23 16:40:03 ET
Table 'ADA409467368' 6-max Seat #5 is the button
Seat 3: yatin47 ($49861 in chips)
Seat 4: hashstack ($24073 in chips)
Seat 5: TurnOnTuneInDropOut ($29400 in chips)
yatin47: posts small blind $200
hashstack: posts big blind $400
*** HOLE CARDS ***
Dealt to TurnOnTuneInDropOut [2c 8s Kh 2d]
TurnOnTuneInDropOut: folds
yatin47: calls $200
hashstack: raises $800 to $1200
yatin47: calls $800
*** FLOP *** [Tc Kc 9c]
yatin47: checks
hashstack: checks
*** TURN *** [Tc Kc 9c] [6h]
yatin47: checks
hashstack: checks
*** RIVER *** [Tc Kc 9c 6h] [Td]
yatin47: checks
hashstack: checks
*** SHOW DOWN ***
yatin47: shows [Ks 6c 7s Qc]
hashstack: mucks hand
yatin47 collected $2304 from pot
*** SUMMARY ***
Total pot $2400 | Rake $96
Board [Tc Kc 9c 6h Td]
Seat 3: yatin47 (small blind) showed [Ks 6c 7s Qc] and won ($2304)
Seat 4: hashstack (big blind) mucked
Seat 5: TurnOnTuneInDropOut (button) folded before Flop (didn't bet)

PokerStars Hand #228844368: Omaha Pot Limit ($200/$400 USD) - 2020/10/23 16:41:01 ET
Table 'ADA409467368' 6-max Seat #4 is the button
Seat 1: Sam565 ($12000 in chips)
Seat 3: yatin47 ($50565 in chips)
Seat 4: hashstack ($22473 in chips)
Seat 5: TurnOnTuneInDropOut ($30152 in chips)
TurnOnTuneInDropOut: posts small blind $200
Sam565: posts big blind $400
*** HOLE CARDS ***
Dealt to TurnOnTuneInDropOut [9s 7c 4d 4s]
yatin47: folds
hashstack: raises $650 to $1050
TurnOnTuneInDropOut: folds
Sam565: calls $650
*** FLOP *** [3s 7d 2c]
Sam565: checks
hashstack: bets $1600
Sam565: calls $1600
*** TURN *** [3s 7d 2c] [6d]
Sam565: checks
hashstack: bets $4125
Sam565: raises $5225 to $9350 and is all-in
hashstack: calls $5225
*** RIVER *** [3s 7d 2c 6d] [Kd]
*** SHOW DOWN ***
Sam565: shows [8d As 7h 6c]
hashstack: shows [Kc 3d 3h Jh]
hashstack collected $23400 from pot
*** SUMMARY ***
Total pot $24200 | Rake $800
Board [3s 7d 2c 6d Kd]
Seat 1: Sam565 (big blind) showed [8d As 7h 6c] and lost
Seat 3: yatin47 folded before Flop (didn't bet)
Seat 4: hashstack (button) showed [Kc 3d 3h Jh] and won ($23400)
Seat 5: TurnOnTuneInDropOut (small blind) folded before Flop

PokerStars Hand #228844369: Omaha Pot Limit ($200/$400 USD) - 2020/10/23 16:41:32 ET
Table 'ADA409467368' 6-max Seat #5 is the button
Seat 3: yatin47 ($50565 in chips)
Seat 4: hashstack ($33873 in chips)
Seat 5: TurnOnTuneInDropOut ($29952 in chips)
yatin47: posts small blind $200
hashstack: posts big blind $400
*** HOLE CARDS ***
Dealt to TurnOnTuneInDropOut [Jd Ac 2d Jc]
TurnOnTuneInDropOut: raises $1000 to $1400
yatin47: folds
hashstack: calls $1000
*** FLOP *** [5s 7h 9h]
hashstack: bets $2250
TurnOnTuneInDropOut: folds
Uncalled bet ($2250) returned to hashstack
hashstack collected $2880 from pot
hashstack: doesn't show hand
*** SUMMARY ***
Total pot $3000 | Rake $120
Board [5s 7h 9h]
Seat 3: yatin47 (small blind) folded before Flop
Seat 4: hashstack (big blind) collected ($2880)
Seat 5: TurnOnTuneInDropOut (button) folded on the Flop

PokerStars Hand #228844371: Omaha Pot Limit ($200/$400 USD) - 2020/10/23 16:42:26 ET
Table 'ADA409467368' 6-max Seat #4 is the button
Seat 1: Sam565 ($11600 in chips)
Seat 3: yatin47 ($51501 in chips)
Seat 4: hashstack ($34953 in chips)
Seat 5: TurnOnTuneInDropOut ($28152 in chips)
TurnOnTuneInDropOut: posts small blind $200
Sam565: posts big blind $400
*** HOLE CARDS ***
Dealt to TurnOnTuneInDropOut [Th 7d Ks 4h]
yatin47: folds
hashstack: raises $800 to $1200
TurnOnTuneInDropOut: folds
Sam565: raises $2600 to $3800
hashstack: calls $2600
*** FLOP *** [Kh 8d Qh]
Sam565: bets $7800 and is all-in
hashstack: calls $7800
*** TURN *** [Kh 8d Qh] [2s]
*** RIVER *** [Kh 8d Qh 2s] [3c]
*** SHOW DOWN ***
Sam565: shows [6s As 5d Ac]
hashstack: shows [4c 8s 6d 5c]
Sam565 collected $22600 from pot
*** SUMMARY ***
Total pot $23400 | Rake $800
Board [Kh 8d Qh 2s 3c]
Seat 1: Sam565 (big blind) showed [6s As 5d Ac] and won ($22600)
Seat 3: yatin47 folded before Flop (didn't bet)
Seat 4: hashstack (button) showed [4c 8s 6d 5c] and lost
Seat 5: TurnOnTuneInDropOut (small blind) folded before Flop

PokerStars Hand #228844372: Omaha Pot Limit ($200/$400 USD) - 2020/10/23 16:42:49 ET
Table 'ADA409467368' 6-max Seat #5 is the button
Seat 1: Sam565 ($22600 in chips)
Seat 3: yatin47 ($51501 in chips)
Seat 4: hashstack ($23353 in chips)
Seat 5: TurnOnTuneInDropOut ($27952 in chips)
Sam565: posts small blind $200
yatin47: posts big blind $400
*** HOLE CARDS ***
Dealt to TurnOnTuneInDropOut [9h 4h As Qd]
hashstack: raises $650 to $1050
TurnOnTuneInDropOut: folds
Sam565: calls $850
yatin47: calls $650
*** FLOP *** [2s 5c 7s]
Sam565: checks
yatin47: checks
hashstack: checks
*** TURN *** [2s 5c 7s] [Jh]
Sam565: checks
yatin47: checks
hashstack: bets $1975
Sam565: folds
yatin47: calls $1975
*** RIVER *** [2s 5c 7s Jh] [Ad]
yatin47: checks
hashstack: checks
*** SHOW DOWN ***
yatin47: mucks hand
hashstack: shows [Js 8d 9c 4d]
hashstack collected $6815 from pot
*** SUMMARY ***
Total pot $7100 | Rake $285
Board [2s 5c 7s Jh Ad]
Seat 1: Sam565 (small blind) folded on the Turn
Seat 3: yatin47 (big blind) mucked
Seat 4: hashstack showed [Js 8d 9c 4d] and won ($6815)
Seat 5: TurnOnTuneInDropOut (button) folded before Flop (didn't bet)

PokerStars Hand #228844373: Omaha Pot Limit ($200/$400 USD) - 2020/10/23 16:43:33 ET
Table 'ADA409467368' 6-max Seat #1 is the button
Seat 1: Sam565 ($21550 in chips)
Seat 3: yatin47 ($48476 in chips)
Seat 4: hashstack ($27143 in chips)
Seat 5: TurnOnTuneInDropOut ($48000 in chips)
yatin47: posts small blind $200
hashstack: posts big blind $400
*** HOLE CARDS ***
Dealt to TurnOnTuneInDropOut [6c 3c 9s 3s]
TurnOnTuneInDropOut: folds
Sam565: folds
yatin47: calls $200
hashstack: raises $800 to $1200
yatin47: raises $2400 to $3600
hashstack: calls $2400
*** FLOP *** [Ac 2s 5d]
yatin47: bets $7200
hashstack: folds
Uncalled bet ($7200) returned to yatin47
yatin47 collected $6911 from pot
yatin47: doesn't show hand
*** SUMMARY ***
Total pot $7200 | Rake $289
Board [Ac 2s 5d]
Seat 1: Sam565 (button) folded before Flop (didn't bet)
Seat 3: yatin47 (small blind) collected ($6911)
Seat 4: hashstack (big blind) folded on the Flop
Seat 5: TurnOnTuneInDropOut folded before Flop (didn't bet)

PokerStars Hand #228844375: Omaha Pot Limit ($200/$400 USD) - 2020/10/23 16:45:03 ET
Table 'ADA409467368' 6-max Seat #4 is the button
Seat 1: Sam565 ($21550 in chips)
Seat 3: yatin47 ($50187 in chips)
Seat 4: hashstack ($23143 in chips)
Seat 5: TurnOnTuneInDropOut ($49856 in chips)
TurnOnTuneInDropOut: posts small blind $200
Sam565: posts big blind $400
*** HOLE CARDS ***
Dealt to TurnOnTuneInDropOut [5d Td Tc 6h]
yatin47: folds
hashstack: raises $1000 to $1400
TurnOnTuneInDropOut: folds
Sam565: calls $1000
*** FLOP *** [Kh 3s 8s]
Sam565: checks
hashstack: bets $1500
Sam565: folds
Uncalled bet ($1500) returned to hashstack
hashstack collected $2880 from pot
hashstack: doesn't show hand
*** SUMMARY ***
Total pot $3000 | Rake $120
Board [Kh 3s 8s]
Seat 1: Sam565 (big blind) folded on the Flop
Seat 3: yatin47 folded before Flop (didn't bet)
Seat 4: hashstack (button) collected ($2880)
Seat 5: TurnOnTuneInDropOut (small blind) folded before Flop

PokerStars Hand #228844376: Omaha Pot Limit ($200/$400 USD) - 2020/10/23 16:45:27 ET
Table 'ADA409467368' 6-max Seat #5 is the button
Seat 1: Sam565 ($20150 in chips)
Seat 3: yatin47 ($50187 in chips)
Seat 4: hashstack ($24623 in chips)
Seat 5: TurnOnTuneInDropOut ($49656 in chips)
Sam565: posts small blind $200
yatin47: posts big blind $400
*** HOLE CARDS ***
Dealt to TurnOnTuneInDropOut [9h Ad Kc 4d]
hashstack: raises $400 to $800
TurnOnTuneInDropOut: raises $2200 to $3000
Sam565: folds
yatin47: folds
hashstack: calls $2200
*** FLOP *** [8s Jd 7d]
hashstack: checks
TurnOnTuneInDropOut: checks
*** TURN *** [8s Jd 7d] [6c]
hashstack: bets $5350
TurnOnTuneInDropOut: folds
Uncalled bet ($5350) returned to hashstack
hashstack collected $6335 from pot
hashstack: doesn't show hand
*** SUMMARY ***
Total pot $6600 | Rake $265
Board [8s Jd 7d 6c]
Seat 1: Sam565 (small blind) folded before Flop
Seat 3: yatin47 (big blind) folded before Flop
Seat 4: hashstack collected ($6335)
Seat 5: TurnOnTuneInDropOut (button) folded on the Turn

PokerStars Hand #228844377: Omaha Pot Limit ($200/$400 USD) - 2020/10/23 16:46:22 ET
Table 'ADA409467368' 6-max Seat #1 is the button
Seat 1: Sam565 ($19950 in chips)
Seat 3: yatin47 ($49787 in chips)
Seat 4: hashstack ($27958 in chips)
Seat 5: TurnOnTuneInDropOut ($46656 in chips)
Seat 6: craftplayer ($30000 in chips)
yatin47: posts small blind $200
hashstack: posts big blind $400
craftplayer: posts big blind $400
*** HOLE CARDS ***
Dealt to TurnOnTuneInDropOut [Td 5s Kd 2s]
TurnOnTuneInDropOut: folds
craftplayer: raises $400 to $800
Sam565: calls $800
yatin47: folds
hashstack: calls $400
*** FLOP *** [Ks Js 3h]
hashstack: checks
craftplayer: checks
Sam565: checks
*** TURN *** [Ks Js 3h] [Ad]
hashstack: checks
craftplayer: checks
Sam565: checks
*** RIVER *** [Ks Js 3h Ad] [Jc]
hashstack: checks
craftplayer: bets $1950
Sam565: folds
hashstack: folds
Uncalled bet ($1950) returned to craftplayer
craftplayer collected $2496 from pot
craftplayer: doesn't show hand
*** SUMMARY ***
Total pot $2600 | Rake $104
Board [Ks Js 3h Ad Jc]
Seat 1: Sam565 (button) folded on the River
Seat 3: yatin47 (small blind) folded before Flop
Seat 4: hashstack (big blind) folded on the River
Seat 5: TurnOnTuneInDropOut folded before Flop (didn't bet)
Seat 6: craftplayer collected ($2496)

PokerStars Hand #228844378: Omaha Pot Limit ($200/$400 USD) - 2020/10/23 16:48:11 ET
Table 'ADA409467368' 6-max Seat #3 is the button
Seat 1: Sam565 ($19150 in chips)
Seat 3: yatin47 ($49587 in chips)
Seat 4: hashstack ($27158 in chips)
Seat 5: TurnOnTuneInDropOut ($46656 in chips)
Seat 6: craftplayer ($31696 in chips)
hashstack: posts small blind $200
TurnOnTuneInDropOut: posts big blind $400
*** HOLE CARDS ***
Dealt to TurnOnTuneInDropOut [3h 8c 6c Kh]
craftplayer: raises $400 to $800
Sam565: calls $800
yatin47: calls $800
hashstack: folds
TurnOnTuneInDropOut: folds
*** FLOP *** [3d Qh 7d]
craftplayer: bets $1500
Sam565: folds
yatin47: folds
Uncalled bet ($1500) returned to craftplayer
craftplayer collected $2880 from pot
craftplayer: doesn't show hand
*** SUMMARY ***
Total pot $3000 | Rake $120
Board [3d Qh 7d]
Seat 1: Sam565 folded on the Flop
Seat 3: yatin47 (button) folded on the Flop
Seat 4: hashstack (small blind) folded before Flop
Seat 5: TurnOnTuneInDropOut (big blind) folded before Flop
Seat 6: craftplayer collected ($2880)

PokerStars Hand #228844380: Omaha Pot Limit ($200/$400 USD) - 2020/10/23 16:50:37 ET
Table 'ADA409467368' 6-max Seat #5 is the button
Seat 1: Sam565 ($18350 in chips)
Seat 4: hashstack ($26958 in chips)
Seat 5: TurnOnTuneInDropOut ($12000 in chips)
Seat 6: craftplayer ($27376 in chips)
craftplayer: posts small blind $200
Sam565: posts big blind $400
*** HOLE CARDS ***
Dealt to TurnOnTuneInDropOut [7s Tc Td Qd]
hashstack: raises $800 to $1200
TurnOnTuneInDropOut: folds
craftplayer: calls $1000
Sam565: calls $800
*** FLOP *** [Kh 5h Th]
craftplayer: checks
Sam565: checks
hashstack: bets $800
craftplayer: calls $800
Sam565: folds
*** TURN *** [Kh 5h Th] [2h]
craftplayer: checks
hashstack: checks
*** RIVER *** [Kh 5h Th 2h] [2s]
craftplayer: checks
hashstack: checks
*** SHOW DOWN ***
craftplayer: shows [6h 8h 9h As]
hashstack: mucks hand
craftplayer collected $4991 from pot
*** SUMMARY ***
Total pot $5200 | Rake $209
Board [Kh 5h Th 2h 2s]
Seat 1: Sam565 (big blind) folded on the Flop
Seat 4: hashstack mucked
Seat 5: TurnOnTuneInDropOut (button) folded before Flop (didn't bet)
Seat 6: craftplayer (small blind) showed [6h 8h 9h As] and won ($4991)

PokerStars Hand #228844381: Omaha Pot Limit ($200/$400 USD) - 2020/10/23 16:52:28 ET
Table 'ADA409467368' 6-max Seat #6 is the button
Seat 1: Sam565 ($17150 in chips)
Seat 2: kimjongun ($30000 in chips)
Seat 4: hashstack ($24958 in chips)
Seat 5: TurnOnTuneInDropOut ($48000 in chips)
Seat 6: craftplayer ($30367 in chips)
Sam565: posts small blind $200
kimjongun: posts big blind $400
*** HOLE CARDS ***
Dealt to TurnOnTuneInDropOut [8d Th Ks Qc]
hashstack: raises $668 to $1068
TurnOnTuneInDropOut: folds
craftplayer: calls $1068
Sam565: calls $868
kimjongun: folds
*** FLOP *** [3c 6d 5h]
Sam565: checks
hashstack: checks
craftplayer: checks
*** TURN *** [3c 6d 5h] [3s]
Sam565: checks
hashstack: checks
craftplayer: checks
*** RIVER *** [3c 6d 5h 3s] [8h]
Sam565: checks
hashstack: checks
craftplayer: bets $2703
Sam565: folds
hashstack: calls $2703
*** SHOW DOWN ***
hashstack: mucks hand
craftplayer: shows [Tc 5s 7h 9c]
craftplayer collected $8649 from pot
*** SUMMARY ***
Total pot $9010 | Rake $361
Board [3c 6d 5h 3s 8h]
Seat 1: Sam565 (small blind) folded on the River
Seat 2: kimjongun (big blind) folded before Flop
Seat 4: hashstack mucked
Seat 5: TurnOnTuneInDropOut folded before Flop (didn't bet)
Seat 6: craftplayer (button) showed [Tc 5s 7h 9c] and won ($8649)

PokerStars Hand #228844382: Omaha Pot Limit ($200/$400 USD) - 2020/10/23 16:54:03 ET
Table 'ADA409467368' 6-max Seat #1 is the button
Seat 1: Sam565 ($16082 in chips)
Seat 2: kimjongun ($29600 in chips)
Seat 4: hashstack ($21187 in chips)
Seat 5: TurnOnTuneInDropOut ($48000 in chips)
Seat 6: craftplayer ($35245 in chips)
kimjongun: posts small blind $200
hashstack: posts big blind $400
*** HOLE CARDS ***
Dealt to TurnOnTuneInDropOut [5h 4d 8c 3c]
TurnOnTuneInDropOut: folds
craftplayer: folds
Sam565: raises $1000 to $1400
kimjongun: folds
hashstack: folds
Uncalled bet ($1000) returned to Sam565
Sam565 collected $1000 from pot
Sam565: doesn't show hand
*** SUMMARY ***
Total pot $1000 | Rake $0
Seat 1: Sam565 (button) collected ($1000)
Seat 2: kimjongun (small blind) folded before Flop
Seat 4: hashstack (big blind) folded before Flop
Seat 5: TurnOnTuneInDropOut folded before Flop (didn't bet)
Seat 6: craftplayer folded before Flop (didn't bet)

PokerStars Hand #228844383: Omaha Pot Limit ($200/$400 USD) - 2020/10/23 16:54:22 ET
Table 'ADA409467368' 6-max Seat #2 is the button
Seat 1: Sam565 ($16682 in chips)
Seat 2: kimjongun ($29400 in chips)
Seat 4: hashstack ($20787 in chips)
Seat 5: TurnOnTuneInDropOut ($48000 in chips)
Seat 6: craftplayer ($35245 in chips)
hashstack: posts small blind $200
TurnOnTuneInDropOut: posts big blind $400
*** HOLE CARDS ***
Dealt to TurnOnTuneInDropOut [Ac Ad 3s Kd]
craftplayer: raises $1000 to $1400
Sam565: folds
kimjongun: folds
hashstack: calls $1200
TurnOnTuneInDropOut: raises $4200 to $5600
craftplayer: calls $4200
hashstack: folds
*** FLOP *** [2d 2h Js]
TurnOnTuneInDropOut: bets $4158
craftplayer: calls $4158
*** TURN *** [2d 2h Js] [Td]
TurnOnTuneInDropOut: checks
craftplayer: checks
*** RIVER *** [2d 2h Js Td] [4d]
TurnOnTuneInDropOut: bets $15887
craftplayer: folds
Uncalled bet ($15887) returned to TurnOnTuneInDropOut
TurnOnTuneInDropOut collected $20116 from pot
TurnOnTuneInDropOut: doesn't show hand
*** SUMMARY ***
Total pot $20916 | Rake $800
Board [2d 2h Js Td 4d]
Seat 1: Sam565 folded before Flop (didn't bet)
Seat 2: kimjongun (button) folded before Flop (didn't bet)
Seat 4: hashstack (small blind) folded before Flop
Seat 5: TurnOnTuneInDropOut (big blind) collected ($20116)
Seat 6: craftplayer folded on the River

PokerStars Hand #228844384: Omaha Pot Limit ($200/$400 USD) - 2020/10/23 16:55:54 ET
Table 'ADA409467368' 6-max Seat #4 is the button
Seat 1: Sam565 ($16682 in chips)
Seat 2: kimjongun ($29400 in chips)
Seat 4: hashstack ($19387 in chips)
Seat 5: TurnOnTuneInDropOut ($58358 in chips)
Seat 6: craftplayer ($25487 in chips)
TurnOnTuneInDropOut: posts small blind $200
craftplayer: posts big blind $400
*** HOLE CARDS ***
Dealt to TurnOnTuneInDropOut [Ah 7h 6h 4s]
Sam565: folds
kimjongun: raises $1000 to $1400
hashstack: folds
TurnOnTuneInDropOut: folds
craftplayer: calls $1000
*** FLOP *** [8h 7d 2c]
craftplayer: checks
kimjongun: checks
*** TURN *** [8h 7d 2c] [6s]
craftplayer: checks
kimjongun: checks
*** RIVER *** [8h 7d 2c 6s] [Kd]
craftplayer: checks
kimjongun: bets $2250
craftplayer: folds
Uncalled bet ($2250) returned to kimjongun
kimjongun collected $2880 from pot
kimjongun: doesn't show hand
*** SUMMARY ***
Total pot $3000 | Rake $120
Board [8h 7d 2c 6s Kd]
Seat 1: Sam565 folded before Flop (didn't bet)
Seat 2: kimjongun collected ($2880)
Seat 4: hashstack (button) folded before Flop (didn't bet)
Seat 5: TurnOnTuneInDropOut (small blind) folded before Flop
Seat 6: craftplayer (big blind) folded on the River

PokerStars Hand #228844385: Omaha Pot Limit ($200/$400 USD) - 2020/10/23 16:56:52 ET
Table 'ADA409467368' 6-max Seat #5 is the button
Seat 1: Sam565 ($16682 in chips)
Seat 2: kimjongun ($30880 in chips)
Seat 4: hashstack ($19387 in chips)
Seat 5: TurnOnTuneInDropOut ($58158 in chips)
Seat 6: craftplayer ($24087 in chips)
craftplayer: posts small blind $200
Sam565: posts big blind $400
*** HOLE CARDS ***
Dealt to TurnOnTuneInDropOut [4h 3c Td Kh]
kimjongun: folds
hashstack: folds
TurnOnTuneInDropOut: folds
craftplayer: raises $800 to $1200
Sam565: calls $800
*** FLOP *** [9c Qh 7h]
craftplayer: bets $1800
Sam565: folds
Uncalled bet ($1800) returned to craftplayer
craftplayer collected $2304 from pot
craftplayer: doesn't show hand
*** SUMMARY ***
Total pot $2400 | Rake $96
Board [9c Qh 7h]
Seat 1: Sam565 (big blind) folded on the Flop
Seat 2: kimjongun folded before Flop (didn't bet)
Seat 4: hashstack folded before Flop (didn't bet)
Seat 5: TurnOnTuneInDropOut (button) folded before Flop (didn't bet)
Seat 6: craftplayer (small blind) collected ($2304)

PokerStars Hand #228844386: Omaha Pot Limit ($200/$400 USD) - 2020/10/23 16:57:45 ET
Table 'ADA409467368' 6-max Seat #6 is the button
Seat 1: Sam565 ($15482 in chips)
Seat 2: kimjongun ($30880 in chips)
Seat 4: hashstack ($19387 in chips)
Seat 5: TurnOnTuneInDropOut ($58158 in chips)
Seat 6: craftplayer ($25191 in chips)
Sam565: posts small blind $200
kimjongun: posts big blind $400
*** HOLE CARDS ***
Dealt to TurnOnTuneInDropOut [3d Th Jc 7h]
hashstack: folds
TurnOnTuneInDropOut: folds
craftplayer: raises $1000 to $1400
Sam565: folds
kimjongun: folds
Uncalled bet ($1000) returned to craftplayer
craftplayer collected $1000 from pot
craftplayer: doesn't show hand
*** SUMMARY ***
Total pot $1000 | Rake $0
Seat 1: Sam565 (small blind) folded before Flop
Seat 2: kimjongun (big blind) folded before Flop
Seat 4: hashstack folded before Flop (didn't bet)
Seat 5: TurnOnTuneInDropOut folded before Flop (didn't bet)
Seat 6: craftplayer (button) collected ($1000)

PokerStars Hand #228844387: Omaha Pot Limit ($200/$400 USD) - 2020/10/23 16:58:07 ET
Table 'ADA409467368' 6-max Seat #1 is the button
Seat 1: Sam565 ($15282 in chips)
Seat 2: kimjongun ($30480 in chips)
Seat 4: hashstack ($19387 in chips)
Seat 5: TurnOnTuneInDropOut ($58158 in chips)
Seat 6: craftplayer ($25791 in chips)
kimjongun: posts small blind $200
hashstack: posts big blind $400
*** HOLE CARDS ***
Dealt to TurnOnTuneInDropOut [5c 7h 9d 6s]
TurnOnTuneInDropOut: folds
craftplayer: raises $400 to $800
Sam565: calls $800
kimjongun: raises $2800 to $3600
hashstack: folds
craftplayer: calls $2800
Sam565: calls $2800
*** FLOP *** [6h 5s Qd]
kimjongun: checks
craftplayer: checks
Sam565: bets $11200
kimjongun: folds
craftplayer: folds
Uncalled bet ($11200) returned to Sam565
Sam565 collected $10751 from pot
Sam565: doesn't show hand
*** SUMMARY ***
Total pot $11200 | Rake $449
Board [6h 5s Qd]
Seat 1: Sam565 (button) collected ($10751)
Seat 2: kimjongun (small blind) folded on the Flop
Seat 4: hashstack (big blind) folded before Flop
Seat 5: TurnOnTuneInDropOut folded before Flop (didn't bet)
Seat 6: craftplayer folded on the Flop

PokerStars Hand #228844388: Omaha Pot Limit ($200/$400 USD) - 2020/10/23 16:59:52 ET
Table 'ADA409467368' 6-max Seat #2 is the button
Seat 1: Sam565 ($22433 in chips)
Seat 2: kimjongun ($26880 in chips)
Seat 4: hashstack ($18987 in chips)
Seat 5: TurnOnTuneInDropOut ($58158 in chips)
Seat 6: craftplayer ($22191 in chips)
hashstack: posts small blind $200
TurnOnTuneInDropOut: posts big blind $400
*** HOLE CARDS ***
Dealt to TurnOnTuneInDropOut [8d Ad 3h 7c]
craftplayer: raises $400 to $800
Sam565: raises $2200 to $3000
kimjongun: folds
hashstack: folds
TurnOnTuneInDropOut: folds
craftplayer: calls $2200
*** FLOP *** [Ac 4c 6h]
craftplayer: checks
Sam565: bets $6600
craftplayer: folds
Uncalled bet ($6600) returned to Sam565
Sam565 collected $6335 from pot
Sam565: doesn't show hand
*** SUMMARY ***
Total pot $6600 | Rake $265
Board [Ac 4c 6h]
Seat 1: Sam565 collected ($6335)
Seat 2: kimjongun (button) folded before Flop (didn't bet)
Seat 4: hashstack (small blind) folded before Flop
Seat 5: TurnOnTuneInDropOut (big blind) folded before Flop
Seat 6: craftplayer folded on the Flop

PokerStars Hand #228844390: Omaha Pot Limit ($200/$400 USD) - 2020/10/23 17:03:34 ET
Table 'ADA409467368' 6-max Seat #5 is the button
Seat 1: Sam565 ($28617 in chips)
Seat 2: kimjongun ($26880 in chips)
Seat 4: hashstack ($16837 in chips)
Seat 5: TurnOnTuneInDropOut ($57558 in chips)
Sam565: posts small blind $200
kimjongun: posts big blind $400
*** HOLE CARDS ***
Dealt to TurnOnTuneInDropOut [3d Qd 5h Qh]
hashstack: folds
TurnOnTuneInDropOut: raises $1000 to $1400
Sam565: folds
kimjongun: folds
Uncalled bet ($1000) returned to TurnOnTuneInDropOut
TurnOnTuneInDropOut collected $1000 from pot
TurnOnTuneInDropOut: doesn't show hand
*** SUMMARY ***
Total pot $1000 | Rake $0
Seat 1: Sam565 (small blind) folded before Flop
Seat 2: kimjongun (big blind) folded before Flop
Seat 4: hashstack folded before Flop (didn't bet)
Seat 5: TurnOnTuneInDropOut (button) collected ($1000)

PokerStars Hand #228844391: Omaha Pot Limit ($200/$400 USD) - 2020/10/23 17:03:53 ET
Table 'ADA409467368' 6-max Seat #1 is the button
Seat 1: Sam565 ($28417 in chips)
Seat 2: kimjongun ($26480 in chips)
Seat 4: hashstack ($16837 in chips)
Seat 5: TurnOnTuneInDropOut ($58158 in chips)
kimjongun: posts small blind $200
hashstack: posts big blind $400
*** HOLE CARDS ***
Dealt to TurnOnTuneInDropOut [Ah 4s 4c Kh]
TurnOnTuneInDropOut: folds
Sam565: folds
kimjongun: raises $800 to $1200
hashstack: calls $800
*** FLOP *** [3h 3c 7h]
kimjongun: checks
hashstack: bets $1800
kimjongun: calls $1800
*** TURN *** [3h 3c 7h] [2c]
kimjongun: bets $3000
hashstack: raises $10837 to $13837 and is all-in
kimjongun: calls $10837
*** RIVER *** [3h 3c 7h 2c] [8h]
*** SHOW DOWN ***
kimjongun: shows [Tc Jh Ac 5h]
hashstack: shows [6c 9s 3s 6h]
kimjongun collected $32874 from pot
*** SUMMARY ***
Total pot $33674 | Rake $800
Board [3h 3c 7h 2c 8h]
Seat 1: Sam565 (button) folded before Flop (didn't bet)
Seat 2: kimjongun (small blind) showed [Tc Jh Ac 5h] and won ($32874)
Seat 4: hashstack (big blind) showed [6c 9s 3s 6h] and lost
Seat 5: TurnOnTuneInDropOut folded before Flop (didn't bet)

PokerStars Hand #228844392: Omaha Pot Limit ($200/$400 USD) - 2020/10/23 17:04:34 ET
Table 'ADA409467368' 6-max Seat #2 is the button
Seat 1: Sam565 ($28417 in chips)
Seat 2: kimjongun ($42517 in chips)
Seat 5: TurnOnTuneInDropOut ($58158 in chips)
TurnOnTuneInDropOut: posts small blind $200
Sam565: posts big blind $400
*** HOLE CARDS ***
Dealt to TurnOnTuneInDropOut [Ks Ad Kc Ah]
kimjongun: raises $1000 to $1400
TurnOnTuneInDropOut: raises $3200 to $4600
Sam565: folds
kimjongun: folds
Uncalled bet ($3200) returned to TurnOnTuneInDropOut
TurnOnTuneInDropOut collected $3200 from pot
TurnOnTuneInDropOut: doesn't show hand
*** SUMMARY ***
Total pot $3200 | Rake $0
Seat 1: Sam565 (big blind) folded before Flop
Seat 2: kimjongun (button) folded before Flop
Seat 5: TurnOnTuneInDropOut (small blind) collected ($3200)

PokerStars Hand #1054739449: Omaha Pot Limit ($500/$1000 USD) - 2020/10/23 12:15:02 ET
Table 'ADA540885739' 6-max Seat #1 is the button
Seat 1: TurnOnTuneInDropOut ($81639 in chips)
Seat 2: vaibz16 ($31774 in chips)
Seat 3: slotmachine ($75000 in chips)
Seat 4: ag2703 ($71500 in chips)
Seat 5: bothras ($45910 in chips)
vaibz16: posts small blind $500
slotmachine: posts big blind $1000
*** HOLE CARDS ***
Dealt to TurnOnTuneInDropOut [3d 5c Td 2h]
ag2703: raises $1797 to $2797
bothras: folds
TurnOnTuneInDropOut: folds
vaibz16: folds
slotmachine: folds
Uncalled bet ($1797) returned to ag2703
ag2703 collected $2500 from pot
ag2703: doesn't show hand
*** SUMMARY ***
Total pot $2500 | Rake $0
Seat 1: TurnOnTuneInDropOut (button) folded before Flop (didn't bet)
Seat 2: vaibz16 (small blind) folded before Flop
Seat 3: slotmachine (big blind) folded before Flop
Seat 4: ag2703 collected ($2500)
Seat 5: bothras folded before Flop (didn't bet)

PokerStars Hand #1054739450: Omaha Pot Limit ($500/$1000 USD) - 2020/10/23 12:15:35 ET
Table 'ADA540885739' 6-max Seat #2 is the button
Seat 1: TurnOnTuneInDropOut ($81639 in chips)
Seat 2: vaibz16 ($31274 in chips)
Seat 3: slotmachine ($74000 in chips)
Seat 4: ag2703 ($73000 in chips)
Seat 5: bothras ($45910 in chips)
slotmachine: posts small blind $500
ag2703: posts big blind $1000
*** HOLE CARDS ***
Dealt to TurnOnTuneInDropOut [Ah 5s 7d 9h]
bothras: raises $2500 to $3500
TurnOnTuneInDropOut: folds
vaibz16: folds
slotmachine: folds
ag2703: calls $2500
*** FLOP *** [3c Ts 8d]
ag2703: checks
bothras: checks
*** TURN *** [3c Ts 8d] [Kh]
ag2703: bets $3750
bothras: raises $15000 to $18750
ag2703: folds
Uncalled bet ($15000) returned to bothras
bothras collected $14548 from pot
bothras: doesn't show hand
*** SUMMARY ***
Total pot $15000 | Rake $452
Board [3c Ts 8d Kh]
Seat 1: TurnOnTuneInDropOut folded before Flop (didn't bet)
Seat 2: vaibz16 (button) folded before Flop (didn't bet)
Seat 3: slotmachine (small blind) folded before Flop
Seat 4: ag2703 (big blind) folded on the Turn
Seat 5: bothras collected ($14548)

PokerStars Hand #1054739451: Omaha Pot Limit ($500/$1000 USD) - 2020/10/23 12:16:18 ET
Table 'ADA540885739' 6-max Seat #3 is the button
Seat 1: TurnOnTuneInDropOut ($81639 in chips)
Seat 2: vaibz16 ($31274 in chips)
Seat 3: slotmachine ($73500 in chips)
Seat 4: ag2703 ($65750 in chips)
Seat 5: bothras ($53208 in chips)
ag2703: posts small blind $500
bothras: posts big blind $1000
*** HOLE CARDS ***
Dealt to TurnOnTuneInDropOut [Kd 5d Jh Ac]
TurnOnTuneInDropOut: raises $2500 to $3500
vaibz16: folds
slotmachine: folds
ag2703: calls $3000
bothras: folds
*** FLOP *** [Qd Qs 6s]
ag2703: checks
TurnOnTuneInDropOut: bets $2640
ag2703: folds
Uncalled bet ($2640) returned to TurnOnTuneInDropOut
TurnOnTuneInDropOut collected $7759 from pot
TurnOnTuneInDropOut: doesn't show hand
*** SUMMARY ***
Total pot $8000 | Rake $241
Board [Qd Qs 6s]
Seat 1: TurnOnTuneInDropOut collected ($7759)
Seat 2: vaibz16 folded before Flop (didn't bet)
Seat 3: slotmachine (button) folded before Flop (didn't bet)
Seat 4: ag2703 (small blind) folded on the Flop
Seat 5: bothras (big blind) folded before Flop

PokerStars Hand #1054739452: Omaha Pot Limit ($500/$1000 USD) - 2020/10/23 12:17:19 ET
Table 'ADA540885739' 6-max Seat #4 is the button
Seat 1: TurnOnTuneInDropOut ($85898 in chips)
Seat 2: vaibz16 ($31274 in chips)
Seat 3: slotmachine ($73500 in chips)
Seat 4: ag2703 ($62250 in chips)
Seat 5: bothras ($52208 in chips)
bothras: posts small blind $500
TurnOnTuneInDropOut: posts big blind $1000
*** HOLE CARDS ***
Dealt to TurnOnTuneInDropOut [6c 2h 8h 6h]
vaibz16: folds
slotmachine: folds
ag2703: folds
bothras: raises $2000 to $3000
TurnOnTuneInDropOut: folds
Uncalled bet ($2000) returned to bothras
bothras collected $2000 from pot
bothras: doesn't show hand
*** SUMMARY ***
Total pot $2000 | Rake $0
Seat 1: TurnOnTuneInDropOut (big blind) folded before Flop
Seat 2: vaibz16 folded before Flop (didn't bet)
Seat 3: slotmachine folded before Flop (didn't bet)
Seat 4: ag2703 (button) folded before Flop (didn't bet)
Seat 5: bothras (small blind) collected ($2000)

PokerStars Hand #1054739453: Omaha Pot Limit ($500/$1000 USD) - 2020/10/23 12:17:39 ET
Table 'ADA540885739' 6-max Seat #5 is the button
Seat 1: TurnOnTuneInDropOut ($84898 in chips)
Seat 2: vaibz16 ($31274 in chips)
Seat 3: slotmachine ($73500 in chips)
Seat 4: ag2703 ($62250 in chips)
Seat 5: bothras ($53208 in chips)
TurnOnTuneInDropOut: posts small blind $500
vaibz16: posts big blind $1000
*** HOLE CARDS ***
Dealt to TurnOnTuneInDropOut [Ad 3h Qc Td]
slotmachine: folds
ag2703: folds
bothras: folds
TurnOnTuneInDropOut: raises $2000 to $3000
vaibz16: folds
Uncalled bet ($2000) returned to TurnOnTuneInDropOut
TurnOnTuneInDropOut collected $2000 from pot
TurnOnTuneInDropOut: doesn't show hand
*** SUMMARY ***
Total pot $2000 | Rake $0
Seat 1: TurnOnTuneInDropOut (small blind) collected ($2000)
Seat 2: vaibz16 (big blind) folded before Flop
Seat 3: slotmachine folded before Flop (didn't bet)
Seat 4: ag2703 folded before Flop (didn't bet)
Seat 5: bothras (button) folded before Flop (didn't bet)

PokerStars Hand #1054739454: Omaha Pot Limit ($500/$1000 USD) - 2020/10/23 12:18:03 ET
Table 'ADA540885739' 6-max Seat #1 is the button
Seat 1: TurnOnTuneInDropOut ($85898 in chips)
Seat 2: vaibz16 ($30274 in chips)
Seat 3: slotmachine ($73500 in chips)
Seat 4: ag2703 ($62250 in chips)
Seat 5: bothras ($53208 in chips)
vaibz16: posts small blind $500
slotmachine: posts big blind $1000
*** HOLE CARDS ***
Dealt to TurnOnTuneInDropOut [Js 5s Ks 6s]
ag2703: folds
bothras: folds
TurnOnTuneInDropOut: folds
vaibz16: folds
Uncalled bet ($500) returned to slotmachine
slotmachine collected $1000 from pot
slotmachine: doesn't show hand
*** SUMMARY ***
Total pot $1000 | Rake $0
Seat 1: TurnOnTuneInDropOut (button) folded before Flop (didn't bet)
Seat 2: vaibz16 (small blind) folded before Flop
Seat 3: slotmachine (big blind) collected ($1000)
Seat 4: ag2703 folded before Flop (didn't bet)
Seat 5: bothras folded before Flop (didn't bet)

PokerStars Hand #1054739455: Omaha Pot Limit ($500/$1000 USD) - 2020/10/23 12:18:26 ET
Table 'ADA540885739' 6-max Seat #2 is the button
Seat 1: TurnOnTuneInDropOut ($85898 in chips)
Seat 2: vaibz16 ($29774 in chips)
Seat 3: slotmachine ($74000 in chips)
Seat 4: ag2703 ($62250 in chips)
Seat 5: bothras ($53208 in chips)
slotmachine: posts small blind $500
ag2703: posts big blind $1000
*** HOLE CARDS ***
Dealt to TurnOnTuneInDropOut [8d 2d Th Qd]
bothras: folds
TurnOnTuneInDropOut: folds
vaibz16: raises $2500 to $3500
slotmachine: folds
ag2703: calls $2500
*** FLOP *** [6d 3s Ah]
ag2703: checks
vaibz16: bets $3750
ag2703: raises $15000 to $18750
vaibz16: folds
Uncalled bet ($15000) returned to ag2703
ag2703 collected $14548 from pot
ag2703: doesn't show hand
*** SUMMARY ***
Total pot $15000 | Rake $452
Board [6d 3s Ah]
Seat 1: TurnOnTuneInDropOut folded before Flop (didn't bet)
Seat 2: vaibz16 (button) folded on the Flop
Seat 3: slotmachine (small blind) folded before Flop
Seat 4: ag2703 (big blind) collected ($14548)
Seat 5: bothras folded before Flop (didn't bet)

PokerStars Hand #1054739456: Omaha Pot Limit ($500/$1000 USD) - 2020/10/23 12:19:12 ET
Table 'ADA540885739' 6-max Seat #3 is the button
Seat 1: TurnOnTuneInDropOut ($85898 in chips)
Seat 2: vaibz16 ($22524 in chips)
Seat 3: slotmachine ($73500 in chips)
Seat 4: ag2703 ($69548 in chips)
Seat 5: bothras ($53208 in chips)
ag2703: posts small blind $500
bothras: posts big blind $1000
*** HOLE CARDS ***
Dealt to TurnOnTuneInDropOut [Qd 3c 4h 2d]
TurnOnTuneInDropOut: folds
vaibz16: raises $2500 to $3500
slotmachine: folds
ag2703: folds
bothras: folds
Uncalled bet ($2500) returned to vaibz16
vaibz16 collected $2500 from pot
vaibz16: doesn't show hand
*** SUMMARY ***
Total pot $2500 | Rake $0
Seat 1: TurnOnTuneInDropOut folded before Flop (didn't bet)
Seat 2: vaibz16 collected ($2500)
Seat 3: slotmachine (button) folded before Flop (didn't bet)
Seat 4: ag2703 (small blind) folded before Flop
Seat 5: bothras (big blind) folded before Flop

PokerStars Hand #1054739462: Omaha Pot Limit ($500/$1000 USD) - 2020/10/23 12:24:06 ET
Table 'ADA540885739' 6-max Seat #4 is the button
Seat 1: TurnOnTuneInDropOut ($72898 in chips)
Seat 2: vaibz16 ($24949 in chips)
Seat 3: slotmachine ($86703 in chips)
Seat 4: ag2703 ($66973 in chips)
Seat 5: bothras ($53133 in chips)
Seat 6: nicholas93 ($36544 in chips)
bothras: posts small blind $500
nicholas93: posts big blind $1000
*** HOLE CARDS ***
Dealt to TurnOnTuneInDropOut [As 3d Jh Th]
TurnOnTuneInDropOut: folds
vaibz16: calls $1000
slotmachine: calls $1000
ag2703: calls $1000
bothras: folds
nicholas93: checks
*** FLOP *** [9d Kh 2c]
nicholas93: checks
vaibz16: checks
slotmachine: checks
ag2703: checks
*** TURN *** [9d Kh 2c] [8c]
nicholas93: checks
vaibz16: bets $3375
slotmachine: calls $3375
ag2703: folds
nicholas93: folds
*** RIVER *** [9d Kh 2c 8c] [7s]
vaibz16: bets $8438
slotmachine: calls $8438
*** SHOW DOWN ***
vaibz16: shows [8s Qc 6c Ts]
slotmachine: mucks hand
vaibz16 collected $27279 from pot
*** SUMMARY ***
Total pot $28126 | Rake $847
Board [9d Kh 2c 8c 7s]
Seat 1: TurnOnTuneInDropOut folded before Flop (didn't bet)
Seat 2: vaibz16 showed [8s Qc 6c Ts] and won ($27279)
Seat 3: slotmachine mucked
Seat 4: ag2703 (button) folded on the Turn
Seat 5: bothras (small blind) folded before Flop
Seat 6: nicholas93 (big blind) folded on the Turn

PokerStars Hand #1054739472: Omaha Pot Limit ($500/$1000 USD) - 2020/10/23 12:33:35 ET
Table 'ADA540885739' 6-max Seat #5 is the button
Seat 1: TurnOnTuneInDropOut ($71898 in chips)
Seat 3: slotmachine ($73390 in chips)
Seat 4: ag2703 ($63473 in chips)
Seat 5: bothras ($40268 in chips)
TurnOnTuneInDropOut: posts small blind $500
slotmachine: posts big blind $1000
*** HOLE CARDS ***
Dealt to TurnOnTuneInDropOut [7h Jd Kh 7s]
ag2703: folds
bothras: folds
TurnOnTuneInDropOut: raises $2000 to $3000
slotmachine: folds
Uncalled bet ($2000) returned to TurnOnTuneInDropOut
TurnOnTuneInDropOut collected $2000 from pot
TurnOnTuneInDropOut: doesn't show hand
*** SUMMARY ***
Total pot $2000 | Rake $0
Seat 1: TurnOnTuneInDropOut (small blind) collected ($2000)
Seat 3: slotmachine (big blind) folded before Flop
Seat 4: ag2703 folded before Flop (didn't bet)
Seat 5: bothras (button) folded before Flop (didn't bet)

PokerStars Hand #1054739473: Omaha Pot Limit ($500/$1000 USD) - 2020/10/23 12:34:06 ET
Table 'ADA540885739' 6-max Seat #1 is the button
Seat 1: TurnOnTuneInDropOut ($72898 in chips)
Seat 3: slotmachine ($72390 in chips)
Seat 4: ag2703 ($63473 in chips)
Seat 5: bothras ($40268 in chips)
slotmachine: posts small blind $500
ag2703: posts big blind $1000
*** HOLE CARDS ***
Dealt to TurnOnTuneInDropOut [6s 2h 4h 2d]
bothras: folds
TurnOnTuneInDropOut: folds
slotmachine: folds
Uncalled bet ($500) returned to ag2703
ag2703 collected $1000 from pot
ag2703: doesn't show hand
*** SUMMARY ***
Total pot $1000 | Rake $0
Seat 1: TurnOnTuneInDropOut (button) folded before Flop (didn't bet)
Seat 3: slotmachine (small blind) folded before Flop
Seat 4: ag2703 (big blind) collected ($1000)
Seat 5: bothras folded before Flop (didn't bet)

PokerStars Hand #1054739474: Omaha Pot Limit ($500/$1000 USD) - 2020/10/23 12:34:35 ET
Table 'ADA540885739' 6-max Seat #3 is the button
Seat 1: TurnOnTuneInDropOut ($72898 in chips)
Seat 3: slotmachine ($71890 in chips)
Seat 4: ag2703 ($63973 in chips)
Seat 5: bothras ($40268 in chips)
Seat 6: Prateek1986 ($49581 in chips)
ag2703: posts small blind $500
bothras: posts big blind $1000
Prateek1986: posts big blind $1000
*** HOLE CARDS ***
Dealt to TurnOnTuneInDropOut [6d 2h Qs 8d]
Prateek1986: raises $2500 to $3500
TurnOnTuneInDropOut: folds
slotmachine: folds
ag2703: folds
bothras: calls $2500
*** FLOP *** [9h Tc 9d]
bothras: checks
Prateek1986: checks
*** TURN *** [9h Tc 9d] [Qh]
bothras: bets $5625
Prateek1986: calls $5625
*** RIVER *** [9h Tc 9d Qh] [3d]
bothras: bets $12063
Prateek1986: folds
Uncalled bet ($12063) returned to bothras
bothras collected $18186 from pot
bothras: doesn't show hand
*** SUMMARY ***
Total pot $18750 | Rake $564
Board [9h Tc 9d Qh 3d]
Seat 1: TurnOnTuneInDropOut folded before Flop (didn't bet)
Seat 3: slotmachine (button) folded before Flop (didn't bet)
Seat 4: ag2703 (small blind) folded before Flop
Seat 5: bothras (big blind) collected ($18186)
Seat 6: Prateek1986 folded on the River

PokerStars Hand #1054739475: Omaha Pot Limit ($500/$1000 USD) - 2020/10/23 12:35:23 ET
Table 'ADA540885739' 6-max Seat #4 is the button
Seat 1: TurnOnTuneInDropOut ($72898 in chips)
Seat 3: slotmachine ($71890 in chips)
Seat 4: ag2703 ($63473 in chips)
Seat 5: bothras ($49329 in chips)
Seat 6: Prateek1986 ($40456 in chips)
bothras: posts small blind $500
Prateek1986: posts big blind $1000
*** HOLE CARDS ***
Dealt to TurnOnTuneInDropOut [Kc 8d 3d Kh]
TurnOnTuneInDropOut: folds
slotmachine: folds
ag2703: folds
bothras: folds
Uncalled bet ($500) returned to Prateek1986
Prateek1986 collected $1000 from pot
Prateek1986: doesn't show hand
*** SUMMARY ***
Total pot $1000 | Rake $0
Seat 1: TurnOnTuneInDropOut folded before Flop (didn't bet)
Seat 3: slotmachine folded before Flop (didn't bet)
Seat 4: ag2703 (button) folded before Flop (didn't bet)
Seat 5: bothras (small blind) folded before Flop
Seat 6: Prateek1986 (big blind) collected ($1000)

PokerStars Hand #1054739476: Omaha Pot Limit ($500/$1000 USD) - 2020/10/23 12:35:42 ET
Table 'ADA540885739' 6-max Seat #5 is the button
Seat 1: TurnOnTuneInDropOut ($72898 in chips)
Seat 3: slotmachine ($71890 in chips)
Seat 4: ag2703 ($63473 in chips)
Seat 5: bothras ($48829 in chips)
Seat 6: Prateek1986 ($40956 in chips)
Prateek1986: posts small blind $500
TurnOnTuneInDropOut: posts big blind $1000
*** HOLE CARDS ***
Dealt to TurnOnTuneInDropOut [9s Qs Kd 8d]
slotmachine: folds
ag2703: folds
bothras: folds
Prateek1986: folds
Uncalled bet ($500) returned to TurnOnTuneInDropOut
TurnOnTuneInDropOut collected $1000 from pot
TurnOnTuneInDropOut: doesn't show hand
*** SUMMARY ***
Total pot $1000 | Rake $0
Seat 1: TurnOnTuneInDropOut (big blind) collected ($1000)
Seat 3: slotmachine folded before Flop (didn't bet)
Seat 4: ag2703 folded before Flop (didn't bet)
Seat 5: bothras (button) folded before Flop (didn't bet)
Seat 6: Prateek1986 (small blind) folded before Flop

PokerStars Hand #1054739479: Omaha Pot Limit ($500/$1000 USD) - 2020/10/23 12:39:04 ET
Table 'ADA540885739' 6-max Seat #3 is the button
Seat 1: TurnOnTuneInDropOut ($72898 in chips)
Seat 3: slotmachine ($120000 in chips)
Seat 4: ag2703 ($47473 in chips)
Seat 5: bothras ($48829 in chips)
Seat 6: Prateek1986 ($83234 in chips)
ag2703: posts small blind $500
bothras: posts big blind $1000
*** HOLE CARDS ***
Dealt to TurnOnTuneInDropOut [3h 3c 7d 5c]
Prateek1986: folds
TurnOnTuneInDropOut: folds
slotmachine: folds
ag2703: calls $500
bothras: checks
*** FLOP *** [Tc Qd Td]
ag2703: checks
bothras: bets $1000
ag2703: folds
Uncalled bet ($1000) returned to bothras
bothras collected $1940 from pot
bothras: doesn't show hand
*** SUMMARY ***
Total pot $2000 | Rake $60
Board [Tc Qd Td]
Seat 1: TurnOnTuneInDropOut folded before Flop (didn't bet)
Seat 3: slotmachine (button) folded before Flop (didn't bet)
Seat 4: ag2703 (small blind) folded on the Flop
Seat 5: bothras (big blind) collected ($1940)
Seat 6: Prateek1986 folded before Flop (didn't bet)

PokerStars Hand #1957459583: Omaha Pot Limit ($500/$1000 USD) - 2020/10/23 13:27:18 ET
Table 'ADA540885739' 6-max Seat #4 is the button
Seat 1: vaibz16 ($149489 in chips)
Seat 2: vishnu2788 ($31579 in chips)
Seat 3: slotmachine ($140693 in chips)
Seat 4: TurnOnTuneInDropOut ($78774 in chips)
Seat 5: gaganhyd ($39129 in chips)
gaganhyd: posts small blind $500
vaibz16: posts big blind $1000
*** HOLE CARDS ***
Dealt to TurnOnTuneInDropOut [Tc 3d 5h Ad]
vishnu2788: folds
slotmachine: folds
TurnOnTuneInDropOut: raises $2500 to $3500
gaganhyd: calls $3000
vaibz16: folds
*** FLOP *** [Th 7d 3s]
gaganhyd: bets $8000
TurnOnTuneInDropOut: raises $24000 to $32000
gaganhyd: raises $3629 to $35629 and is all-in
TurnOnTuneInDropOut: calls $3629
*** TURN *** [Th 7d 3s] [2s]
*** RIVER *** [Th 7d 3s 2s] [9h]
*** SHOW DOWN ***
gaganhyd: shows [Qh 8d 9d Jd]
TurnOnTuneInDropOut: shows [Tc 3d 5h Ad]
gaganhyd collected $77859 from pot
*** SUMMARY ***
Total pot $79258 | Rake $1399
Board [Th 7d 3s 2s 9h]
Seat 1: vaibz16 (big blind) folded before Flop
Seat 2: vishnu2788 folded before Flop (didn't bet)
Seat 3: slotmachine folded before Flop (didn't bet)
Seat 4: TurnOnTuneInDropOut (button) showed [Tc 3d 5h Ad] and lost
Seat 5: gaganhyd (small blind) showed [Qh 8d 9d Jd] and won ($77859)

PokerStars Hand #1957459584: Omaha Pot Limit ($500/$1000 USD) - 2020/10/23 13:27:55 ET
Table 'ADA540885739' 6-max Seat #5 is the button
Seat 2: vishnu2788 ($31579 in chips)
Seat 3: slotmachine ($140693 in chips)
Seat 4: TurnOnTuneInDropOut ($39645 in chips)
Seat 5: gaganhyd ($77859 in chips)
vishnu2788: posts small blind $500
slotmachine: posts big blind $1000
*** HOLE CARDS ***
Dealt to TurnOnTuneInDropOut [6c Jc 9h Kd]
TurnOnTuneInDropOut: folds
gaganhyd: folds
vishnu2788: raises $2000 to $3000
slotmachine: calls $2000
*** FLOP *** [6s 7s 7h]
vishnu2788: checks
slotmachine: checks
*** TURN *** [6s 7s 7h] [Qc]
vishnu2788: bets $6000
slotmachine: folds
Uncalled bet ($6000) returned to vishnu2788
vishnu2788 collected $5819 from pot
vishnu2788: doesn't show hand
*** SUMMARY ***
Total pot $6000 | Rake $181
Board [6s 7s 7h Qc]
Seat 2: vishnu2788 (small blind) collected ($5819)
Seat 3: slotmachine (big blind) folded on the Turn
Seat 4: TurnOnTuneInDropOut folded before Flop (didn't bet)
Seat 5: gaganhyd (button) folded before Flop (didn't bet)

PokerStars Hand #1957459589: Omaha Pot Limit ($500/$1000 USD) - 2020/10/23 13:32:04 ET
Table 'ADA540885739' 6-max Seat #2 is the button
Seat 2: vishnu2788 ($29438 in chips)
Seat 3: slotmachine ($136193 in chips)
Seat 4: TurnOnTuneInDropOut ($78793 in chips)
Seat 5: gaganhyd ($76359 in chips)
Seat 6: Shr181 ($57134 in chips)
slotmachine: posts small blind $500
TurnOnTuneInDropOut: posts big blind $1000
*** HOLE CARDS ***
Dealt to TurnOnTuneInDropOut [4h 7c Ts Th]
gaganhyd: raises $1000 to $2000
Shr181: calls $2000
vishnu2788: calls $2000
slotmachine: folds
TurnOnTuneInDropOut: folds
*** FLOP *** [6s 3s 8d]
gaganhyd: checks
Shr181: checks
vishnu2788: checks
*** TURN *** [6s 3s 8d] [7h]
gaganhyd: bets $3750
Shr181: folds
vishnu2788: calls $3750
*** RIVER *** [6s 3s 8d 7h] [5c]
gaganhyd: bets $6603
vishnu2788: raises $17085 to $23688 and is all-in
gaganhyd: folds
Uncalled bet ($17085) returned to vishnu2788
vishnu2788 collected $27357 from pot
vishnu2788: doesn't show hand
*** SUMMARY ***
Total pot $28206 | Rake $849
Board [6s 3s 8d 7h 5c]
Seat 2: vishnu2788 (button) collected ($27357)
Seat 3: slotmachine (small blind) folded before Flop
Seat 4: TurnOnTuneInDropOut (big blind) folded before Flop
Seat 5: gaganhyd folded on the River
Seat 6: Shr181 folded on the Turn

PokerStars Hand #1957459592: Omaha Pot Limit ($500/$1000 USD) - 2020/10/23 13:35:58 ET
Table 'ADA540885739' 6-max Seat #5 is the button
Seat 2: bothras ($45000 in chips)
Seat 3: slotmachine ($143381 in chips)
Seat 4: TurnOnTuneInDropOut ($77293 in chips)
Seat 5: gaganhyd ($66105 in chips)
Seat 6: Shr181 ($45220 in chips)
Shr181: posts small blind $500
bothras: posts big blind $1000
*** HOLE CARDS ***
Dealt to TurnOnTuneInDropOut [4c 3c Qh 7d]
slotmachine: raises $2500 to $3500
TurnOnTuneInDropOut: folds
gaganhyd: folds
Shr181: folds
bothras: folds
Uncalled bet ($2500) returned to slotmachine
slotmachine collected $2500 from pot
slotmachine: doesn't show hand
*** SUMMARY ***
Total pot $2500 | Rake $0
Seat 2: bothras (big blind) folded before Flop
Seat 3: slotmachine collected ($2500)
Seat 4: TurnOnTuneInDropOut folded before Flop (didn't bet)
Seat 5: gaganhyd (button) folded before Flop (didn't bet)
Seat 6: Shr181 (small blind) folded before Flop

PokerStars Hand #1957459593: Omaha Pot Limit ($500/$1000 USD) - 2020/10/23 13:36:29 ET
Table 'ADA540885739' 6-max Seat #6 is the button
Seat 2: bothras ($44000 in chips)
Seat 3: slotmachine ($144881 in chips)
Seat 4: TurnOnTuneInDropOut ($77293 in chips)
Seat 5: gaganhyd ($66105 in chips)
Seat 6: Shr181 ($44720 in chips)
bothras: posts small blind $500
slotmachine: posts big blind $1000
*** HOLE CARDS ***
Dealt to TurnOnTuneInDropOut [7h Kc 8s Ts]
TurnOnTuneInDropOut: folds
gaganhyd: raises $1000 to $2000
Shr181: calls $2000
bothras: folds
slotmachine: folds
*** FLOP *** [Qh 2h Jc]
gaganhyd: checks
Shr181: checks
*** TURN *** [Qh 2h Jc] [9s]
gaganhyd: checks
Shr181: checks
*** RIVER *** [Qh 2h Jc 9s] [3c]
gaganhyd: checks
Shr181: checks
*** SHOW DOWN ***
gaganhyd: shows [8c 6h 9c 7c]
Shr181: mucks hand
gaganhyd collected $5334 from pot
*** SUMMARY ***
Total pot $5500 | Rake $166
Board [Qh 2h Jc 9s 3c]
Seat 2: bothras (small blind) folded before Flop
Seat 3: slotmachine (big blind) folded before Flop
Seat 4: TurnOnTuneInDropOut folded before Flop (didn't bet)
Seat 5: gaganhyd showed [8c 6h 9c 7c] and won ($5334)
Seat 6: Shr181 (button) mucked

PokerStars Hand #1957459594: Omaha Pot Limit ($500/$1000 USD) - 2020/10/23 13:37:28 ET
Table 'ADA540885739' 6-max Seat #2 is the button
Seat 2: bothras ($43500 in chips)
Seat 3: slotmachine ($143881 in chips)
Seat 4: TurnOnTuneInDropOut ($77293 in chips)
Seat 5: gaganhyd ($69439 in chips)
Seat 6: Shr181 ($42720 in chips)
slotmachine: posts small blind $500
TurnOnTuneInDropOut: posts big blind $1000
*** HOLE CARDS ***
Dealt to TurnOnTuneInDropOut [Ts 4d 9c Th]
gaganhyd: folds
Shr181: folds
bothras: folds
slotmachine: folds
Uncalled bet ($500) returned to TurnOnTuneInDropOut
TurnOnTuneInDropOut collected $1000 from pot
TurnOnTuneInDropOut: doesn't show hand
*** SUMMARY ***
Total pot $1000 | Rake $0
Seat 2: bothras (button) folded before Flop (didn't bet)
Seat 3: slotmachine (small blind) folded before Flop
Seat 4: TurnOnTuneInDropOut (big blind) collected ($1000)
Seat 5: gaganhyd folded before Flop (didn't bet)
Seat 6: Shr181 folded before Flop (didn't bet)

PokerStars Hand #1957459595: Omaha Pot Limit ($500/$1000 USD) - 2020/10/23 13:37:43 ET
Table 'ADA540885739' 6-max Seat #3 is the button
Seat 2: bothras ($43500 in chips)
Seat 3: slotmachine ($143381 in chips)
Seat 4: TurnOnTuneInDropOut ($77793 in chips)
Seat 5: gaganhyd ($69439 in chips)
Seat 6: Shr181 ($42720 in chips)
TurnOnTuneInDropOut: posts small blind $500
gaganhyd: posts big blind $1000
*** HOLE CARDS ***
Dealt to TurnOnTuneInDropOut [Jd 6s 7c 5s]
Shr181: folds
bothras: folds
slotmachine: raises $2500 to $3500
TurnOnTuneInDropOut: folds
gaganhyd: raises $7500 to $11000
slotmachine: calls $7500
*** FLOP *** [9c 4h 2d]
gaganhyd: bets $16875
slotmachine: raises $56250 to $73125
gaganhyd: calls $41564 and is all-in
Uncalled bet ($14686) returned to slotmachine
*** TURN *** [9c 4h 2d] [Kh]
*** RIVER *** [9c 4h 2d Kh] [Th]
*** SHOW DOWN ***
gaganhyd: shows [As Qc 8d Ad]
slotmachine: shows [8c Ah Js 9s]
gaganhyd collected $68989 from pot
*** SUMMARY ***
Total pot $139378 | Rake $70389
Board [9c 4h 2d Kh Th]
Seat 2: bothras folded before Flop (didn't bet)
Seat 3: slotmachine (button) showed [8c Ah Js 9s] and lost
Seat 4: TurnOnTuneInDropOut (small blind) folded before Flop
Seat 5: gaganhyd (big blind) showed [As Qc 8d Ad] and won ($68989)
Seat 6: Shr181 folded before Flop (didn't bet)

PokerStars Hand #1957459596: Omaha Pot Limit ($500/$1000 USD) - 2020/10/23 13:38:33 ET
Table 'ADA540885739' 6-max Seat #4 is the button
Seat 2: bothras ($43500 in chips)
Seat 3: slotmachine ($88850 in chips)
Seat 4: TurnOnTuneInDropOut ($77293 in chips)
Seat 5: gaganhyd ($137978 in chips)
Seat 6: Shr181 ($42720 in chips)
gaganhyd: posts small blind $500
Shr181: posts big blind $1000
*** HOLE CARDS ***
Dealt to TurnOnTuneInDropOut [Jh 5s 2d 2c]
bothras: raises $2500 to $3500
slotmachine: folds
TurnOnTuneInDropOut: folds
gaganhyd: folds
Shr181: calls $2500
*** FLOP *** [As 9c Qh]
Shr181: checks
bothras: bets $4500
Shr181: calls $4500
*** TURN *** [As 9c Qh] [Qd]
Shr181: bets $5573
bothras: folds
Uncalled bet ($5573) returned to Shr181
Shr181 collected $16003 from pot
Shr181: doesn't show hand
*** SUMMARY ***
Total pot $16500 | Rake $497
Board [As 9c Qh Qd]
Seat 2: bothras folded on the Turn
Seat 3: slotmachine folded before Flop (didn't bet)
Seat 4: TurnOnTuneInDropOut (button) folded before Flop (didn't bet)
Seat 5: gaganhyd (small blind) folded before Flop
Seat 6: Shr181 (big blind) collected ($16003)

PokerStars Hand #1957459597: Omaha Pot Limit ($500/$1000 USD) - 2020/10/23 13:39:14 ET
Table 'ADA540885739' 6-max Seat #5 is the button
Seat 2: bothras ($35500 in chips)
Seat 3: slotmachine ($88850 in chips)
Seat 4: TurnOnTuneInDropOut ($77293 in chips)
Seat 5: gaganhyd ($137478 in chips)
Seat 6: Shr181 ($50723 in chips)
Shr181: posts small blind $500
bothras: posts big blind $1000
*** HOLE CARDS ***
Dealt to TurnOnTuneInDropOut [5c Qd 6c Kh]
slotmachine: raises $2500 to $3500
TurnOnTuneInDropOut: folds
gaganhyd: folds
Shr181: calls $3000
bothras: folds
*** FLOP *** [4s 3s 4c]
Shr181: checks
slotmachine: bets $2640
Shr181: calls $2640
*** TURN *** [4s 3s 4c] [3d]
Shr181: checks
slotmachine: checks
*** RIVER *** [4s 3s 4c 3d] [Jd]
Shr181: bets $7175
slotmachine: calls $7175
*** SHOW DOWN ***
Shr181: shows [4h 3c 7h 8h]
slotmachine: mucks hand
Shr181 collected $26798 from pot
*** SUMMARY ***
Total pot $27630 | Rake $832
Board [4s 3s 4c 3d Jd]
Seat 2: bothras (big blind) folded before Flop
Seat 3: slotmachine mucked
Seat 4: TurnOnTuneInDropOut folded before Flop (didn't bet)
Seat 5: gaganhyd (button) folded before Flop (didn't bet)
Seat 6: Shr181 (small blind) showed [4h 3c 7h 8h] and won ($26798)

PokerStars Hand #1957459598: Omaha Pot Limit ($500/$1000 USD) - 2020/10/23 13:40:15 ET
Table 'ADA540885739' 6-max Seat #6 is the button
Seat 2: bothras ($34500 in chips)
Seat 3: slotmachine ($75535 in chips)
Seat 4: TurnOnTuneInDropOut ($77293 in chips)
Seat 6: Shr181 ($64206 in chips)
bothras: posts small blind $500
slotmachine: posts big blind $1000
*** HOLE CARDS ***
Dealt to TurnOnTuneInDropOut [Ad As 9s 8c]
TurnOnTuneInDropOut: raises $2500 to $3500
Shr181: calls $3500
bothras: folds
slotmachine: folds
*** FLOP *** [3c 2s 9h]
TurnOnTuneInDropOut: bets $8500
Shr181: calls $8500
*** TURN *** [3c 2s 9h] [8s]
TurnOnTuneInDropOut: bets $16830
Shr181: calls $16830
*** RIVER *** [3c 2s 9h 8s] [Td]
TurnOnTuneInDropOut: checks
Shr181: checks
*** SHOW DOWN ***
TurnOnTuneInDropOut: shows [Ad As 9s 8c]
Shr181: mucks hand
TurnOnTuneInDropOut collected $57761 from pot
*** SUMMARY ***
Total pot $59160 | Rake $1399
Board [3c 2s 9h 8s Td]
Seat 2: bothras (small blind) folded before Flop
Seat 3: slotmachine (big blind) folded before Flop
Seat 4: TurnOnTuneInDropOut showed [Ad As 9s 8c] and won ($57761)
Seat 6: Shr181 (button) mucked

PokerStars Hand #1957459600: Omaha Pot Limit ($500/$1000 USD) - 2020/10/23 13:43:36 ET
Table 'ADA540885739' 6-max Seat #3 is the button
Seat 1: Prateek1986 ($70250 in chips)
Seat 3: slotmachine ($73535 in chips)
Seat 4: TurnOnTuneInDropOut ($105224 in chips)
Seat 5: aggtarun ($120000 in chips)
Seat 6: Shr181 ($42750 in chips)
TurnOnTuneInDropOut: posts small blind $500
aggtarun: posts big blind $1000
*** HOLE CARDS ***
Dealt to TurnOnTuneInDropOut [9h Th 3h Ah]
Shr181: folds
Prateek1986: raises $1000 to $2000
slotmachine: folds
TurnOnTuneInDropOut: folds
aggtarun: calls $1000
*** FLOP *** [3c 4s 8s]
aggtarun: checks
Prateek1986: checks
*** TURN *** [3c 4s 8s] [3s]
aggtarun: checks
Prateek1986: bets $3375
aggtarun: calls $3375
*** RIVER *** [3c 4s 8s 3s] [4h]
aggtarun: checks
Prateek1986: checks
*** SHOW DOWN ***
aggtarun: mucks hand
Prateek1986: shows [5s Ad Js Ks]
Prateek1986 collected $10911 from pot
*** SUMMARY ***
Total pot $11250 | Rake $339
Board [3c 4s 8s 3s 4h]
Seat 1: Prateek1986 showed [5s Ad Js Ks] and won ($10911)
Seat 3: slotmachine (button) folded before Flop (didn't bet)
Seat 4: TurnOnTuneInDropOut (small blind) folded before Flop
Seat 5: aggtarun (big blind) mucked
Seat 6: Shr181 folded before Flop (didn't bet)

PokerStars Hand #1957459601: Omaha Pot Limit ($500/$1000 USD) - 2020/10/23 13:44:24 ET
Table 'ADA540885739' 6-max Seat #4 is the button
Seat 1: Prateek1986 ($75786 in chips)
Seat 3: slotmachine ($73535 in chips)
Seat 4: TurnOnTuneInDropOut ($104724 in chips)
Seat 5: aggtarun ($120000 in chips)
aggtarun: posts small blind $500
Prateek1986: posts big blind $1000
*** HOLE CARDS ***
Dealt to TurnOnTuneInDropOut [5h 6c 4s Qh]
slotmachine: folds
TurnOnTuneInDropOut: folds
aggtarun: raises $2000 to $3000
Prateek1986: calls $2000
*** FLOP *** [8c 7h 9s]
aggtarun: bets $4140
Prateek1986: calls $4140
*** TURN *** [8c 7h 9s] [3c]
aggtarun: bets $14280
Prateek1986: calls $14280
*** RIVER *** [8c 7h 9s 3c] [Ks]
aggtarun: bets $29560
Prateek1986: folds
Uncalled bet ($29560) returned to aggtarun
aggtarun collected $41551 from pot
aggtarun: doesn't show hand
*** SUMMARY ***
Total pot $42840 | Rake $1289
Board [8c 7h 9s 3c Ks]
Seat 1: Prateek1986 (big blind) folded on the River
Seat 3: slotmachine folded before Flop (didn't bet)
Seat 4: TurnOnTuneInDropOut (button) folded before Flop (didn't bet)
Seat 5: aggtarun (small blind) collected ($41551)

PokerStars Hand #1957459602: Omaha Pot Limit ($500/$1000 USD) - 2020/10/23 13:45:28 ET
Table 'ADA540885739' 6-max Seat #5 is the button
Seat 1: Prateek1986 ($54366 in chips)
Seat 3: slotmachine ($73535 in chips)
Seat 4: TurnOnTuneInDropOut ($104724 in chips)
Seat 5: aggtarun ($140131 in chips)
Prateek1986: posts small blind $500
slotmachine: posts big blind $1000
*** HOLE CARDS ***
Dealt to TurnOnTuneInDropOut [Th Jc Kc Ac]
TurnOnTuneInDropOut: raises $2500 to $3500
aggtarun: calls $3500
Prateek1986: calls $3000
slotmachine: folds
*** FLOP *** [Ks 4c 6c]
Prateek1986: checks
TurnOnTuneInDropOut: checks
aggtarun: checks
*** TURN *** [Ks 4c 6c] [9d]
Prateek1986: checks
TurnOnTuneInDropOut: checks
aggtarun: checks
*** RIVER *** [Ks 4c 6c 9d] [5h]
Prateek1986: checks
TurnOnTuneInDropOut: checks
aggtarun: bets $8970
Prateek1986: folds
TurnOnTuneInDropOut: folds
Uncalled bet ($8970) returned to aggtarun
aggtarun collected $11154 from pot
aggtarun: doesn't show hand
*** SUMMARY ***
Total pot $11500 | Rake $346
Board [Ks 4c 6c 9d 5h]
Seat 1: Prateek1986 (small blind) folded on the River
Seat 3: slotmachine (big blind) folded before Flop
Seat 4: TurnOnTuneInDropOut folded on the River
Seat 5: aggtarun (button) collected ($11154)

PokerStars Hand #1957459603: Omaha Pot Limit ($500/$1000 USD) - 2020/10/23 13:46:58 ET
Table 'ADA540885739' 6-max Seat #1 is the button
Seat 1: Prateek1986 ($50866 in chips)
Seat 3: slotmachine ($72535 in chips)
Seat 4: TurnOnTuneInDropOut ($101224 in chips)
Seat 5: aggtarun ($147785 in chips)
slotmachine: posts small blind $500
TurnOnTuneInDropOut: posts big blind $1000
*** HOLE CARDS ***
Dealt to TurnOnTuneInDropOut [Kd 4h 9d Tc]
aggtarun: folds
Prateek1986: folds
slotmachine: raises $2000 to $3000
TurnOnTuneInDropOut: calls $2000
*** FLOP *** [Jd 5h 2c]
slotmachine: bets $6000
TurnOnTuneInDropOut: folds
Uncalled bet ($6000) returned to slotmachine
slotmachine collected $5819 from pot
slotmachine: doesn't show hand
*** SUMMARY ***
Total pot $6000 | Rake $181
Board [Jd 5h 2c]
Seat 1: Prateek1986 (button) folded before Flop (didn't bet)
Seat 3: slotmachine (small blind) collected ($5819)
Seat 4: TurnOnTuneInDropOut (big blind) folded on the Flop
Seat 5: aggtarun folded before Flop (didn't bet)

PokerStars Hand #1957459604: Omaha Pot Limit ($500/$1000 USD) - 2020/10/23 13:47:29 ET
Table 'ADA540885739' 6-max Seat #3 is the button
Seat 1: Prateek1986 ($50866 in chips)
Seat 3: slotmachine ($75354 in chips)
Seat 4: TurnOnTuneInDropOut ($98224 in chips)
Seat 5: aggtarun ($147785 in chips)
TurnOnTuneInDropOut: posts small blind $500
aggtarun: posts big blind $1000
*** HOLE CARDS ***
Dealt to TurnOnTuneInDropOut [5h 4d Td 6h]
Prateek1986: folds
slotmachine: raises $2500 to $3500
TurnOnTuneInDropOut: folds
aggtarun: raises $7500 to $11000
slotmachine: calls $7500
*** FLOP *** [Jh 5c 9c]
aggtarun: bets $22500
slotmachine: raises $41854 to $64354 and is all-in
aggtarun: calls $41854
*** TURN *** [Jh 5c 9c] [2h]
*** RIVER *** [Jh 5c 9c 2h] [6d]
*** SHOW DOWN ***
aggtarun: shows [As 4c 6c Js]
slotmachine: shows [3c Kd 8d Jc]
aggtarun collected $149809 from pot
*** SUMMARY ***
Total pot $151208 | Rake $1399
Board [Jh 5c 9c 2h 6d]
Seat 1: Prateek1986 folded before Flop (didn't bet)
Seat 3: slotmachine (button) showed [3c Kd 8d Jc] and lost
Seat 4: TurnOnTuneInDropOut (small blind) folded before Flop
Seat 5: aggtarun (big blind) showed [As 4c 6c Js] and won ($149809)

PokerStars Hand #1957459605: Omaha Pot Limit ($500/$1000 USD) - 2020/10/23 13:48:15 ET
Table 'ADA540885739' 6-max Seat #4 is the button
Seat 1: Prateek1986 ($50866 in chips)
Seat 3: slotmachine ($90000 in chips)
Seat 4: TurnOnTuneInDropOut ($97724 in chips)
Seat 5: aggtarun ($222240 in chips)
aggtarun: posts small blind $500
Prateek1986: posts big blind $1000
*** HOLE CARDS ***
Dealt to TurnOnTuneInDropOut [5s Th 6d Ah]
slotmachine: folds
TurnOnTuneInDropOut: raises $2500 to $3500
aggtarun: folds
Prateek1986: folds
Uncalled bet ($2500) returned to TurnOnTuneInDropOut
TurnOnTuneInDropOut collected $2500 from pot
TurnOnTuneInDropOut: doesn't show hand
*** SUMMARY ***
Total pot $2500 | Rake $0
Seat 1: Prateek1986 (big blind) folded before Flop
Seat 3: slotmachine folded before Flop (didn't bet)
Seat 4: TurnOnTuneInDropOut (button) collected ($2500)
Seat 5: aggtarun (small blind) folded before Flop

PokerStars Hand #1957459606: Omaha Pot Limit ($500/$1000 USD) - 2020/10/23 13:48:30 ET
Table 'ADA540885739' 6-max Seat #5 is the button
Seat 1: Prateek1986 ($49866 in chips)
Seat 2: Lock2k16 ($92649 in chips)
Seat 3: slotmachine ($90000 in chips)
Seat 4: TurnOnTuneInDropOut ($99224 in chips)
Seat 5: aggtarun ($221740 in chips)
Prateek1986: posts small blind $500
Lock2k16: posts big blind $1000
*** HOLE CARDS ***
Dealt to TurnOnTuneInDropOut [8d 8s Ad 5s]
slotmachine: folds
TurnOnTuneInDropOut: raises $2500 to $3500
aggtarun: calls $3500
Prateek1986: folds
Lock2k16: calls $2500
*** FLOP *** [Tc Jc 7s]
Lock2k16: checks
TurnOnTuneInDropOut: checks
aggtarun: checks
*** TURN *** [Tc Jc 7s] [2c]
Lock2k16: bets $3000
TurnOnTuneInDropOut: folds
aggtarun: folds
Uncalled bet ($3000) returned to Lock2k16
Lock2k16 collected $10669 from pot
Lock2k16: doesn't show hand
*** SUMMARY ***
Total pot $11000 | Rake $331
Board [Tc Jc 7s 2c]
Seat 1: Prateek1986 (small blind) folded before Flop
Seat 2: Lock2k16 (big blind) collected ($10669)
Seat 3: slotmachine folded before Flop (didn't bet)
Seat 4: TurnOnTuneInDropOut folded on the Turn
Seat 5: aggtarun (button) folded on the Turn

PokerStars Hand #1957459607: Omaha Pot Limit ($500/$1000 USD) - 2020/10/23 13:49:15 ET
Table 'ADA540885739' 6-max Seat #1 is the button
Seat 1: Prateek1986 ($49366 in chips)
Seat 2: Lock2k16 ($99818 in chips)
Seat 3: slotmachine ($90000 in chips)
Seat 4: TurnOnTuneInDropOut ($95724 in chips)
Seat 5: aggtarun ($218240 in chips)
Seat 6: Shr181 ($42750 in chips)
Lock2k16: posts small blind $500
slotmachine: posts big blind $1000
Shr181: posts big blind $1000
*** HOLE CARDS ***
Dealt to TurnOnTuneInDropOut [6d As 4h 3h]
TurnOnTuneInDropOut: folds
aggtarun: calls $1000
Shr181: checks
Prateek1986: folds
Lock2k16: raises $1000 to $2000
slotmachine: folds
aggtarun: raises $6000 to $8000
Shr181: folds
Lock2k16: calls $6000
*** FLOP *** [3s 6h 2d]
Lock2k16: checks
aggtarun: checks
*** TURN *** [3s 6h 2d] [8c]
Lock2k16: bets $4000
aggtarun: raises $20400 to $24400
Lock2k16: folds
Uncalled bet ($20400) returned to aggtarun
aggtarun collected $25217 from pot
aggtarun: doesn't show hand
*** SUMMARY ***
Total pot $26000 | Rake $783
Board [3s 6h 2d 8c]
Seat 1: Prateek1986 (button) folded before Flop (didn't bet)
Seat 2: Lock2k16 (small blind) folded on the Turn
Seat 3: slotmachine (big blind) folded before Flop
Seat 4: TurnOnTuneInDropOut folded before Flop (didn't bet)
Seat 5: aggtarun collected ($25217)
Seat 6: Shr181 folded before Flop

PokerStars Hand #1957459617: Omaha Pot Limit ($500/$1000 USD) - 2020/10/23 13:59:52 ET
Table 'ADA540885739' 6-max Seat #6 is the button
Seat 1: Prateek1986 ($43366 in chips)
Seat 2: Lock2k16 ($74179 in chips)
Seat 3: slotmachine ($121684 in chips)
Seat 4: TurnOnTuneInDropOut ($86036 in chips)
Seat 5: aggtarun ($264852 in chips)
Seat 6: Shr181 ($32250 in chips)
Prateek1986: posts small blind $500
Lock2k16: posts big blind $1000
*** HOLE CARDS ***
Dealt to TurnOnTuneInDropOut [Qd 9c Ac Js]
slotmachine: folds
TurnOnTuneInDropOut: raises $2500 to $3500
aggtarun: folds
Shr181: calls $3500
Prateek1986: calls $3000
Lock2k16: calls $2500
*** FLOP *** [Jh 5c Ks]
Prateek1986: checks
Lock2k16: checks
TurnOnTuneInDropOut: checks
Shr181: checks
*** TURN *** [Jh 5c Ks] [2d]
Prateek1986: checks
Lock2k16: bets $4000
TurnOnTuneInDropOut: calls $4000
Shr181: calls $4000
Prateek1986: calls $4000
*** RIVER *** [Jh 5c Ks 2d] [4d]
Prateek1986: bets $22500
Lock2k16: folds
TurnOnTuneInDropOut: folds
Shr181: folds
Uncalled bet ($22500) returned to Prateek1986
Prateek1986 collected $29097 from pot
Prateek1986: doesn't show hand
*** SUMMARY ***
Total pot $30000 | Rake $903
Board [Jh 5c Ks 2d 4d]
Seat 1: Prateek1986 (small blind) collected ($29097)
Seat 2: Lock2k16 (big blind) folded on the River
Seat 3: slotmachine folded before Flop (didn't bet)
Seat 4: TurnOnTuneInDropOut folded on the River
Seat 5: aggtarun folded before Flop (didn't bet)
Seat 6: Shr181 (button) folded on the River

PokerStars Hand #1957459618: Omaha Pot Limit ($500/$1000 USD) - 2020/10/23 14:01:10 ET
Table 'ADA540885739' 6-max Seat #1 is the button
Seat 1: Prateek1986 ($64963 in chips)
Seat 2: Lock2k16 ($66679 in chips)
Seat 3: slotmachine ($121684 in chips)
Seat 4: TurnOnTuneInDropOut ($78536 in chips)
Seat 5: aggtarun ($264852 in chips)
Seat 6: Shr181 ($24750 in chips)
Lock2k16: posts small blind $500
slotmachine: posts big blind $1000
*** HOLE CARDS ***
Dealt to TurnOnTuneInDropOut [Ts 3c 6h 3d]
TurnOnTuneInDropOut: folds
aggtarun: raises $2500 to $3500
Shr181: raises $2500 to $6000
Prateek1986: calls $6000
Lock2k16: folds
slotmachine: folds
aggtarun: raises $19500 to $25500
Shr181: calls $18750 and is all-in
Prateek1986: calls $19500
*** FLOP *** [Th 9d 4c]
aggtarun: bets $77250
Prateek1986: calls $39463 and is all-in
Uncalled bet ($37787) returned to aggtarun
*** TURN *** [Th 9d 4c] [7d]
*** RIVER *** [Th 9d 4c 7d] [Kc]
*** SHOW DOWN ***
aggtarun: shows [Qc Qs Kd 8s]
Prateek1986: shows [Td Ah Qd 5h]
aggtarun collected $80426 from side pot
Shr181: shows [Jh 3s Jd 4h]
aggtarun collected $74351 from main pot
*** SUMMARY ***
Total pot $156176 Main pot $74351. Side pot $80426. | Rake $1399
Board [Th 9d 4c 7d Kc]
Seat 1: Prateek1986 (button) showed [Td Ah Qd 5h] and lost
Seat 2: Lock2k16 (small blind) folded before Flop
Seat 3: slotmachine (big blind) folded before Flop
Seat 4: TurnOnTuneInDropOut folded before Flop (didn't bet)
Seat 5: aggtarun showed [Qc Qs Kd 8s] and won ($154777)
Seat 6: Shr181 showed [Jh 3s Jd 4h] and lost

PokerStars Hand #1957459619: Omaha Pot Limit ($500/$1000 USD) - 2020/10/23 14:02:19 ET
Table 'ADA540885739' 6-max Seat #2 is the button
Seat 2: Lock2k16 ($66179 in chips)
Seat 3: slotmachine ($120684 in chips)
Seat 4: TurnOnTuneInDropOut ($78536 in chips)
Seat 5: aggtarun ($354666 in chips)
slotmachine: posts small blind $500
TurnOnTuneInDropOut: posts big blind $1000
*** HOLE CARDS ***
Dealt to TurnOnTuneInDropOut [6d 8d Jh 9s]
aggtarun: raises $2500 to $3500
Lock2k16: folds
slotmachine: folds
TurnOnTuneInDropOut: folds
Uncalled bet ($2500) returned to aggtarun
aggtarun collected $2500 from pot
aggtarun: doesn't show hand
*** SUMMARY ***
Total pot $2500 | Rake $0
Seat 2: Lock2k16 (button) folded before Flop (didn't bet)
Seat 3: slotmachine (small blind) folded before Flop
Seat 4: TurnOnTuneInDropOut (big blind) folded before Flop
Seat 5: aggtarun collected ($2500)

PokerStars Hand #1957459621: Omaha Pot Limit ($500/$1000 USD) - 2020/10/23 14:03:21 ET
Table 'ADA540885739' 6-max Seat #4 is the button
Seat 2: Lock2k16 ($70423 in chips)
Seat 3: slotmachine ($120184 in chips)
Seat 4: TurnOnTuneInDropOut ($77036 in chips)
Seat 5: aggtarun ($352166 in chips)
aggtarun: posts small blind $500
Lock2k16: posts big blind $1000
*** HOLE CARDS ***
Dealt to TurnOnTuneInDropOut [7c 8s 6s 3c]
slotmachine: folds
TurnOnTuneInDropOut: raises $2500 to $3500
aggtarun: folds
Lock2k16: folds
Uncalled bet ($2500) returned to TurnOnTuneInDropOut
TurnOnTuneInDropOut collected $2500 from pot
TurnOnTuneInDropOut: doesn't show hand
*** SUMMARY ***
Total pot $2500 | Rake $0
Seat 2: Lock2k16 (big blind) folded before Flop
Seat 3: slotmachine folded before Flop (didn't bet)
Seat 4: TurnOnTuneInDropOut (button) collected ($2500)
Seat 5: aggtarun (small blind) folded before Flop

PokerStars Hand #1957459622: Omaha Pot Limit ($500/$1000 USD) - 2020/10/23 14:03:48 ET
Table 'ADA540885739' 6-max Seat #5 is the button
Seat 2: Lock2k16 ($69423 in chips)
Seat 3: slotmachine ($120184 in chips)
Seat 4: TurnOnTuneInDropOut ($78536 in chips)
Seat 5: aggtarun ($351666 in chips)
Lock2k16: posts small blind $500
slotmachine: posts big blind $1000
*** HOLE CARDS ***
Dealt to TurnOnTuneInDropOut [6c 8d Qs 2c]
TurnOnTuneInDropOut: folds
aggtarun: folds
Lock2k16: calls $500
slotmachine: raises $2000 to $3000
Lock2k16: folds
Uncalled bet ($2000) returned to slotmachine
slotmachine collected $2000 from pot
slotmachine: doesn't show hand
*** SUMMARY ***
Total pot $2000 | Rake $0
Seat 2: Lock2k16 (small blind) folded before Flop
Seat 3: slotmachine (big blind) collected ($2000)
Seat 4: TurnOnTuneInDropOut folded before Flop (didn't bet)
Seat 5: aggtarun (button) folded before Flop (didn't bet)

PokerStars Hand #1957459627: Omaha Pot Limit ($500/$1000 USD) - 2020/10/23 14:06:38 ET
Table 'ADA540885739' 6-max Seat #2 is the button
Seat 2: Lock2k16 ($63995 in chips)
Seat 3: slotmachine ($132862 in chips)
Seat 4: TurnOnTuneInDropOut ($78536 in chips)
Seat 5: aggtarun ($346666 in chips)
Seat 6: gaganhyd ($36720 in chips)
slotmachine: posts small blind $500
TurnOnTuneInDropOut: posts big blind $1000
*** HOLE CARDS ***
Dealt to TurnOnTuneInDropOut [Ad 2d Td 6h]
aggtarun: folds
gaganhyd: folds
Lock2k16: raises $1000 to $2000
slotmachine: folds
TurnOnTuneInDropOut: calls $1000
*** FLOP *** [Tc 9h 3s]
TurnOnTuneInDropOut: checks
Lock2k16: bets $1000
TurnOnTuneInDropOut: calls $1000
*** TURN *** [Tc 9h 3s] [Js]
TurnOnTuneInDropOut: checks
Lock2k16: bets $6500
TurnOnTuneInDropOut: folds
Uncalled bet ($6500) returned to Lock2k16
Lock2k16 collected $6304 from pot
Lock2k16: doesn't show hand
*** SUMMARY ***
Total pot $6500 | Rake $196
Board [Tc 9h 3s Js]
Seat 2: Lock2k16 (button) collected ($6304)
Seat 3: slotmachine (small blind) folded before Flop
Seat 4: TurnOnTuneInDropOut (big blind) folded on the Turn
Seat 5: aggtarun folded before Flop (didn't bet)
Seat 6: gaganhyd folded before Flop (didn't bet)

PokerStars Hand #1957459628: Omaha Pot Limit ($500/$1000 USD) - 2020/10/23 14:07:13 ET
Table 'ADA540885739' 6-max Seat #3 is the button
Seat 2: Lock2k16 ($67299 in chips)
Seat 3: slotmachine ($132362 in chips)
Seat 4: TurnOnTuneInDropOut ($75536 in chips)
Seat 5: aggtarun ($346666 in chips)
Seat 6: gaganhyd ($36720 in chips)
TurnOnTuneInDropOut: posts small blind $500
aggtarun: posts big blind $1000
*** HOLE CARDS ***
Dealt to TurnOnTuneInDropOut [Ks 7d 2s Kd]
gaganhyd: folds
Lock2k16: raises $1000 to $2000
slotmachine: folds
TurnOnTuneInDropOut: raises $5000 to $7000
aggtarun: folds
Lock2k16: calls $5000
*** FLOP *** [3h 5h Kh]
TurnOnTuneInDropOut: bets $2950
Lock2k16: calls $2950
*** TURN *** [3h 5h Kh] [Qs]
TurnOnTuneInDropOut: checks
Lock2k16: bets $10450
TurnOnTuneInDropOut: calls $10450
*** RIVER *** [3h 5h Kh Qs] [Ts]
TurnOnTuneInDropOut: checks
Lock2k16: bets $20900
TurnOnTuneInDropOut: calls $20900
*** SHOW DOWN ***
TurnOnTuneInDropOut: shows [Ks 7d 2s Kd]
Lock2k16: mucks hand
TurnOnTuneInDropOut collected $82201 from pot
*** SUMMARY ***
Total pot $83600 | Rake $1399
Board [3h 5h Kh Qs Ts]
Seat 2: Lock2k16 mucked
Seat 3: slotmachine (button) folded before Flop (didn't bet)
Seat 4: TurnOnTuneInDropOut (small blind) showed [Ks 7d 2s Kd] and won ($82201)
Seat 5: aggtarun (big blind) folded before Flop
Seat 6: gaganhyd folded before Flop (didn't bet)

PokerStars Hand #1957459631: Omaha Pot Limit ($500/$1000 USD) - 2020/10/23 14:09:41 ET
Table 'ADA540885739' 6-max Seat #6 is the button
Seat 1: inveigle ($120000 in chips)
Seat 2: Lock2k16 ($23499 in chips)
Seat 3: slotmachine ($133862 in chips)
Seat 4: TurnOnTuneInDropOut ($116437 in chips)
Seat 5: aggtarun ($343166 in chips)
Seat 6: gaganhyd ($40994 in chips)
inveigle: posts small blind $500
Lock2k16: posts big blind $1000
*** HOLE CARDS ***
Dealt to TurnOnTuneInDropOut [8s 6d Kc 3d]
slotmachine: folds
TurnOnTuneInDropOut: folds
aggtarun: folds
gaganhyd: folds
inveigle: calls $500
Lock2k16: raises $2000 to $3000
inveigle: raises $6000 to $9000
Lock2k16: calls $6000
*** FLOP *** [8c Qc 2d]
inveigle: bets $18000
Lock2k16: calls $14499 and is all-in
Uncalled bet ($3501) returned to inveigle
*** TURN *** [8c Qc 2d] [Qh]
*** RIVER *** [8c Qc 2d Qh] [Th]
*** SHOW DOWN ***
inveigle: shows [7d Kd 4h Kh]
Lock2k16: shows [Ad 9h 2s 7h]
inveigle collected $45599 from pot
*** SUMMARY ***
Total pot $46998 | Rake $1399
Board [8c Qc 2d Qh Th]
Seat 1: inveigle (small blind) showed [7d Kd 4h Kh] and won ($45599)
Seat 2: Lock2k16 (big blind) showed [Ad 9h 2s 7h] and lost
Seat 3: slotmachine folded before Flop (didn't bet)
Seat 4: TurnOnTuneInDropOut folded before Flop (didn't bet)
Seat 5: aggtarun folded before Flop (didn't bet)
Seat 6: gaganhyd (button) folded before Flop (didn't bet)

PokerStars Hand #1957459647: Omaha Pot Limit ($500/$1000 USD) - 2020/10/23 14:18:34 ET
Table 'ADA540885739' 6-max Seat #3 is the button
Seat 1: inveigle ($119500 in chips)
Seat 3: slotmachine ($179828 in chips)
Seat 4: TurnOnTuneInDropOut ($107437 in chips)
Seat 5: prashantshah ($41500 in chips)
TurnOnTuneInDropOut: posts small blind $500
prashantshah: posts big blind $1000
*** HOLE CARDS ***
Dealt to TurnOnTuneInDropOut [Ad 4h Ah 6s]
inveigle: folds
slotmachine: folds
TurnOnTuneInDropOut: raises $2000 to $3000
prashantshah: calls $2000
*** FLOP *** [Kc 9h Jc]
TurnOnTuneInDropOut: checks
prashantshah: checks
*** TURN *** [Kc 9h Jc] [6c]
TurnOnTuneInDropOut: checks
prashantshah: checks
*** RIVER *** [Kc 9h Jc 6c] [5h]
TurnOnTuneInDropOut: checks
prashantshah: bets $1000
TurnOnTuneInDropOut: folds
Uncalled bet ($1000) returned to prashantshah
prashantshah collected $5819 from pot
prashantshah: doesn't show hand
*** SUMMARY ***
Total pot $6000 | Rake $181
Board [Kc 9h Jc 6c 5h]
Seat 1: inveigle folded before Flop (didn't bet)
Seat 3: slotmachine (button) folded before Flop (didn't bet)
Seat 4: TurnOnTuneInDropOut (small blind) folded on the River
Seat 5: prashantshah (big blind) collected ($5819)

PokerStars Hand #1957459648: Omaha Pot Limit ($500/$1000 USD) - 2020/10/23 14:19:37 ET
Table 'ADA540885739' 6-max Seat #4 is the button
Seat 1: inveigle ($119500 in chips)
Seat 3: slotmachine ($179828 in chips)
Seat 4: TurnOnTuneInDropOut ($104437 in chips)
Seat 5: prashantshah ($44319 in chips)
Seat 6: Prateek1986 ($41614 in chips)
prashantshah: posts small blind $500
Prateek1986: posts big blind $1000
*** HOLE CARDS ***
Dealt to TurnOnTuneInDropOut [Ks 2s 7c 3c]
inveigle: folds
slotmachine: folds
TurnOnTuneInDropOut: folds
prashantshah: calls $500
Prateek1986: checks
*** FLOP *** [Qc 6s 9c]
prashantshah: checks
Prateek1986: checks
*** TURN *** [Qc 6s 9c] [6c]
prashantshah: checks
Prateek1986: checks
*** RIVER *** [Qc 6s 9c 6c] [7d]
prashantshah: checks
Prateek1986: checks
*** SHOW DOWN ***
prashantshah: shows [Jd 7h Kc 4h]
Prateek1986: mucks hand
prashantshah collected $1940 from pot
*** SUMMARY ***
Total pot $2000 | Rake $60
Board [Qc 6s 9c 6c 7d]
Seat 1: inveigle folded before Flop (didn't bet)
Seat 3: slotmachine folded before Flop (didn't bet)
Seat 4: TurnOnTuneInDropOut (button) folded before Flop (didn't bet)
Seat 5: prashantshah (small blind) showed [Jd 7h Kc 4h] and won ($1940)
Seat 6: Prateek1986 (big blind) mucked

PokerStars Hand #1957459649: Omaha Pot Limit ($500/$1000 USD) - 2020/10/23 14:20:26 ET
Table 'ADA540885739' 6-max Seat #5 is the button
Seat 1: inveigle ($119500 in chips)
Seat 3: slotmachine ($179828 in chips)
Seat 4: TurnOnTuneInDropOut ($104437 in chips)
Seat 5: prashantshah ($45259 in chips)
Seat 6: Prateek1986 ($40614 in chips)
Prateek1986: posts small blind $500
inveigle: posts big blind $1000
*** HOLE CARDS ***
Dealt to TurnOnTuneInDropOut [7s Jd Kd Kh]
slotmachine: folds
TurnOnTuneInDropOut: raises $2500 to $3500
prashantshah: folds
Prateek1986: folds
inveigle: folds
Uncalled bet ($2500) returned to TurnOnTuneInDropOut
TurnOnTuneInDropOut collected $2500 from pot
TurnOnTuneInDropOut: doesn't show hand
*** SUMMARY ***
Total pot $2500 | Rake $0
Seat 1: inveigle (big blind) folded before Flop
Seat 3: slotmachine folded before Flop (didn't bet)
Seat 4: TurnOnTuneInDropOut collected ($2500)
Seat 5: prashantshah (button) folded before Flop (didn't bet)
Seat 6: Prateek1986 (small blind) folded before Flop

PokerStars Hand #1957459650: Omaha Pot Limit ($500/$1000 USD) - 2020/10/23 14:20:56 ET
Table 'ADA540885739' 6-max Seat #6 is the button
Seat 1: inveigle ($118500 in chips)
Seat 3: slotmachine ($179828 in chips)
Seat 4: TurnOnTuneInDropOut ($105937 in chips)
Seat 5: prashantshah ($45259 in chips)
Seat 6: Prateek1986 ($40114 in chips)
inveigle: posts small blind $500
slotmachine: posts big blind $1000
*** HOLE CARDS ***
Dealt to TurnOnTuneInDropOut [Kh 8s 4h Ac]
TurnOnTuneInDropOut: folds
prashantshah: folds
Prateek1986: calls $1000
inveigle: calls $500
slotmachine: checks
*** FLOP *** [6d 5s Kd]
inveigle: checks
slotmachine: checks
Prateek1986: checks
*** TURN *** [6d 5s Kd] [Js]
inveigle: checks
slotmachine: checks
Prateek1986: checks
*** RIVER *** [6d 5s Kd Js] [8h]
inveigle: bets $3000
slotmachine: folds
Prateek1986: folds
Uncalled bet ($3000) returned to inveigle
inveigle collected $2910 from pot
inveigle: doesn't show hand
*** SUMMARY ***
Total pot $3000 | Rake $90
Board [6d 5s Kd Js 8h]
Seat 1: inveigle (small blind) collected ($2910)
Seat 3: slotmachine (big blind) folded on the River
Seat 4: TurnOnTuneInDropOut folded before Flop (didn't bet)
Seat 5: prashantshah folded before Flop (didn't bet)
Seat 6: Prateek1986 (button) folded on the River

PokerStars Hand #1957459652: Omaha Pot Limit ($500/$1000 USD) - 2020/10/23 14:22:56 ET
Table 'ADA540885739' 6-max Seat #3 is the button
Seat 1: inveigle ($121910 in chips)
Seat 3: slotmachine ($178328 in chips)
Seat 4: TurnOnTuneInDropOut ($104937 in chips)
Seat 5: prashantshah ($45259 in chips)
Seat 6: Prateek1986 ($39114 in chips)
TurnOnTuneInDropOut: posts small blind $500
prashantshah: posts big blind $1000
*** HOLE CARDS ***
Dealt to TurnOnTuneInDropOut [6c Kd As 4h]
Prateek1986: folds
inveigle: folds
slotmachine: folds
TurnOnTuneInDropOut: folds
Uncalled bet ($500) returned to prashantshah
prashantshah collected $1000 from pot
prashantshah: doesn't show hand
*** SUMMARY ***
Total pot $1000 | Rake $0
Seat 1: inveigle folded before Flop (didn't bet)
Seat 3: slotmachine (button) folded before Flop (didn't bet)
Seat 4: TurnOnTuneInDropOut (small blind) folded before Flop
Seat 5: prashantshah (big blind) collected ($1000)
Seat 6: Prateek1986 folded before Flop (didn't bet)

PokerStars Hand #1957459653: Omaha Pot Limit ($500/$1000 USD) - 2020/10/23 14:23:23 ET
Table 'ADA540885739' 6-max Seat #4 is the button
Seat 3: slotmachine ($178328 in chips)
Seat 4: TurnOnTuneInDropOut ($104437 in chips)
Seat 5: prashantshah ($45759 in chips)
Seat 6: Prateek1986 ($39114 in chips)
prashantshah: posts small blind $500
Prateek1986: posts big blind $1000
*** HOLE CARDS ***
Dealt to TurnOnTuneInDropOut [6d Jc Qh 7s]
slotmachine: folds
TurnOnTuneInDropOut: folds
prashantshah: calls $500
Prateek1986: raises $2000 to $3000
prashantshah: folds
Uncalled bet ($2000) returned to Prateek1986
Prateek1986 collected $2000 from pot
Prateek1986: doesn't show hand
*** SUMMARY ***
Total pot $2000 | Rake $0
Seat 3: slotmachine folded before Flop (didn't bet)
Seat 4: TurnOnTuneInDropOut (button) folded before Flop (didn't bet)
Seat 5: prashantshah (small blind) folded before Flop
Seat 6: Prateek1986 (big blind) collected ($2000)

PokerStars Hand #1957459654: Omaha Pot Limit ($500/$1000 USD) - 2020/10/23 14:23:56 ET
Table 'ADA540885739' 6-max Seat #5 is the button
Seat 3: slotmachine ($178328 in chips)
Seat 4: TurnOnTuneInDropOut ($104437 in chips)
Seat 5: prashantshah ($44759 in chips)
Seat 6: Prateek1986 ($40114 in chips)
Prateek1986: posts small blind $500
slotmachine: posts big blind $1000
*** HOLE CARDS ***
Dealt to TurnOnTuneInDropOut [Kh 4d 7h 8h]
TurnOnTuneInDropOut: folds
prashantshah: folds
Prateek1986: folds
Uncalled bet ($500) returned to slotmachine
slotmachine collected $1000 from pot
slotmachine: doesn't show hand
*** SUMMARY ***
Total pot $1000 | Rake $0
Seat 3: slotmachine (big blind) collected ($1000)
Seat 4: TurnOnTuneInDropOut folded before Flop (didn't bet)
Seat 5: prashantshah (button) folded before Flop (didn't bet)
Seat 6: Prateek1986 (small blind) folded before Flop

PokerStars Hand #1957459657: Omaha Pot Limit ($500/$1000 USD) - 2020/10/23 14:26:21 ET
Table 'ADA540885739' 6-max Seat #4 is the button
Seat 3: slotmachine ($178328 in chips)
Seat 4: TurnOnTuneInDropOut ($105832 in chips)
Seat 5: prashantshah ($48488 in chips)
Seat 6: Prateek1986 ($34614 in chips)
prashantshah: posts small blind $500
Prateek1986: posts big blind $1000
*** HOLE CARDS ***
Dealt to TurnOnTuneInDropOut [Kd 8s Ac Kc]
slotmachine: folds
TurnOnTuneInDropOut: raises $2500 to $3500
prashantshah: folds
Prateek1986: folds
Uncalled bet ($2500) returned to TurnOnTuneInDropOut
TurnOnTuneInDropOut collected $2500 from pot
TurnOnTuneInDropOut: doesn't show hand
*** SUMMARY ***
Total pot $2500 | Rake $0
Seat 3: slotmachine folded before Flop (didn't bet)
Seat 4: TurnOnTuneInDropOut (button) collected ($2500)
Seat 5: prashantshah (small blind) folded before Flop
Seat 6: Prateek1986 (big blind) folded before Flop

PokerStars Hand #1957459658: Omaha Pot Limit ($500/$1000 USD) - 2020/10/23 14:26:39 ET
Table 'ADA540885739' 6-max Seat #5 is the button
Seat 3: slotmachine ($178328 in chips)
Seat 4: TurnOnTuneInDropOut ($107332 in chips)
Seat 5: prashantshah ($47988 in chips)
Seat 6: Prateek1986 ($33614 in chips)
Prateek1986: posts small blind $500
slotmachine: posts big blind $1000
*** HOLE CARDS ***
Dealt to TurnOnTuneInDropOut [As 5h 9h Js]
TurnOnTuneInDropOut: raises $2500 to $3500
prashantshah: folds
Prateek1986: calls $3000
slotmachine: folds
*** FLOP *** [Qs 3c 4c]
Prateek1986: checks
TurnOnTuneInDropOut: checks
*** TURN *** [Qs 3c 4c] [Ad]
Prateek1986: checks
TurnOnTuneInDropOut: bets $6000
Prateek1986: folds
Uncalled bet ($6000) returned to TurnOnTuneInDropOut
TurnOnTuneInDropOut collected $7759 from pot
TurnOnTuneInDropOut: doesn't show hand
*** SUMMARY ***
Total pot $8000 | Rake $241
Board [Qs 3c 4c Ad]
Seat 3: slotmachine (big blind) folded before Flop
Seat 4: TurnOnTuneInDropOut collected ($7759)
Seat 5: prashantshah (button) folded before Flop (didn't bet)
Seat 6: Prateek1986 (small blind) folded on the Turn

PokerStars Hand #1957459662: Omaha Pot Limit ($500/$1000 USD) - 2020/10/23 14:29:44 ET
Table 'ADA540885739' 6-max Seat #5 is the button
Seat 3: slotmachine ($178328 in chips)
Seat 4: TurnOnTuneInDropOut ($110091 in chips)
Seat 5: prashantshah ($45488 in chips)
Seat 6: Prateek1986 ($33039 in chips)
Prateek1986: posts small blind $500
slotmachine: posts big blind $1000
*** HOLE CARDS ***
Dealt to TurnOnTuneInDropOut [2s Tc 9c 5h]
TurnOnTuneInDropOut: folds
prashantshah: folds
Prateek1986: calls $500
slotmachine: raises $2000 to $3000
Prateek1986: calls $2000
*** FLOP *** [Qs 2h 7s]
Prateek1986: checks
slotmachine: bets $6000
Prateek1986: folds
Uncalled bet ($6000) returned to slotmachine
slotmachine collected $5819 from pot
slotmachine: doesn't show hand
*** SUMMARY ***
Total pot $6000 | Rake $181
Board [Qs 2h 7s]
Seat 3: slotmachine (big blind) collected ($5819)
Seat 4: TurnOnTuneInDropOut folded before Flop (didn't bet)
Seat 5: prashantshah (button) folded before Flop (didn't bet)
Seat 6: Prateek1986 (small blind) folded on the Flop

PokerStars Hand #1957459663: Omaha Pot Limit ($500/$1000 USD) - 2020/10/23 14:30:33 ET
Table 'ADA540885739' 6-max Seat #6 is the button
Seat 3: slotmachine ($181147 in chips)
Seat 4: TurnOnTuneInDropOut ($110091 in chips)
Seat 5: prashantshah ($45488 in chips)
Seat 6: Prateek1986 ($30039 in chips)
slotmachine: posts small blind $500
TurnOnTuneInDropOut: posts big blind $1000
*** HOLE CARDS ***
Dealt to TurnOnTuneInDropOut [7h Kc 2s Tc]
prashantshah: folds
Prateek1986: folds
slotmachine: raises $2000 to $3000
TurnOnTuneInDropOut: calls $2000
*** FLOP *** [4s 7d 4d]
slotmachine: bets $1980
TurnOnTuneInDropOut: raises $5401 to $7381
slotmachine: calls $5401
*** TURN *** [4s 7d 4d] [8c]
slotmachine: checks
TurnOnTuneInDropOut: checks
*** RIVER *** [4s 7d 4d 8c] [6c]
slotmachine: bets $10381
TurnOnTuneInDropOut: folds
Uncalled bet ($10381) returned to slotmachine
slotmachine collected $20137 from pot
slotmachine: doesn't show hand
*** SUMMARY ***
Total pot $20762 | Rake $625
Board [4s 7d 4d 8c 6c]
Seat 3: slotmachine (small blind) collected ($20137)
Seat 4: TurnOnTuneInDropOut (big blind) folded on the River
Seat 5: prashantshah folded before Flop (didn't bet)
Seat 6: Prateek1986 (button) folded before Flop (didn't bet)

PokerStars Hand #1957459666: Omaha Pot Limit ($500/$1000 USD) - 2020/10/23 14:32:40 ET
Table 'ADA540885739' 6-max Seat #5 is the button
Seat 3: slotmachine ($192403 in chips)
Seat 4: TurnOnTuneInDropOut ($99210 in chips)
Seat 5: prashantshah ($43988 in chips)
Seat 6: Prateek1986 ($30464 in chips)
Prateek1986: posts small blind $500
slotmachine: posts big blind $1000
*** HOLE CARDS ***
Dealt to TurnOnTuneInDropOut [Ks 8s 5h Kd]
TurnOnTuneInDropOut: raises $2500 to $3500
prashantshah: folds
Prateek1986: calls $3000
slotmachine: folds
*** FLOP *** [9h 2d Th]
Prateek1986: checks
TurnOnTuneInDropOut: checks
*** TURN *** [9h 2d Th] [Js]
Prateek1986: checks
TurnOnTuneInDropOut: bets $6000
Prateek1986: folds
Uncalled bet ($6000) returned to TurnOnTuneInDropOut
TurnOnTuneInDropOut collected $7759 from pot
TurnOnTuneInDropOut: doesn't show hand
*** SUMMARY ***
Total pot $8000 | Rake $241
Board [9h 2d Th Js]
Seat 3: slotmachine (big blind) folded before Flop
Seat 4: TurnOnTuneInDropOut collected ($7759)
Seat 5: prashantshah (button) folded before Flop (didn't bet)
Seat 6: Prateek1986 (small blind) folded on the Turn

PokerStars Hand #1957459667: Omaha Pot Limit ($500/$1000 USD) - 2020/10/23 14:33:41 ET
Table 'ADA540885739' 6-max Seat #6 is the button
Seat 3: slotmachine ($191403 in chips)
Seat 4: TurnOnTuneInDropOut ($103469 in chips)
Seat 5: prashantshah ($43988 in chips)
Seat 6: Prateek1986 ($26964 in chips)
slotmachine: posts small blind $500
TurnOnTuneInDropOut: posts big blind $1000
*** HOLE CARDS ***
Dealt to TurnOnTuneInDropOut [8c 7s Kd 8s]
prashantshah: folds
Prateek1986: folds
slotmachine: folds
Uncalled bet ($500) returned to TurnOnTuneInDropOut
TurnOnTuneInDropOut collected $1000 from pot
TurnOnTuneInDropOut: doesn't show hand
*** SUMMARY ***
Total pot $1000 | Rake $0
Seat 3: slotmachine (small blind) folded before Flop
Seat 4: TurnOnTuneInDropOut (big blind) collected ($1000)
Seat 5: prashantshah folded before Flop (didn't bet)
Seat 6: Prateek1986 (button) folded before Flop (didn't bet)

PokerStars Hand #1957459670: Omaha Pot Limit ($500/$1000 USD) - 2020/10/23 14:35:42 ET
Table 'ADA540885739' 6-max Seat #5 is the button
Seat 3: slotmachine ($195647 in chips)
Seat 4: TurnOnTuneInDropOut ($99969 in chips)
Seat 5: prashantshah ($42488 in chips)
Seat 6: Prateek1986 ($27389 in chips)
Prateek1986: posts small blind $500
slotmachine: posts big blind $1000
*** HOLE CARDS ***
Dealt to TurnOnTuneInDropOut [Jc 8c Jd 3d]
TurnOnTuneInDropOut: raises $2500 to $3500
prashantshah: folds
Prateek1986: folds
slotmachine: calls $2500
*** FLOP *** [9s 4d Js]
slotmachine: checks
TurnOnTuneInDropOut: bets $5625
slotmachine: calls $5625
*** TURN *** [9s 4d Js] [4c]
slotmachine: checks
TurnOnTuneInDropOut: bets $12375
slotmachine: calls $12375
*** RIVER *** [9s 4d Js 4c] [7h]
slotmachine: checks
TurnOnTuneInDropOut: bets $43500
slotmachine: folds
Uncalled bet ($43500) returned to TurnOnTuneInDropOut
TurnOnTuneInDropOut collected $42191 from pot
TurnOnTuneInDropOut: doesn't show hand
*** SUMMARY ***
Total pot $43500 | Rake $1309
Board [9s 4d Js 4c 7h]
Seat 3: slotmachine (big blind) folded on the River
Seat 4: TurnOnTuneInDropOut collected ($42191)
Seat 5: prashantshah (button) folded before Flop (didn't bet)
Seat 6: Prateek1986 (small blind) folded before Flop

PokerStars Hand #1957459671: Omaha Pot Limit ($500/$1000 USD) - 2020/10/23 14:37:32 ET
Table 'ADA540885739' 6-max Seat #6 is the button
Seat 3: slotmachine ($174147 in chips)
Seat 4: TurnOnTuneInDropOut ($120660 in chips)
Seat 5: prashantshah ($42488 in chips)
Seat 6: Prateek1986 ($26889 in chips)
slotmachine: posts small blind $500
TurnOnTuneInDropOut: posts big blind $1000
*** HOLE CARDS ***
Dealt to TurnOnTuneInDropOut [Ac Tc Ad As]
prashantshah: folds
Prateek1986: raises $2500 to $3500
slotmachine: folds
TurnOnTuneInDropOut: raises $7500 to $11000
Prateek1986: calls $7500
*** FLOP *** [7d 5c Td]
TurnOnTuneInDropOut: bets $22500
Prateek1986: calls $15889 and is all-in
Uncalled bet ($6611) returned to TurnOnTuneInDropOut
*** TURN *** [7d 5c Td] [2c]
*** RIVER *** [7d 5c Td 2c] [9c]
*** SHOW DOWN ***
TurnOnTuneInDropOut: shows [Ac Tc Ad As]
Prateek1986: shows [Qd 3s 4c Qc]
TurnOnTuneInDropOut collected $52879 from pot
*** SUMMARY ***
Total pot $54278 | Rake $1399
Board [7d 5c Td 2c 9c]
Seat 3: slotmachine (small blind) folded before Flop
Seat 4: TurnOnTuneInDropOut (big blind) showed [Ac Tc Ad As] and won ($52879)
Seat 5: prashantshah folded before Flop (didn't bet)
Seat 6: Prateek1986 (button) showed [Qd 3s 4c Qc] and lost

PokerStars Hand #1957459672: Omaha Pot Limit ($500/$1000 USD) - 2020/10/23 14:38:20 ET
Table 'ADA540885739' 6-max Seat #3 is the button
Seat 3: slotmachine ($173647 in chips)
Seat 4: TurnOnTuneInDropOut ($146650 in chips)
Seat 5: prashantshah ($42488 in chips)
TurnOnTuneInDropOut: posts small blind $500
prashantshah: posts big blind $1000
*** HOLE CARDS ***
Dealt to TurnOnTuneInDropOut [5c As 7c 2d]
slotmachine: folds
TurnOnTuneInDropOut: folds
Uncalled bet ($500) returned to prashantshah
prashantshah collected $1000 from pot
prashantshah: doesn't show hand
*** SUMMARY ***
Total pot $1000 | Rake $0
Seat 3: slotmachine (button) folded before Flop (didn't bet)
Seat 4: TurnOnTuneInDropOut (small blind) folded before Flop
Seat 5: prashantshah (big blind) collected ($1000)

PokerStars Hand #1957459673: Omaha Pot Limit ($500/$1000 USD) - 2020/10/23 14:38:34 ET
Table 'ADA540885739' 6-max Seat #4 is the button
Seat 1: terminator369 ($30000 in chips)
Seat 3: slotmachine ($173647 in chips)
Seat 4: TurnOnTuneInDropOut ($146150 in chips)
Seat 5: prashantshah ($42988 in chips)
prashantshah: posts small blind $500
terminator369: posts big blind $1000
*** HOLE CARDS ***
Dealt to TurnOnTuneInDropOut [4h Qs Jc 3c]
slotmachine: folds
TurnOnTuneInDropOut: folds
prashantshah: calls $500
terminator369: raises $2000 to $3000
prashantshah: folds
Uncalled bet ($2000) returned to terminator369
terminator369 collected $2000 from pot
terminator369: doesn't show hand
*** SUMMARY ***
Total pot $2000 | Rake $0
Seat 1: terminator369 (big blind) collected ($2000)
Seat 3: slotmachine folded before Flop (didn't bet)
Seat 4: TurnOnTuneInDropOut (button) folded before Flop (didn't bet)
Seat 5: prashantshah (small blind) folded before Flop

PokerStars Hand #1957459674: Omaha Pot Limit ($500/$1000 USD) - 2020/10/23 14:39:03 ET
Table 'ADA540885739' 6-max Seat #5 is the button
Seat 1: terminator369 ($31000 in chips)
Seat 3: slotmachine ($173647 in chips)
Seat 4: TurnOnTuneInDropOut ($146150 in chips)
Seat 5: prashantshah ($41988 in chips)
terminator369: posts small blind $500
slotmachine: posts big blind $1000
*** HOLE CARDS ***
Dealt to TurnOnTuneInDropOut [9s 8s Jc Kd]
TurnOnTuneInDropOut: raises $2500 to $3500
prashantshah: folds
terminator369: folds
slotmachine: folds
Uncalled bet ($2500) returned to TurnOnTuneInDropOut
TurnOnTuneInDropOut collected $2500 from pot
TurnOnTuneInDropOut: doesn't show hand
*** SUMMARY ***
Total pot $2500 | Rake $0
Seat 1: terminator369 (small blind) folded before Flop
Seat 3: slotmachine (big blind) folded before Flop
Seat 4: TurnOnTuneInDropOut collected ($2500)
Seat 5: prashantshah (button) folded before Flop (didn't bet)

PokerStars Hand #1255059641: Omaha Pot Limit ($200/$400 USD) - 2020/10/23 12:24:37 ET
Table 'ADA675920511' 6-max Seat #4 is the button
Seat 1: PokerMessi ($57050 in chips)
Seat 2: TurnOnTuneInDropOut ($29400 in chips)
Seat 3: slotmachine ($54021 in chips)
Seat 4: rajan2017 ($9360 in chips)
Seat 6: soundfsilenz ($39186 in chips)
soundfsilenz: posts small blind $200
PokerMessi: posts big blind $400
*** HOLE CARDS ***
Dealt to TurnOnTuneInDropOut [Qs 5d Jd Ks]
TurnOnTuneInDropOut: raises $1000 to $1400
slotmachine: folds
rajan2017: raises $3400 to $4800
soundfsilenz: folds
PokerMessi: folds
TurnOnTuneInDropOut: raises $10200 to $15000
rajan2017: calls $4560 and is all-in
Uncalled bet ($5640) returned to TurnOnTuneInDropOut
*** FLOP *** [2d Kc 7s]
*** TURN *** [2d Kc 7s] [2h]
*** RIVER *** [2d Kc 7s 2h] [6s]
*** SHOW DOWN ***
TurnOnTuneInDropOut: shows [Qs 5d Jd Ks]
rajan2017: shows [Jc 9d Kd 7c]
rajan2017 collected $18545 from pot
*** SUMMARY ***
Total pot $19320 | Rake $775
Board [2d Kc 7s 2h 6s]
Seat 1: PokerMessi (big blind) folded before Flop
Seat 2: TurnOnTuneInDropOut showed [Qs 5d Jd Ks] and lost
Seat 3: slotmachine folded before Flop (didn't bet)
Seat 4: rajan2017 (button) showed [Jc 9d Kd 7c] and won ($18545)
Seat 6: soundfsilenz (small blind) folded before Flop

PokerStars Hand #1255059682: Omaha Pot Limit ($200/$400 USD) - 2020/10/23 13:24:34 ET
Table 'ADA675920511' 6-max Seat #1 is the button
Seat 1: harshb_95 ($13480 in chips)
Seat 2: vaibz16 ($22100 in chips)
Seat 4: TurnOnTuneInDropOut ($30000 in chips)
vaibz16: posts small blind $200
TurnOnTuneInDropOut: posts big blind $400
*** HOLE CARDS ***
Dealt to TurnOnTuneInDropOut [As Ts 8c Kh]
harshb_95: raises $1000 to $1400
vaibz16: folds
TurnOnTuneInDropOut: raises $3000 to $4400
harshb_95: calls $3000
*** FLOP *** [6c 7d Ad]
TurnOnTuneInDropOut: bets $9000
harshb_95: raises $80 to $9080 and is all-in
TurnOnTuneInDropOut: calls $80
*** TURN *** [6c 7d Ad] [Qc]
*** RIVER *** [6c 7d Ad Qc] [Qs]
*** SHOW DOWN ***
TurnOnTuneInDropOut: shows [As Ts 8c Kh]
harshb_95: shows [8d Jd Jc Kc]
TurnOnTuneInDropOut collected $26460 from pot
*** SUMMARY ***
Total pot $27160 | Rake $700
Board [6c 7d Ad Qc Qs]
Seat 1: harshb_95 (button) showed [8d Jd Jc Kc] and lost
Seat 2: vaibz16 (small blind) folded before Flop
Seat 4: TurnOnTuneInDropOut (big blind) showed [As Ts 8c Kh] and won ($26460)

PokerStars Hand #1255059688: Omaha Pot Limit ($200/$400 USD) - 2020/10/23 13:28:01 ET
Table 'ADA675920511' 6-max Seat #1 is the button
Seat 1: harshb_95 ($11400 in chips)
Seat 2: gaganhyd ($19824 in chips)
Seat 4: TurnOnTuneInDropOut ($42780 in chips)
Seat 5: kimjongun ($42600 in chips)
Seat 6: karanchawla09 ($28905 in chips)
gaganhyd: posts small blind $200
TurnOnTuneInDropOut: posts big blind $400
karanchawla09: posts big blind $400
*** HOLE CARDS ***
Dealt to TurnOnTuneInDropOut [7c 5c Td Th]
kimjongun: folds
karanchawla09: raises $1000 to $1400
harshb_95: calls $1400
gaganhyd: folds
TurnOnTuneInDropOut: folds
*** FLOP *** [8c 8h 6c]
karanchawla09: checks
harshb_95: bets $3400
karanchawla09: raises $10200 to $13600
harshb_95: calls $6600 and is all-in
Uncalled bet ($3600) returned to karanchawla09
*** TURN *** [8c 8h 6c] [2d]
*** RIVER *** [8c 8h 6c 2d] [2h]
*** SHOW DOWN ***
karanchawla09: shows [4c Jh 3c 6s]
harshb_95: shows [Kd 7d 8s Ts]
harshb_95 collected $22600 from pot
*** SUMMARY ***
Total pot $23400 | Rake $800
Board [8c 8h 6c 2d 2h]
Seat 1: harshb_95 (button) showed [Kd 7d 8s Ts] and won ($22600)
Seat 2: gaganhyd (small blind) folded before Flop
Seat 4: TurnOnTuneInDropOut (big blind) folded before Flop
Seat 5: kimjongun folded before Flop (didn't bet)
Seat 6: karanchawla09 showed [4c Jh 3c 6s] and lost

PokerStars Hand #1255059689: Omaha Pot Limit ($200/$400 USD) - 2020/10/23 13:28:25 ET
Table 'ADA675920511' 6-max Seat #2 is the button
Seat 1: harshb_95 ($22600 in chips)
Seat 2: gaganhyd ($19624 in chips)
Seat 4: TurnOnTuneInDropOut ($42380 in chips)
Seat 5: kimjongun ($42600 in chips)
Seat 6: karanchawla09 ($17505 in chips)
TurnOnTuneInDropOut: posts small blind $200
kimjongun: posts big blind $400
*** HOLE CARDS ***
Dealt to TurnOnTuneInDropOut [3c Th Ah 2h]
karanchawla09: raises $1000 to $1400
harshb_95: folds
gaganhyd: folds
TurnOnTuneInDropOut: folds
kimjongun: calls $1000
*** FLOP *** [5s Kc Kh]
kimjongun: checks
karanchawla09: checks
*** TURN *** [5s Kc Kh] [8s]
kimjongun: bets $1050
karanchawla09: calls $1050
*** RIVER *** [5s Kc Kh 8s] [2d]
kimjongun: bets $2550
karanchawla09: calls $2550
*** SHOW DOWN ***
kimjongun: mucks hand
karanchawla09: shows [4d 9d 9s As]
karanchawla09 collected $9791 from pot
*** SUMMARY ***
Total pot $10200 | Rake $409
Board [5s Kc Kh 8s 2d]
Seat 1: harshb_95 folded before Flop (didn't bet)
Seat 2: gaganhyd (button) folded before Flop (didn't bet)
Seat 4: TurnOnTuneInDropOut (small blind) folded before Flop
Seat 5: kimjongun (big blind) mucked
Seat 6: karanchawla09 showed [4d 9d 9s As] and won ($9791)

PokerStars Hand #1255059691: Omaha Pot Limit ($200/$400 USD) - 2020/10/23 13:30:15 ET
Table 'ADA675920511' 6-max Seat #5 is the button
Seat 1: harshb_95 ($21000 in chips)
Seat 2: gaganhyd ($19624 in chips)
Seat 4: TurnOnTuneInDropOut ($42180 in chips)
Seat 5: kimjongun ($60696 in chips)
harshb_95: posts small blind $200
gaganhyd: posts big blind $400
*** HOLE CARDS ***
Dealt to TurnOnTuneInDropOut [Ts Ah Kc Tc]
TurnOnTuneInDropOut: raises $1000 to $1400
kimjongun: folds
harshb_95: folds
gaganhyd: folds
Uncalled bet ($1000) returned to TurnOnTuneInDropOut
TurnOnTuneInDropOut collected $1000 from pot
TurnOnTuneInDropOut: doesn't show hand
*** SUMMARY ***
Total pot $1000 | Rake $0
Seat 1: harshb_95 (small blind) folded before Flop
Seat 2: gaganhyd (big blind) folded before Flop
Seat 4: TurnOnTuneInDropOut collected ($1000)
Seat 5: kimjongun (button) folded before Flop (didn't bet)

PokerStars Hand #1255059692: Omaha Pot Limit ($200/$400 USD) - 2020/10/23 13:30:30 ET
Table 'ADA675920511' 6-max Seat #1 is the button
Seat 1: harshb_95 ($20800 in chips)
Seat 2: gaganhyd ($19224 in chips)
Seat 4: TurnOnTuneInDropOut ($42780 in chips)
Seat 5: kimjongun ($60696 in chips)
gaganhyd: posts small blind $200
TurnOnTuneInDropOut: posts big blind $400
*** HOLE CARDS ***
Dealt to TurnOnTuneInDropOut [7c Kd Ah 6c]
kimjongun: folds
harshb_95: raises $650 to $1050
gaganhyd: folds
TurnOnTuneInDropOut: calls $650
*** FLOP *** [5h 3d Ts]
TurnOnTuneInDropOut: checks
harshb_95: bets $1725
TurnOnTuneInDropOut: raises $3882 to $5607
harshb_95: raises $13514 to $19121
TurnOnTuneInDropOut: folds
Uncalled bet ($13514) returned to harshb_95
harshb_95 collected $12972 from pot
harshb_95: doesn't show hand
*** SUMMARY ***
Total pot $13514 | Rake $542
Board [5h 3d Ts]
Seat 1: harshb_95 (button) collected ($12972)
Seat 2: gaganhyd (small blind) folded before Flop
Seat 4: TurnOnTuneInDropOut (big blind) folded on the Flop
Seat 5: kimjongun folded before Flop (didn't bet)

PokerStars Hand #1255059693: Omaha Pot Limit ($200/$400 USD) - 2020/10/23 13:30:59 ET
Table 'ADA675920511' 6-max Seat #2 is the button
Seat 1: harshb_95 ($27115 in chips)
Seat 2: gaganhyd ($19024 in chips)
Seat 4: TurnOnTuneInDropOut ($36123 in chips)
Seat 5: kimjongun ($60696 in chips)
TurnOnTuneInDropOut: posts small blind $200
kimjongun: posts big blind $400
*** HOLE CARDS ***
Dealt to TurnOnTuneInDropOut [9c Ah Kh Jc]
harshb_95: folds
gaganhyd: folds
TurnOnTuneInDropOut: raises $800 to $1200
kimjongun: calls $800
*** FLOP *** [8h 4c 7d]
TurnOnTuneInDropOut: checks
kimjongun: checks
*** TURN *** [8h 4c 7d] [Jd]
TurnOnTuneInDropOut: bets $2400
kimjongun: folds
Uncalled bet ($2400) returned to TurnOnTuneInDropOut
TurnOnTuneInDropOut collected $2304 from pot
TurnOnTuneInDropOut: doesn't show hand
*** SUMMARY ***
Total pot $2400 | Rake $96
Board [8h 4c 7d Jd]
Seat 1: harshb_95 folded before Flop (didn't bet)
Seat 2: gaganhyd (button) folded before Flop (didn't bet)
Seat 4: TurnOnTuneInDropOut (small blind) collected ($2304)
Seat 5: kimjongun (big blind) folded on the Turn

PokerStars Hand #1255059694: Omaha Pot Limit ($200/$400 USD) - 2020/10/23 13:31:50 ET
Table 'ADA675920511' 6-max Seat #4 is the button
Seat 1: harshb_95 ($27115 in chips)
Seat 2: gaganhyd ($19024 in chips)
Seat 4: TurnOnTuneInDropOut ($37227 in chips)
Seat 5: kimjongun ($59496 in chips)
kimjongun: posts small blind $200
harshb_95: posts big blind $400
*** HOLE CARDS ***
Dealt to TurnOnTuneInDropOut [Jd Th Qs 3h]
gaganhyd: raises $400 to $800
TurnOnTuneInDropOut: folds
kimjongun: folds
harshb_95: calls $400
*** FLOP *** [2s Jh Ts]
harshb_95: checks
gaganhyd: bets $900
harshb_95: folds
Uncalled bet ($900) returned to gaganhyd
gaganhyd collected $1728 from pot
gaganhyd: doesn't show hand
*** SUMMARY ***
Total pot $1800 | Rake $72
Board [2s Jh Ts]
Seat 1: harshb_95 (big blind) folded on the Flop
Seat 2: gaganhyd collected ($1728)
Seat 4: TurnOnTuneInDropOut (button) folded before Flop (didn't bet)
Seat 5: kimjongun (small blind) folded before Flop

PokerStars Hand #1255059695: Omaha Pot Limit ($200/$400 USD) - 2020/10/23 13:32:37 ET
Table 'ADA675920511' 6-max Seat #5 is the button
Seat 1: harshb_95 ($26315 in chips)
Seat 2: gaganhyd ($19952 in chips)
Seat 4: TurnOnTuneInDropOut ($37227 in chips)
Seat 5: kimjongun ($59296 in chips)
harshb_95: posts small blind $200
gaganhyd: posts big blind $400
*** HOLE CARDS ***
Dealt to TurnOnTuneInDropOut [6d 2h 6c 2d]
TurnOnTuneInDropOut: raises $1000 to $1400
kimjongun: calls $1400
harshb_95: folds
gaganhyd: folds
*** FLOP *** [5s 9h 8h]
TurnOnTuneInDropOut: checks
kimjongun: checks
*** TURN *** [5s 9h 8h] [Kd]
TurnOnTuneInDropOut: bets $3400
kimjongun: folds
Uncalled bet ($3400) returned to TurnOnTuneInDropOut
TurnOnTuneInDropOut collected $3264 from pot
TurnOnTuneInDropOut: doesn't show hand
*** SUMMARY ***
Total pot $3400 | Rake $136
Board [5s 9h 8h Kd]
Seat 1: harshb_95 (small blind) folded before Flop
Seat 2: gaganhyd (big blind) folded before Flop
Seat 4: TurnOnTuneInDropOut collected ($3264)
Seat 5: kimjongun (button) folded on the Turn

PokerStars Hand #1255059696: Omaha Pot Limit ($200/$400 USD) - 2020/10/23 13:33:19 ET
Table 'ADA675920511' 6-max Seat #1 is the button
Seat 1: harshb_95 ($26115 in chips)
Seat 2: gaganhyd ($19552 in chips)
Seat 4: TurnOnTuneInDropOut ($39091 in chips)
Seat 5: kimjongun ($57896 in chips)
gaganhyd: posts small blind $200
TurnOnTuneInDropOut: posts big blind $400
*** HOLE CARDS ***
Dealt to TurnOnTuneInDropOut [2c 3c 9d 2h]
kimjongun: folds
harshb_95: folds
gaganhyd: folds
Uncalled bet ($200) returned to TurnOnTuneInDropOut
TurnOnTuneInDropOut collected $400 from pot
TurnOnTuneInDropOut: doesn't show hand
*** SUMMARY ***
Total pot $400 | Rake $0
Seat 1: harshb_95 (button) folded before Flop (didn't bet)
Seat 2: gaganhyd (small blind) folded before Flop
Seat 4: TurnOnTuneInDropOut (big blind) collected ($400)
Seat 5: kimjongun folded before Flop (didn't bet)

PokerStars Hand #1255059697: Omaha Pot Limit ($200/$400 USD) - 2020/10/23 13:33:59 ET
Table 'ADA675920511' 6-max Seat #2 is the button
Seat 1: harshb_95 ($26115 in chips)
Seat 2: gaganhyd ($19352 in chips)
Seat 4: TurnOnTuneInDropOut ($39291 in chips)
Seat 5: kimjongun ($57896 in chips)
TurnOnTuneInDropOut: posts small blind $200
kimjongun: posts big blind $400
*** HOLE CARDS ***
Dealt to TurnOnTuneInDropOut [4h Ks 3c 3d]
harshb_95: raises $1000 to $1400
gaganhyd: folds
TurnOnTuneInDropOut: folds
kimjongun: calls $1000
*** FLOP *** [8d 7h 2s]
kimjongun: bets $2250
harshb_95: raises $2250 to $4500
kimjongun: calls $2250
*** TURN *** [8d 7h 2s] [3s]
kimjongun: checks
harshb_95: bets $12000
kimjongun: raises $12000 to $24000
harshb_95: calls $8215 and is all-in
Uncalled bet ($3785) returned to kimjongun
*** RIVER *** [8d 7h 2s 3s] [Kc]
*** SHOW DOWN ***
kimjongun: shows [7d Qd Td Ts]
harshb_95: shows [Th 7c 7s 9h]
harshb_95 collected $51630 from pot
*** SUMMARY ***
Total pot $52430 | Rake $800
Board [8d 7h 2s 3s Kc]
Seat 1: harshb_95 showed [Th 7c 7s 9h] and won ($51630)
Seat 2: gaganhyd (button) folded before Flop (didn't bet)
Seat 4: TurnOnTuneInDropOut (small blind) folded before Flop
Seat 5: kimjongun (big blind) showed [7d Qd Td Ts] and lost

PokerStars Hand #1255059699: Omaha Pot Limit ($200/$400 USD) - 2020/10/23 13:35:36 ET
Table 'ADA675920511' 6-max Seat #5 is the button
Seat 1: harshb_95 ($51630 in chips)
Seat 2: gaganhyd ($19352 in chips)
Seat 4: TurnOnTuneInDropOut ($37691 in chips)
Seat 5: kimjongun ($31581 in chips)
Seat 6: Sam565 ($13600 in chips)
Sam565: posts small blind $200
harshb_95: posts big blind $400
*** HOLE CARDS ***
Dealt to TurnOnTuneInDropOut [7s Tc 7c 3s]
gaganhyd: folds
TurnOnTuneInDropOut: raises $1000 to $1400
kimjongun: calls $1400
Sam565: calls $1200
harshb_95: folds
*** FLOP *** [Ah 2h 5c]
Sam565: bets $4600
TurnOnTuneInDropOut: folds
kimjongun: folds
Uncalled bet ($4600) returned to Sam565
Sam565 collected $4416 from pot
Sam565: doesn't show hand
*** SUMMARY ***
Total pot $4600 | Rake $184
Board [Ah 2h 5c]
Seat 1: harshb_95 (big blind) folded before Flop
Seat 2: gaganhyd folded before Flop (didn't bet)
Seat 4: TurnOnTuneInDropOut folded on the Flop
Seat 5: kimjongun (button) folded on the Flop
Seat 6: Sam565 (small blind) collected ($4416)

PokerStars Hand #1255059700: Omaha Pot Limit ($200/$400 USD) - 2020/10/23 13:36:15 ET
Table 'ADA675920511' 6-max Seat #6 is the button
Seat 1: harshb_95 ($51230 in chips)
Seat 2: gaganhyd ($19352 in chips)
Seat 4: TurnOnTuneInDropOut ($48000 in chips)
Seat 5: kimjongun ($30181 in chips)
Seat 6: Sam565 ($16616 in chips)
harshb_95: posts small blind $200
gaganhyd: posts big blind $400
*** HOLE CARDS ***
Dealt to TurnOnTuneInDropOut [6c 5c 8d 9s]
TurnOnTuneInDropOut: folds
kimjongun: folds
Sam565: folds
harshb_95: folds
Uncalled bet ($200) returned to gaganhyd
gaganhyd collected $400 from pot
gaganhyd: doesn't show hand
*** SUMMARY ***
Total pot $400 | Rake $0
Seat 1: harshb_95 (small blind) folded before Flop
Seat 2: gaganhyd (big blind) collected ($400)
Seat 4: TurnOnTuneInDropOut folded before Flop (didn't bet)
Seat 5: kimjongun folded before Flop (didn't bet)
Seat 6: Sam565 (button) folded before Flop (didn't bet)

PokerStars Hand #1255059701: Omaha Pot Limit ($200/$400 USD) - 2020/10/23 13:36:29 ET
Table 'ADA675920511' 6-max Seat #1 is the button
Seat 1: harshb_95 ($51030 in chips)
Seat 2: gaganhyd ($19552 in chips)
Seat 3: slotmachine ($28231 in chips)
Seat 4: TurnOnTuneInDropOut ($48000 in chips)
Seat 5: kimjongun ($30181 in chips)
Seat 6: Sam565 ($16616 in chips)
gaganhyd: posts small blind $200
slotmachine: posts big blind $400
*** HOLE CARDS ***
Dealt to TurnOnTuneInDropOut [Jd 6d 2c 6h]
TurnOnTuneInDropOut: folds
kimjongun: folds
Sam565: folds
harshb_95: folds
gaganhyd: raises $800 to $1200
slotmachine: calls $800
*** FLOP *** [7c 5d 5s]
gaganhyd: checks
slotmachine: checks
*** TURN *** [7c 5d 5s] [5h]
gaganhyd: bets $1200
slotmachine: folds
Uncalled bet ($1200) returned to gaganhyd
gaganhyd collected $2304 from pot
gaganhyd: doesn't show hand
*** SUMMARY ***
Total pot $2400 | Rake $96
Board [7c 5d 5s 5h]
Seat 1: harshb_95 (button) folded before Flop (didn't bet)
Seat 2: gaganhyd (small blind) collected ($2304)
Seat 3: slotmachine (big blind) folded on the Turn
Seat 4: TurnOnTuneInDropOut folded before Flop (didn't bet)
Seat 5: kimjongun folded before Flop (didn't bet)
Seat 6: Sam565 folded before Flop (didn't bet)

PokerStars Hand #1255059704: Omaha Pot Limit ($200/$400 USD) - 2020/10/23 13:39:08 ET
Table 'ADA675920511' 6-max Seat #4 is the button
Seat 1: harshb_95 ($51590 in chips)
Seat 2: gaganhyd ($20656 in chips)
Seat 3: slotmachine ($48000 in chips)
Seat 4: TurnOnTuneInDropOut ($46740 in chips)
Seat 5: kimjongun ($29781 in chips)
Seat 6: Sam565 ($17783 in chips)
kimjongun: posts small blind $200
Sam565: posts big blind $400
*** HOLE CARDS ***
Dealt to TurnOnTuneInDropOut [Jh Ts Qs Td]
harshb_95: folds
gaganhyd: folds
slotmachine: folds
TurnOnTuneInDropOut: raises $1000 to $1400
kimjongun: folds
Sam565: folds
Uncalled bet ($1000) returned to TurnOnTuneInDropOut
TurnOnTuneInDropOut collected $1000 from pot
TurnOnTuneInDropOut: doesn't show hand
*** SUMMARY ***
Total pot $1000 | Rake $0
Seat 1: harshb_95 folded before Flop (didn't bet)
Seat 2: gaganhyd folded before Flop (didn't bet)
Seat 3: slotmachine folded before Flop (didn't bet)
Seat 4: TurnOnTuneInDropOut (button) collected ($1000)
Seat 5: kimjongun (small blind) folded before Flop
Seat 6: Sam565 (big blind) folded before Flop

PokerStars Hand #1255059705: Omaha Pot Limit ($200/$400 USD) - 2020/10/23 13:39:27 ET
Table 'ADA675920511' 6-max Seat #5 is the button
Seat 1: harshb_95 ($51590 in chips)
Seat 2: gaganhyd ($20656 in chips)
Seat 3: slotmachine ($48000 in chips)
Seat 4: TurnOnTuneInDropOut ($47340 in chips)
Seat 5: kimjongun ($29581 in chips)
Seat 6: Sam565 ($17383 in chips)
Sam565: posts small blind $200
harshb_95: posts big blind $400
*** HOLE CARDS ***
Dealt to TurnOnTuneInDropOut [Tc 7d Ts 3d]
gaganhyd: folds
slotmachine: folds
TurnOnTuneInDropOut: folds
kimjongun: folds
Sam565: calls $200
harshb_95: raises $600 to $1000
Sam565: calls $600
*** FLOP *** [8c 4s 2s]
Sam565: checks
harshb_95: bets $1000
Sam565: calls $1000
*** TURN *** [8c 4s 2s] [5s]
Sam565: checks
harshb_95: checks
*** RIVER *** [8c 4s 2s 5s] [2d]
Sam565: checks
harshb_95: checks
*** SHOW DOWN ***
Sam565: shows [6s 5h 8d Qh]
harshb_95: shows [Qc Th 7c Js]
Sam565 collected $3840 from pot
*** SUMMARY ***
Total pot $4000 | Rake $160
Board [8c 4s 2s 5s 2d]
Seat 1: harshb_95 (big blind) showed [Qc Th 7c Js] and lost
Seat 2: gaganhyd folded before Flop (didn't bet)
Seat 3: slotmachine folded before Flop (didn't bet)
Seat 4: TurnOnTuneInDropOut folded before Flop (didn't bet)
Seat 5: kimjongun (button) folded before Flop (didn't bet)
Seat 6: Sam565 (small blind) showed [6s 5h 8d Qh] and won ($3840)

PokerStars Hand #1255059706: Omaha Pot Limit ($200/$400 USD) - 2020/10/23 13:40:21 ET
Table 'ADA675920511' 6-max Seat #6 is the button
Seat 1: harshb_95 ($49590 in chips)
Seat 2: gaganhyd ($20656 in chips)
Seat 3: slotmachine ($48000 in chips)
Seat 4: TurnOnTuneInDropOut ($47340 in chips)
Seat 5: kimjongun ($29581 in chips)
Seat 6: Sam565 ($19223 in chips)
harshb_95: posts small blind $200
gaganhyd: posts big blind $400
*** HOLE CARDS ***
Dealt to TurnOnTuneInDropOut [Th 8c 3c Tc]
slotmachine: folds
TurnOnTuneInDropOut: folds
kimjongun: folds
Sam565: folds
harshb_95: folds
Uncalled bet ($200) returned to gaganhyd
gaganhyd collected $400 from pot
gaganhyd: doesn't show hand
*** SUMMARY ***
Total pot $400 | Rake $0
Seat 1: harshb_95 (small blind) folded before Flop
Seat 2: gaganhyd (big blind) collected ($400)
Seat 3: slotmachine folded before Flop (didn't bet)
Seat 4: TurnOnTuneInDropOut folded before Flop (didn't bet)
Seat 5: kimjongun folded before Flop (didn't bet)
Seat 6: Sam565 (button) folded before Flop (didn't bet)

PokerStars Hand #1255059707: Omaha Pot Limit ($200/$400 USD) - 2020/10/23 13:40:52 ET
Table 'ADA675920511' 6-max Seat #2 is the button
Seat 2: gaganhyd ($20856 in chips)
Seat 3: slotmachine ($48000 in chips)
Seat 4: TurnOnTuneInDropOut ($47340 in chips)
Seat 5: kimjongun ($29581 in chips)
Seat 6: Sam565 ($19223 in chips)
slotmachine: posts small blind $200
TurnOnTuneInDropOut: posts big blind $400
*** HOLE CARDS ***
Dealt to TurnOnTuneInDropOut [Jc Js 7h 7d]
kimjongun: folds
Sam565: folds
gaganhyd: folds
slotmachine: folds
Uncalled bet ($200) returned to TurnOnTuneInDropOut
TurnOnTuneInDropOut collected $400 from pot
TurnOnTuneInDropOut: doesn't show hand
*** SUMMARY ***
Total pot $400 | Rake $0
Seat 2: gaganhyd (button) folded before Flop (didn't bet)
Seat 3: slotmachine (small blind) folded before Flop
Seat 4: TurnOnTuneInDropOut (big blind) collected ($400)
Seat 5: kimjongun folded before Flop (didn't bet)
Seat 6: Sam565 folded before Flop (didn't bet)

PokerStars Hand #1255059709: Omaha Pot Limit ($200/$400 USD) - 2020/10/23 13:42:22 ET
Table 'ADA675920511' 6-max Seat #4 is the button
Seat 2: gaganhyd ($20856 in chips)
Seat 3: slotmachine ($47800 in chips)
Seat 4: TurnOnTuneInDropOut ($47340 in chips)
Seat 5: kimjongun ($24581 in chips)
Seat 6: Sam565 ($24014 in chips)
kimjongun: posts small blind $200
Sam565: posts big blind $400
*** HOLE CARDS ***
Dealt to TurnOnTuneInDropOut [Jh Qc Qs 4d]
gaganhyd: folds
slotmachine: raises $1000 to $1400
TurnOnTuneInDropOut: folds
kimjongun: folds
Sam565: folds
Uncalled bet ($1000) returned to slotmachine
slotmachine collected $1000 from pot
slotmachine: doesn't show hand
*** SUMMARY ***
Total pot $1000 | Rake $0
Seat 2: gaganhyd folded before Flop (didn't bet)
Seat 3: slotmachine collected ($1000)
Seat 4: TurnOnTuneInDropOut (button) folded before Flop (didn't bet)
Seat 5: kimjongun (small blind) folded before Flop
Seat 6: Sam565 (big blind) folded before Flop

PokerStars Hand #1255059710: Omaha Pot Limit ($200/$400 USD) - 2020/10/23 13:42:39 ET
Table 'ADA675920511' 6-max Seat #5 is the button
Seat 2: gaganhyd ($20856 in chips)
Seat 3: slotmachine ($48400 in chips)
Seat 4: TurnOnTuneInDropOut ($47340 in chips)
Seat 5: kimjongun ($24381 in chips)
Seat 6: Sam565 ($23614 in chips)
Sam565: posts small blind $200
gaganhyd: posts big blind $400
*** HOLE CARDS ***
Dealt to TurnOnTuneInDropOut [2h 8d Js 5s]
slotmachine: folds
TurnOnTuneInDropOut: folds
kimjongun: folds
Sam565: calls $200
gaganhyd: raises $800 to $1200
Sam565: calls $800
*** FLOP *** [2d Ad Kh]
Sam565: checks
gaganhyd: bets $1200
Sam565: calls $1200
*** TURN *** [2d Ad Kh] [3h]
Sam565: checks
gaganhyd: bets $4800
Sam565: folds
Uncalled bet ($4800) returned to gaganhyd
gaganhyd collected $4608 from pot
gaganhyd: doesn't show hand
*** SUMMARY ***
Total pot $4800 | Rake $192
Board [2d Ad Kh 3h]
Seat 2: gaganhyd (big blind) collected ($4608)
Seat 3: slotmachine folded before Flop (didn't bet)
Seat 4: TurnOnTuneInDropOut folded before Flop (didn't bet)
Seat 5: kimjongun (button) folded before Flop (didn't bet)
Seat 6: Sam565 (small blind) folded on the Turn

PokerStars Hand #1255059711: Omaha Pot Limit ($200/$400 USD) - 2020/10/23 13:43:23 ET
Table 'ADA675920511' 6-max Seat #6 is the button
Seat 2: gaganhyd ($23064 in chips)
Seat 3: slotmachine ($48400 in chips)
Seat 4: TurnOnTuneInDropOut ($47340 in chips)
Seat 5: kimjongun ($24381 in chips)
Seat 6: Sam565 ($21214 in chips)
gaganhyd: posts small blind $200
slotmachine: posts big blind $400
*** HOLE CARDS ***
Dealt to TurnOnTuneInDropOut [Kc 8h Ad 4s]
TurnOnTuneInDropOut: folds
kimjongun: folds
Sam565: folds
gaganhyd: folds
Uncalled bet ($200) returned to slotmachine
slotmachine collected $400 from pot
slotmachine: doesn't show hand
*** SUMMARY ***
Total pot $400 | Rake $0
Seat 2: gaganhyd (small blind) folded before Flop
Seat 3: slotmachine (big blind) collected ($400)
Seat 4: TurnOnTuneInDropOut folded before Flop (didn't bet)
Seat 5: kimjongun folded before Flop (didn't bet)
Seat 6: Sam565 (button) folded before Flop (didn't bet)

PokerStars Hand #1255059712: Omaha Pot Limit ($200/$400 USD) - 2020/10/23 13:43:39 ET
Table 'ADA675920511' 6-max Seat #2 is the button
Seat 2: gaganhyd ($22864 in chips)
Seat 3: slotmachine ($48600 in chips)
Seat 4: TurnOnTuneInDropOut ($47340 in chips)
Seat 5: kimjongun ($24381 in chips)
Seat 6: Sam565 ($21214 in chips)
slotmachine: posts small blind $200
TurnOnTuneInDropOut: posts big blind $400
*** HOLE CARDS ***
Dealt to TurnOnTuneInDropOut [9s Kd 5d Ts]
kimjongun: raises $600 to $1000
Sam565: folds
gaganhyd: folds
slotmachine: raises $2400 to $3400
TurnOnTuneInDropOut: folds
kimjongun: calls $2400
*** FLOP *** [Ac 4h 8s]
slotmachine: bets $3600
kimjongun: folds
Uncalled bet ($3600) returned to slotmachine
slotmachine collected $6911 from pot
slotmachine: doesn't show hand
*** SUMMARY ***
Total pot $7200 | Rake $289
Board [Ac 4h 8s]
Seat 2: gaganhyd (button) folded before Flop (didn't bet)
Seat 3: slotmachine (small blind) collected ($6911)
Seat 4: TurnOnTuneInDropOut (big blind) folded before Flop
Seat 5: kimjongun folded on the Flop
Seat 6: Sam565 folded before Flop (didn't bet)

PokerStars Hand #1255059714: Omaha Pot Limit ($200/$400 USD) - 2020/10/23 13:45:02 ET
Table 'ADA675920511' 6-max Seat #4 is the button
Seat 2: gaganhyd ($22864 in chips)
Seat 3: slotmachine ($52111 in chips)
Seat 4: TurnOnTuneInDropOut ($46740 in chips)
Seat 5: kimjongun ($21081 in chips)
Seat 6: Sam565 ($21314 in chips)
kimjongun: posts small blind $200
Sam565: posts big blind $400
*** HOLE CARDS ***
Dealt to TurnOnTuneInDropOut [2s Qs 3h Ad]
gaganhyd: raises $650 to $1050
slotmachine: folds
TurnOnTuneInDropOut: folds
kimjongun: folds
Sam565: calls $650
*** FLOP *** [Kh 3c 6s]
Sam565: checks
gaganhyd: bets $1150
Sam565: folds
Uncalled bet ($1150) returned to gaganhyd
gaganhyd collected $2208 from pot
gaganhyd: doesn't show hand
*** SUMMARY ***
Total pot $2300 | Rake $92
Board [Kh 3c 6s]
Seat 2: gaganhyd collected ($2208)
Seat 3: slotmachine folded before Flop (didn't bet)
Seat 4: TurnOnTuneInDropOut (button) folded before Flop (didn't bet)
Seat 5: kimjongun (small blind) folded before Flop
Seat 6: Sam565 (big blind) folded on the Flop

PokerStars Hand #1255059715: Omaha Pot Limit ($200/$400 USD) - 2020/10/23 13:45:32 ET
Table 'ADA675920511' 6-max Seat #5 is the button
Seat 2: gaganhyd ($24022 in chips)
Seat 3: slotmachine ($52111 in chips)
Seat 4: TurnOnTuneInDropOut ($46740 in chips)
Seat 5: kimjongun ($20881 in chips)
Seat 6: Sam565 ($20264 in chips)
Sam565: posts small blind $200
gaganhyd: posts big blind $400
*** HOLE CARDS ***
Dealt to TurnOnTuneInDropOut [Ad Ah Kh 5h]
slotmachine: folds
TurnOnTuneInDropOut: raises $1000 to $1400
kimjongun: folds
Sam565: folds
gaganhyd: folds
Uncalled bet ($1000) returned to TurnOnTuneInDropOut
TurnOnTuneInDropOut collected $1000 from pot
TurnOnTuneInDropOut: doesn't show hand
*** SUMMARY ***
Total pot $1000 | Rake $0
Seat 2: gaganhyd (big blind) folded before Flop
Seat 3: slotmachine folded before Flop (didn't bet)
Seat 4: TurnOnTuneInDropOut collected ($1000)
Seat 5: kimjongun (button) folded before Flop (didn't bet)
Seat 6: Sam565 (small blind) folded before Flop

PokerStars Hand #1255059716: Omaha Pot Limit ($200/$400 USD) - 2020/10/23 13:46:24 ET
Table 'ADA675920511' 6-max Seat #6 is the button
Seat 2: gaganhyd ($23622 in chips)
Seat 3: slotmachine ($52111 in chips)
Seat 4: TurnOnTuneInDropOut ($47340 in chips)
Seat 5: kimjongun ($20881 in chips)
Seat 6: Sam565 ($20064 in chips)
gaganhyd: posts small blind $200
slotmachine: posts big blind $400
*** HOLE CARDS ***
Dealt to TurnOnTuneInDropOut [3d 9d 6c Qc]
TurnOnTuneInDropOut: folds
kimjongun: folds
Sam565: calls $400
gaganhyd: folds
slotmachine: checks
*** FLOP *** [Jh 9h 5s]
slotmachine: checks
Sam565: bets $1000
slotmachine: folds
Uncalled bet ($1000) returned to Sam565
Sam565 collected $960 from pot
Sam565: doesn't show hand
*** SUMMARY ***
Total pot $1000 | Rake $40
Board [Jh 9h 5s]
Seat 2: gaganhyd (small blind) folded before Flop
Seat 3: slotmachine (big blind) folded on the Flop
Seat 4: TurnOnTuneInDropOut folded before Flop (didn't bet)
Seat 5: kimjongun folded before Flop (didn't bet)
Seat 6: Sam565 (button) collected ($960)

PokerStars Hand #1255059717: Omaha Pot Limit ($200/$400 USD) - 2020/10/23 13:46:54 ET
Table 'ADA675920511' 6-max Seat #2 is the button
Seat 2: gaganhyd ($23422 in chips)
Seat 3: slotmachine ($51711 in chips)
Seat 4: TurnOnTuneInDropOut ($47340 in chips)
Seat 5: kimjongun ($20881 in chips)
Seat 6: Sam565 ($20624 in chips)
slotmachine: posts small blind $200
TurnOnTuneInDropOut: posts big blind $400
*** HOLE CARDS ***
Dealt to TurnOnTuneInDropOut [Kd Ac 5s 7h]
kimjongun: folds
Sam565: folds
gaganhyd: folds
slotmachine: raises $800 to $1200
TurnOnTuneInDropOut: folds
Uncalled bet ($800) returned to slotmachine
slotmachine collected $800 from pot
slotmachine: doesn't show hand
*** SUMMARY ***
Total pot $800 | Rake $0
Seat 2: gaganhyd (button) folded before Flop (didn't bet)
Seat 3: slotmachine (small blind) collected ($800)
Seat 4: TurnOnTuneInDropOut (big blind) folded before Flop
Seat 5: kimjongun folded before Flop (didn't bet)
Seat 6: Sam565 folded before Flop (didn't bet)

PokerStars Hand #1255059718: Omaha Pot Limit ($200/$400 USD) - 2020/10/23 13:47:10 ET
Table 'ADA675920511' 6-max Seat #3 is the button
Seat 2: gaganhyd ($23422 in chips)
Seat 3: slotmachine ($52111 in chips)
Seat 4: TurnOnTuneInDropOut ($46940 in chips)
Seat 5: kimjongun ($26097 in chips)
Seat 6: Sam565 ($20624 in chips)
TurnOnTuneInDropOut: posts small blind $200
kimjongun: posts big blind $400
*** HOLE CARDS ***
Dealt to TurnOnTuneInDropOut [Jh Td 9d Jc]
Sam565: folds
gaganhyd: folds
slotmachine: raises $1000 to $1400
TurnOnTuneInDropOut: calls $1200
kimjongun: folds
*** FLOP *** [6d 3c Ts]
TurnOnTuneInDropOut: checks
slotmachine: bets $3200
TurnOnTuneInDropOut: calls $3200
*** TURN *** [6d 3c Ts] [9s]
TurnOnTuneInDropOut: checks
slotmachine: checks
*** RIVER *** [6d 3c Ts 9s] [4h]
TurnOnTuneInDropOut: bets $3936
slotmachine: raises $6768 to $10704
TurnOnTuneInDropOut: raises $31008 to $41712
slotmachine: folds
Uncalled bet ($31008) returned to TurnOnTuneInDropOut
TurnOnTuneInDropOut collected $30208 from pot
TurnOnTuneInDropOut: doesn't show hand
*** SUMMARY ***
Total pot $31008 | Rake $800
Board [6d 3c Ts 9s 4h]
Seat 2: gaganhyd folded before Flop (didn't bet)
Seat 3: slotmachine (button) folded on the River
Seat 4: TurnOnTuneInDropOut (small blind) collected ($30208)
Seat 5: kimjongun (big blind) folded before Flop
Seat 6: Sam565 folded before Flop (didn't bet)

PokerStars Hand #1255059719: Omaha Pot Limit ($200/$400 USD) - 2020/10/23 13:48:33 ET
Table 'ADA675920511' 6-max Seat #4 is the button
Seat 1: soundfsilenz ($42000 in chips)
Seat 2: gaganhyd ($23422 in chips)
Seat 3: slotmachine ($48000 in chips)
Seat 4: TurnOnTuneInDropOut ($61844 in chips)
Seat 5: kimjongun ($25697 in chips)
kimjongun: posts small blind $200
soundfsilenz: posts big blind $400
*** HOLE CARDS ***
Dealt to TurnOnTuneInDropOut [Ts Ac 7d Td]
gaganhyd: raises $650 to $1050
slotmachine: folds
TurnOnTuneInDropOut: folds
kimjongun: folds
soundfsilenz: folds
Uncalled bet ($650) returned to gaganhyd
gaganhyd collected $1000 from pot
gaganhyd: doesn't show hand
*** SUMMARY ***
Total pot $1000 | Rake $0
Seat 1: soundfsilenz (big blind) folded before Flop
Seat 2: gaganhyd collected ($1000)
Seat 3: slotmachine folded before Flop (didn't bet)
Seat 4: TurnOnTuneInDropOut (button) folded before Flop (didn't bet)
Seat 5: kimjongun (small blind) folded before Flop

PokerStars Hand #1255059720: Omaha Pot Limit ($200/$400 USD) - 2020/10/23 13:48:57 ET
Table 'ADA675920511' 6-max Seat #5 is the button
Seat 1: soundfsilenz ($41600 in chips)
Seat 2: gaganhyd ($24022 in chips)
Seat 3: slotmachine ($48000 in chips)
Seat 4: TurnOnTuneInDropOut ($61844 in chips)
Seat 5: kimjongun ($25497 in chips)
soundfsilenz: posts small blind $200
gaganhyd: posts big blind $400
*** HOLE CARDS ***
Dealt to TurnOnTuneInDropOut [8d Ts 8h Ad]
slotmachine: folds
TurnOnTuneInDropOut: raises $1000 to $1400
kimjongun: folds
soundfsilenz: folds
gaganhyd: folds
Uncalled bet ($1000) returned to TurnOnTuneInDropOut
TurnOnTuneInDropOut collected $1000 from pot
TurnOnTuneInDropOut: doesn't show hand
*** SUMMARY ***
Total pot $1000 | Rake $0
Seat 1: soundfsilenz (small blind) folded before Flop
Seat 2: gaganhyd (big blind) folded before Flop
Seat 3: slotmachine folded before Flop (didn't bet)
Seat 4: TurnOnTuneInDropOut collected ($1000)
Seat 5: kimjongun (button) folded before Flop (didn't bet)

PokerStars Hand #1255059721: Omaha Pot Limit ($200/$400 USD) - 2020/10/23 13:49:21 ET
Table 'ADA675920511' 6-max Seat #1 is the button
Seat 1: soundfsilenz ($41400 in chips)
Seat 2: gaganhyd ($23622 in chips)
Seat 3: slotmachine ($48000 in chips)
Seat 4: TurnOnTuneInDropOut ($62444 in chips)
Seat 5: kimjongun ($25497 in chips)
gaganhyd: posts small blind $200
slotmachine: posts big blind $400
*** HOLE CARDS ***
Dealt to TurnOnTuneInDropOut [8c 7h 2h 3d]
TurnOnTuneInDropOut: folds
kimjongun: folds
soundfsilenz: raises $1000 to $1400
gaganhyd: folds
slotmachine: folds
Uncalled bet ($1000) returned to soundfsilenz
soundfsilenz collected $1000 from pot
soundfsilenz: doesn't show hand
*** SUMMARY ***
Total pot $1000 | Rake $0
Seat 1: soundfsilenz (button) collected ($1000)
Seat 2: gaganhyd (small blind) folded before Flop
Seat 3: slotmachine (big blind) folded before Flop
Seat 4: TurnOnTuneInDropOut folded before Flop (didn't bet)
Seat 5: kimjongun folded before Flop (didn't bet)

PokerStars Hand #1255059722: Omaha Pot Limit ($200/$400 USD) - 2020/10/23 13:49:45 ET
Table 'ADA675920511' 6-max Seat #2 is the button
Seat 1: soundfsilenz ($42000 in chips)
Seat 2: gaganhyd ($23422 in chips)
Seat 3: slotmachine ($47600 in chips)
Seat 4: TurnOnTuneInDropOut ($62444 in chips)
Seat 5: kimjongun ($25497 in chips)
slotmachine: posts small blind $200
TurnOnTuneInDropOut: posts big blind $400
*** HOLE CARDS ***
Dealt to TurnOnTuneInDropOut [6d Qh 2s Tc]
kimjongun: raises $600 to $1000
soundfsilenz: folds
gaganhyd: calls $1000
slotmachine: folds
TurnOnTuneInDropOut: folds
*** FLOP *** [Ts 8h 4d]
kimjongun: checks
gaganhyd: bets $1300
kimjongun: calls $1300
*** TURN *** [Ts 8h 4d] [4s]
kimjongun: checks
gaganhyd: checks
*** RIVER *** [Ts 8h 4d 4s] [5d]
kimjongun: bets $2600
gaganhyd: folds
Uncalled bet ($2600) returned to kimjongun
kimjongun collected $4991 from pot
kimjongun: doesn't show hand
*** SUMMARY ***
Total pot $5200 | Rake $209
Board [Ts 8h 4d 4s 5d]
Seat 1: soundfsilenz folded before Flop (didn't bet)
Seat 2: gaganhyd (button) folded on the River
Seat 3: slotmachine (small blind) folded before Flop
Seat 4: TurnOnTuneInDropOut (big blind) folded before Flop
Seat 5: kimjongun collected ($4991)

PokerStars Hand #1255059724: Omaha Pot Limit ($200/$400 USD) - 2020/10/23 13:51:26 ET
Table 'ADA675920511' 6-max Seat #4 is the button
Seat 1: soundfsilenz ($42000 in chips)
Seat 2: gaganhyd ($21122 in chips)
Seat 3: slotmachine ($45600 in chips)
Seat 4: TurnOnTuneInDropOut ($61844 in chips)
Seat 5: kimjongun ($27788 in chips)
Seat 6: vikram2013 ($14620 in chips)
kimjongun: posts small blind $200
vikram2013: posts big blind $400
*** HOLE CARDS ***
Dealt to TurnOnTuneInDropOut [2d Jh 7s 8d]
soundfsilenz: raises $1000 to $1400
gaganhyd: calls $1400
slotmachine: folds
TurnOnTuneInDropOut: folds
kimjongun: folds
vikram2013: folds
*** FLOP *** [3s Qs 5s]
soundfsilenz: checks
gaganhyd: checks
*** TURN *** [3s Qs 5s] [9d]
soundfsilenz: checks
gaganhyd: checks
*** RIVER *** [3s Qs 5s 9d] [Kh]
soundfsilenz: checks
gaganhyd: bets $2550
soundfsilenz: folds
Uncalled bet ($2550) returned to gaganhyd
gaganhyd collected $3264 from pot
gaganhyd: doesn't show hand
*** SUMMARY ***
Total pot $3400 | Rake $136
Board [3s Qs 5s 9d Kh]
Seat 1: soundfsilenz folded on the River
Seat 2: gaganhyd collected ($3264)
Seat 3: slotmachine folded before Flop (didn't bet)
Seat 4: TurnOnTuneInDropOut (button) folded before Flop (didn't bet)
Seat 5: kimjongun (small blind) folded before Flop
Seat 6: vikram2013 (big blind) folded before Flop

PokerStars Hand #1255059725: Omaha Pot Limit ($200/$400 USD) - 2020/10/23 13:52:25 ET
Table 'ADA675920511' 6-max Seat #5 is the button
Seat 1: soundfsilenz ($40600 in chips)
Seat 2: gaganhyd ($22986 in chips)
Seat 3: slotmachine ($45600 in chips)
Seat 4: TurnOnTuneInDropOut ($61844 in chips)
Seat 5: kimjongun ($27588 in chips)
Seat 6: vikram2013 ($14220 in chips)
vikram2013: posts small blind $200
soundfsilenz: posts big blind $400
*** HOLE CARDS ***
Dealt to TurnOnTuneInDropOut [6h 3d 3s 8c]
gaganhyd: folds
slotmachine: folds
TurnOnTuneInDropOut: folds
kimjongun: folds
vikram2013: raises $800 to $1200
soundfsilenz: folds
Uncalled bet ($800) returned to vikram2013
vikram2013 collected $800 from pot
vikram2013: doesn't show hand
*** SUMMARY ***
Total pot $800 | Rake $0
Seat 1: soundfsilenz (big blind) folded before Flop
Seat 2: gaganhyd folded before Flop (didn't bet)
Seat 3: slotmachine folded before Flop (didn't bet)
Seat 4: TurnOnTuneInDropOut folded before Flop (didn't bet)
Seat 5: kimjongun (button) folded before Flop (didn't bet)
Seat 6: vikram2013 (small blind) collected ($800)

PokerStars Hand #1255059726: Omaha Pot Limit ($200/$400 USD) - 2020/10/23 13:53:10 ET
Table 'ADA675920511' 6-max Seat #6 is the button
Seat 1: soundfsilenz ($40200 in chips)
Seat 2: gaganhyd ($22986 in chips)
Seat 3: slotmachine ($45600 in chips)
Seat 4: TurnOnTuneInDropOut ($61844 in chips)
Seat 5: kimjongun ($27588 in chips)
Seat 6: vikram2013 ($14620 in chips)
soundfsilenz: posts small blind $200
gaganhyd: posts big blind $400
*** HOLE CARDS ***
Dealt to TurnOnTuneInDropOut [4d Ah Td Qh]
slotmachine: raises $1000 to $1400
TurnOnTuneInDropOut: calls $1400
kimjongun: folds
vikram2013: folds
soundfsilenz: folds
gaganhyd: calls $1000
*** FLOP *** [Js Kh 6d]
gaganhyd: checks
slotmachine: bets $2904
TurnOnTuneInDropOut: calls $2904
gaganhyd: folds
*** TURN *** [Js Kh 6d] [9s]
slotmachine: checks
TurnOnTuneInDropOut: bets $9698
slotmachine: folds
Uncalled bet ($9698) returned to TurnOnTuneInDropOut
TurnOnTuneInDropOut collected $9799 from pot
TurnOnTuneInDropOut: doesn't show hand
*** SUMMARY ***
Total pot $10208 | Rake $409
Board [Js Kh 6d 9s]
Seat 1: soundfsilenz (small blind) folded before Flop
Seat 2: gaganhyd (big blind) folded on the Flop
Seat 3: slotmachine folded on the Turn
Seat 4: TurnOnTuneInDropOut collected ($9799)
Seat 5: kimjongun folded before Flop (didn't bet)
Seat 6: vikram2013 (button) folded before Flop (didn't bet)

PokerStars Hand #1255059727: Omaha Pot Limit ($200/$400 USD) - 2020/10/23 13:54:03 ET
Table 'ADA675920511' 6-max Seat #1 is the button
Seat 1: soundfsilenz ($40000 in chips)
Seat 2: gaganhyd ($21586 in chips)
Seat 3: slotmachine ($41296 in chips)
Seat 4: TurnOnTuneInDropOut ($67339 in chips)
Seat 5: kimjongun ($27588 in chips)
Seat 6: vikram2013 ($14620 in chips)
gaganhyd: posts small blind $200
slotmachine: posts big blind $400
*** HOLE CARDS ***
Dealt to TurnOnTuneInDropOut [Ac 6h 4c Jd]
TurnOnTuneInDropOut: folds
kimjongun: folds
vikram2013: calls $400
soundfsilenz: folds
gaganhyd: calls $200
slotmachine: checks
*** FLOP *** [6c As 5c]
gaganhyd: checks
slotmachine: checks
vikram2013: checks
*** TURN *** [6c As 5c] [8h]
gaganhyd: checks
slotmachine: bets $792
vikram2013: folds
gaganhyd: folds
Uncalled bet ($792) returned to slotmachine
slotmachine collected $1152 from pot
slotmachine: doesn't show hand
*** SUMMARY ***
Total pot $1200 | Rake $48
Board [6c As 5c 8h]
Seat 1: soundfsilenz (button) folded before Flop (didn't bet)
Seat 2: gaganhyd (small blind) folded on the Turn
Seat 3: slotmachine (big blind) collected ($1152)
Seat 4: TurnOnTuneInDropOut folded before Flop (didn't bet)
Seat 5: kimjongun folded before Flop (didn't bet)
Seat 6: vikram2013 folded on the Turn

PokerStars Hand #1255059730: Omaha Pot Limit ($200/$400 USD) - 2020/10/23 13:57:11 ET
Table 'ADA675920511' 6-max Seat #4 is the button
Seat 1: soundfsilenz ($43767 in chips)
Seat 2: gaganhyd ($21186 in chips)
Seat 3: slotmachine ($40248 in chips)
Seat 4: TurnOnTuneInDropOut ($76739 in chips)
Seat 5: kimjongun ($27188 in chips)
Seat 6: vikram2013 ($2220 in chips)
kimjongun: posts small blind $200
vikram2013: posts big blind $400
*** HOLE CARDS ***
Dealt to TurnOnTuneInDropOut [4d 9s 8h Kd]
soundfsilenz: folds
gaganhyd: folds
slotmachine: folds
TurnOnTuneInDropOut: folds
kimjongun: folds
Uncalled bet ($200) returned to vikram2013
vikram2013 collected $400 from pot
vikram2013: doesn't show hand
*** SUMMARY ***
Total pot $400 | Rake $0
Seat 1: soundfsilenz folded before Flop (didn't bet)
Seat 2: gaganhyd folded before Flop (didn't bet)
Seat 3: slotmachine folded before Flop (didn't bet)
Seat 4: TurnOnTuneInDropOut (button) folded before Flop (didn't bet)
Seat 5: kimjongun (small blind) folded before Flop
Seat 6: vikram2013 (big blind) collected ($400)

PokerStars Hand #1255059731: Omaha Pot Limit ($200/$400 USD) - 2020/10/23 13:57:31 ET
Table 'ADA675920511' 6-max Seat #5 is the button
Seat 1: soundfsilenz ($43767 in chips)
Seat 2: gaganhyd ($21186 in chips)
Seat 3: slotmachine ($40248 in chips)
Seat 4: TurnOnTuneInDropOut ($76739 in chips)
Seat 5: kimjongun ($26988 in chips)
Seat 6: vikram2013 ($2420 in chips)
vikram2013: posts small blind $200
soundfsilenz: posts big blind $400
*** HOLE CARDS ***
Dealt to TurnOnTuneInDropOut [Kc 9c Qh 5c]
gaganhyd: folds
slotmachine: folds
TurnOnTuneInDropOut: folds
kimjongun: folds
vikram2013: raises $800 to $1200
soundfsilenz: raises $2400 to $3600
vikram2013: calls $1220 and is all-in
Uncalled bet ($1180) returned to soundfsilenz
*** FLOP *** [Qc 7s 7d]
*** TURN *** [Qc 7s 7d] [Td]
*** RIVER *** [Qc 7s 7d Td] [5d]
*** SHOW DOWN ***
vikram2013: shows [4h 5s Ad Js]
soundfsilenz: shows [4s 3s Ah 5h]
soundfsilenz collected $2420 from pot
vikram2013 collected $2420 from pot
*** SUMMARY ***
Total pot $4840 | Rake $0
Board [Qc 7s 7d Td 5d]
Seat 1: soundfsilenz (big blind) showed [4s 3s Ah 5h] and won ($2420)
Seat 2: gaganhyd folded before Flop (didn't bet)
Seat 3: slotmachine folded before Flop (didn't bet)
Seat 4: TurnOnTuneInDropOut folded before Flop (didn't bet)
Seat 5: kimjongun (button) folded before Flop (didn't bet)
Seat 6: vikram2013 (small blind) showed [4h 5s Ad Js] and won ($2420)

PokerStars Hand #1255059733: Omaha Pot Limit ($200/$400 USD) - 2020/10/23 13:58:46 ET
Table 'ADA675920511' 6-max Seat #1 is the button
Seat 1: soundfsilenz ($43567 in chips)
Seat 2: gaganhyd ($20786 in chips)
Seat 3: slotmachine ($40248 in chips)
Seat 4: TurnOnTuneInDropOut ($79541 in chips)
Seat 5: kimjongun ($26988 in chips)
gaganhyd: posts small blind $200
slotmachine: posts big blind $400
*** HOLE CARDS ***
Dealt to TurnOnTuneInDropOut [4d 4c 3c 2d]
TurnOnTuneInDropOut: folds
kimjongun: raises $1000 to $1400
soundfsilenz: folds
gaganhyd: folds
slotmachine: raises $3000 to $4400
kimjongun: folds
Uncalled bet ($3000) returned to slotmachine
slotmachine collected $3000 from pot
slotmachine: doesn't show hand
*** SUMMARY ***
Total pot $3000 | Rake $0
Seat 1: soundfsilenz (button) folded before Flop (didn't bet)
Seat 2: gaganhyd (small blind) folded before Flop
Seat 3: slotmachine (big blind) collected ($3000)
Seat 4: TurnOnTuneInDropOut folded before Flop (didn't bet)
Seat 5: kimjongun folded before Flop

PokerStars Hand #1255059734: Omaha Pot Limit ($200/$400 USD) - 2020/10/23 13:59:13 ET
Table 'ADA675920511' 6-max Seat #2 is the button
Seat 1: soundfsilenz ($43567 in chips)
Seat 2: gaganhyd ($20586 in chips)
Seat 3: slotmachine ($48000 in chips)
Seat 4: TurnOnTuneInDropOut ($79541 in chips)
Seat 5: kimjongun ($25588 in chips)
slotmachine: posts small blind $200
TurnOnTuneInDropOut: posts big blind $400
*** HOLE CARDS ***
Dealt to TurnOnTuneInDropOut [Kh Qs Ks 6s]
kimjongun: folds
soundfsilenz: folds
gaganhyd: folds
slotmachine: folds
Uncalled bet ($200) returned to TurnOnTuneInDropOut
TurnOnTuneInDropOut collected $400 from pot
TurnOnTuneInDropOut: doesn't show hand
*** SUMMARY ***
Total pot $400 | Rake $0
Seat 1: soundfsilenz folded before Flop (didn't bet)
Seat 2: gaganhyd (button) folded before Flop (didn't bet)
Seat 3: slotmachine (small blind) folded before Flop
Seat 4: TurnOnTuneInDropOut (big blind) collected ($400)
Seat 5: kimjongun folded before Flop (didn't bet)

PokerStars Hand #1255059756: Omaha Pot Limit ($200/$400 USD) - 2020/10/23 14:11:34 ET
Table 'ADA675920511' 6-max Seat #2 is the button
Seat 1: Prateek1986 ($21375 in chips)
Seat 2: sherpalife ($48000 in chips)
Seat 3: slotmachine ($44468 in chips)
Seat 5: TurnOnTuneInDropOut ($79741 in chips)
Seat 6: soundfsilenz ($38567 in chips)
slotmachine: posts small blind $200
TurnOnTuneInDropOut: posts big blind $400
*** HOLE CARDS ***
Dealt to TurnOnTuneInDropOut [2d 5d 8s Ad]
soundfsilenz: folds
Prateek1986: folds
sherpalife: folds
slotmachine: raises $800 to $1200
TurnOnTuneInDropOut: calls $800
*** FLOP *** [6h 5h Ac]
slotmachine: checks
TurnOnTuneInDropOut: bets $1584
slotmachine: folds
Uncalled bet ($1584) returned to TurnOnTuneInDropOut
TurnOnTuneInDropOut collected $2304 from pot
TurnOnTuneInDropOut: doesn't show hand
*** SUMMARY ***
Total pot $2400 | Rake $96
Board [6h 5h Ac]
Seat 1: Prateek1986 folded before Flop (didn't bet)
Seat 2: sherpalife (button) folded before Flop (didn't bet)
Seat 3: slotmachine (small blind) folded on the Flop
Seat 5: TurnOnTuneInDropOut (big blind) collected ($2304)
Seat 6: soundfsilenz folded before Flop (didn't bet)

PokerStars Hand #1255059758: Omaha Pot Limit ($200/$400 USD) - 2020/10/23 14:13:25 ET
Table 'ADA675920511' 6-max Seat #5 is the button
Seat 1: Prateek1986 ($20075 in chips)
Seat 2: sherpalife ($48000 in chips)
Seat 3: slotmachine ($43268 in chips)
Seat 5: TurnOnTuneInDropOut ($83289 in chips)
Seat 6: soundfsilenz ($37267 in chips)
soundfsilenz: posts small blind $200
Prateek1986: posts big blind $400
*** HOLE CARDS ***
Dealt to TurnOnTuneInDropOut [8h Ks 7h Th]
sherpalife: folds
slotmachine: folds
TurnOnTuneInDropOut: raises $1000 to $1400
soundfsilenz: folds
Prateek1986: calls $1000
*** FLOP *** [Ts 6s Qh]
Prateek1986: checks
TurnOnTuneInDropOut: checks
*** TURN *** [Ts 6s Qh] [Td]
Prateek1986: bets $2250
TurnOnTuneInDropOut: raises $5063 to $7313
Prateek1986: calls $5063
*** RIVER *** [Ts 6s Qh Td] [Js]
Prateek1986: checks
TurnOnTuneInDropOut: checks
*** SHOW DOWN ***
Prateek1986: shows [2d 2c Kh Tc]
TurnOnTuneInDropOut: shows [8h Ks 7h Th]
TurnOnTuneInDropOut collected $8813 from pot
Prateek1986 collected $8813 from pot
*** SUMMARY ***
Total pot $17626 | Rake $0
Board [Ts 6s Qh Td Js]
Seat 1: Prateek1986 (big blind) showed [2d 2c Kh Tc] and won ($8813)
Seat 2: sherpalife folded before Flop (didn't bet)
Seat 3: slotmachine folded before Flop (didn't bet)
Seat 5: TurnOnTuneInDropOut (button) showed [8h Ks 7h Th] and won ($8813)
Seat 6: soundfsilenz (small blind) folded before Flop

PokerStars Hand #1255059759: Omaha Pot Limit ($200/$400 USD) - 2020/10/23 14:14:22 ET
Table 'ADA675920511' 6-max Seat #6 is the button
Seat 1: Prateek1986 ($20175 in chips)
Seat 2: sherpalife ($48000 in chips)
Seat 3: slotmachine ($43268 in chips)
Seat 5: TurnOnTuneInDropOut ($83389 in chips)
Seat 6: soundfsilenz ($37067 in chips)
Prateek1986: posts small blind $200
sherpalife: posts big blind $400
*** HOLE CARDS ***
Dealt to TurnOnTuneInDropOut [Qs 7h Js Kd]
slotmachine: folds
TurnOnTuneInDropOut: folds
soundfsilenz: folds
Prateek1986: raises $800 to $1200
sherpalife: folds
Uncalled bet ($800) returned to Prateek1986
Prateek1986 collected $800 from pot
Prateek1986: doesn't show hand
*** SUMMARY ***
Total pot $800 | Rake $0
Seat 1: Prateek1986 (small blind) collected ($800)
Seat 2: sherpalife (big blind) folded before Flop
Seat 3: slotmachine folded before Flop (didn't bet)
Seat 5: TurnOnTuneInDropOut folded before Flop (didn't bet)
Seat 6: soundfsilenz (button) folded before Flop (didn't bet)

PokerStars Hand #1255059760: Omaha Pot Limit ($200/$400 USD) - 2020/10/23 14:16:06 ET
Table 'ADA675920511' 6-max Seat #1 is the button
Seat 1: Prateek1986 ($20575 in chips)
Seat 2: sherpalife ($47600 in chips)
Seat 3: slotmachine ($43268 in chips)
Seat 5: TurnOnTuneInDropOut ($83389 in chips)
Seat 6: soundfsilenz ($37067 in chips)
sherpalife: posts small blind $200
slotmachine: posts big blind $400
*** HOLE CARDS ***
Dealt to TurnOnTuneInDropOut [Qd 5h 7s 5c]
TurnOnTuneInDropOut: folds
soundfsilenz: folds
Prateek1986: calls $400
sherpalife: folds
slotmachine: checks
*** FLOP *** [7h Qc Td]
slotmachine: checks
Prateek1986: checks
*** TURN *** [7h Qc Td] [4h]
slotmachine: checks
Prateek1986: checks
*** RIVER *** [7h Qc Td 4h] [2c]
slotmachine: checks
Prateek1986: checks
*** SHOW DOWN ***
slotmachine: shows [6d 8s 2s 7c]
Prateek1986: mucks hand
slotmachine collected $960 from pot
*** SUMMARY ***
Total pot $1000 | Rake $40
Board [7h Qc Td 4h 2c]
Seat 1: Prateek1986 (button) mucked
Seat 2: sherpalife (small blind) folded before Flop
Seat 3: slotmachine (big blind) showed [6d 8s 2s 7c] and won ($960)
Seat 5: TurnOnTuneInDropOut folded before Flop (didn't bet)
Seat 6: soundfsilenz folded before Flop (didn't bet)

PokerStars Hand #1255059761: Omaha Pot Limit ($200/$400 USD) - 2020/10/23 14:17:09 ET
Table 'ADA675920511' 6-max Seat #2 is the button
Seat 1: Prateek1986 ($20175 in chips)
Seat 2: sherpalife ($47400 in chips)
Seat 3: slotmachine ($43828 in chips)
Seat 4: Sam565 ($12000 in chips)
Seat 5: TurnOnTuneInDropOut ($83389 in chips)
Seat 6: soundfsilenz ($37067 in chips)
slotmachine: posts small blind $200
Sam565: posts big blind $400
*** HOLE CARDS ***
Dealt to TurnOnTuneInDropOut [2d Qs 7c Ah]
TurnOnTuneInDropOut: folds
soundfsilenz: folds
Prateek1986: folds
sherpalife: folds
slotmachine: folds
Uncalled bet ($200) returned to Sam565
Sam565 collected $400 from pot
Sam565: doesn't show hand
*** SUMMARY ***
Total pot $400 | Rake $0
Seat 1: Prateek1986 folded before Flop (didn't bet)
Seat 2: sherpalife (button) folded before Flop (didn't bet)
Seat 3: slotmachine (small blind) folded before Flop
Seat 4: Sam565 (big blind) collected ($400)
Seat 5: TurnOnTuneInDropOut folded before Flop (didn't bet)
Seat 6: soundfsilenz folded before Flop (didn't bet)

PokerStars Hand #1255059764: Omaha Pot Limit ($200/$400 USD) - 2020/10/23 14:21:06 ET
Table 'ADA675920511' 6-max Seat #6 is the button
Seat 1: Prateek1986 ($18625 in chips)
Seat 2: sherpalife ($47960 in chips)
Seat 3: slotmachine ($43628 in chips)
Seat 5: TurnOnTuneInDropOut ($84639 in chips)
Seat 6: soundfsilenz ($36867 in chips)
Prateek1986: posts small blind $200
sherpalife: posts big blind $400
*** HOLE CARDS ***
Dealt to TurnOnTuneInDropOut [Tc Ah 7s 2s]
slotmachine: folds
TurnOnTuneInDropOut: folds
soundfsilenz: folds
Prateek1986: calls $200
sherpalife: raises $800 to $1200
Prateek1986: folds
Uncalled bet ($800) returned to sherpalife
sherpalife collected $800 from pot
sherpalife: doesn't show hand
*** SUMMARY ***
Total pot $800 | Rake $0
Seat 1: Prateek1986 (small blind) folded before Flop
Seat 2: sherpalife (big blind) collected ($800)
Seat 3: slotmachine folded before Flop (didn't bet)
Seat 5: TurnOnTuneInDropOut folded before Flop (didn't bet)
Seat 6: soundfsilenz (button) folded before Flop (didn't bet)

PokerStars Hand #1255059765: Omaha Pot Limit ($200/$400 USD) - 2020/10/23 14:22:01 ET
Table 'ADA675920511' 6-max Seat #1 is the button
Seat 1: Prateek1986 ($18225 in chips)
Seat 2: sherpalife ($48360 in chips)
Seat 3: slotmachine ($43628 in chips)
Seat 5: TurnOnTuneInDropOut ($84639 in chips)
Seat 6: soundfsilenz ($36867 in chips)
sherpalife: posts small blind $200
slotmachine: posts big blind $400
*** HOLE CARDS ***
Dealt to TurnOnTuneInDropOut [Th 7h 8s 5c]
TurnOnTuneInDropOut: folds
soundfsilenz: folds
Prateek1986: calls $400
sherpalife: folds
slotmachine: raises $1000 to $1400
Prateek1986: calls $1000
*** FLOP *** [Jh 8c 7s]
slotmachine: checks
Prateek1986: checks
*** TURN *** [Jh 8c 7s] [3c]
slotmachine: checks
Prateek1986: checks
*** RIVER *** [Jh 8c 7s 3c] [5h]
slotmachine: checks
Prateek1986: checks
*** SHOW DOWN ***
slotmachine: shows [3s Ks Kh 4h]
Prateek1986: mucks hand
slotmachine collected $2880 from pot
*** SUMMARY ***
Total pot $3000 | Rake $120
Board [Jh 8c 7s 3c 5h]
Seat 1: Prateek1986 (button) mucked
Seat 2: sherpalife (small blind) folded before Flop
Seat 3: slotmachine (big blind) showed [3s Ks Kh 4h] and won ($2880)
Seat 5: TurnOnTuneInDropOut folded before Flop (didn't bet)
Seat 6: soundfsilenz folded before Flop (didn't bet)

PokerStars Hand #1255059766: Omaha Pot Limit ($200/$400 USD) - 2020/10/23 14:23:36 ET
Table 'ADA675920511' 6-max Seat #2 is the button
Seat 1: Prateek1986 ($16825 in chips)
Seat 2: sherpalife ($48160 in chips)
Seat 3: slotmachine ($45108 in chips)
Seat 4: Sam565 ($12000 in chips)
Seat 5: TurnOnTuneInDropOut ($84639 in chips)
Seat 6: soundfsilenz ($36867 in chips)
slotmachine: posts small blind $200
Sam565: posts big blind $400
*** HOLE CARDS ***
Dealt to TurnOnTuneInDropOut [3c 8d 5h Ac]
TurnOnTuneInDropOut: folds
soundfsilenz: folds
Prateek1986: raises $1000 to $1400
sherpalife: folds
slotmachine: raises $3200 to $4600
Sam565: folds
Prateek1986: calls $3200
*** FLOP *** [Qc Jh Jd]
slotmachine: bets $2768
Prateek1986: raises $9457 to $12225 and is all-in
slotmachine: folds
Uncalled bet ($9457) returned to Prateek1986
Prateek1986 collected $14529 from pot
Prateek1986: doesn't show hand
*** SUMMARY ***
Total pot $15136 | Rake $607
Board [Qc Jh Jd]
Seat 1: Prateek1986 collected ($14529)
Seat 2: sherpalife (button) folded before Flop (didn't bet)
Seat 3: slotmachine (small blind) folded on the Flop
Seat 4: Sam565 (big blind) folded before Flop
Seat 5: TurnOnTuneInDropOut folded before Flop (didn't bet)
Seat 6: soundfsilenz folded before Flop (didn't bet)

PokerStars Hand #1255059768: Omaha Pot Limit ($200/$400 USD) - 2020/10/23 14:25:40 ET
Table 'ADA675920511' 6-max Seat #4 is the button
Seat 1: Prateek1986 ($22186 in chips)
Seat 2: sherpalife ($50392 in chips)
Seat 3: slotmachine ($48000 in chips)
Seat 4: Sam565 ($11400 in chips)
Seat 5: TurnOnTuneInDropOut ($84239 in chips)
Seat 6: soundfsilenz ($36867 in chips)
TurnOnTuneInDropOut: posts small blind $200
soundfsilenz: posts big blind $400
*** HOLE CARDS ***
Dealt to TurnOnTuneInDropOut [Td 6s 2c Tc]
Prateek1986: raises $1000 to $1400
sherpalife: folds
slotmachine: folds
Sam565: folds
TurnOnTuneInDropOut: folds
soundfsilenz: folds
Uncalled bet ($1000) returned to Prateek1986
Prateek1986 collected $1000 from pot
Prateek1986: doesn't show hand
*** SUMMARY ***
Total pot $1000 | Rake $0
Seat 1: Prateek1986 collected ($1000)
Seat 2: sherpalife folded before Flop (didn't bet)
Seat 3: slotmachine folded before Flop (didn't bet)
Seat 4: Sam565 (button) folded before Flop (didn't bet)
Seat 5: TurnOnTuneInDropOut (small blind) folded before Flop
Seat 6: soundfsilenz (big blind) folded before Flop

PokerStars Hand #1255059771: Omaha Pot Limit ($200/$400 USD) - 2020/10/23 14:30:21 ET
Table 'ADA675920511' 6-max Seat #1 is the button
Seat 1: Prateek1986 ($21986 in chips)
Seat 2: sherpalife ($49392 in chips)
Seat 3: slotmachine ($48000 in chips)
Seat 4: Sam565 ($11104 in chips)
Seat 5: TurnOnTuneInDropOut ($84039 in chips)
Seat 6: soundfsilenz ($38323 in chips)
sherpalife: posts small blind $200
slotmachine: posts big blind $400
*** HOLE CARDS ***
Dealt to TurnOnTuneInDropOut [Jd Ts 2d 9s]
Sam565: folds
TurnOnTuneInDropOut: folds
soundfsilenz: folds
Prateek1986: folds
sherpalife: folds
Uncalled bet ($200) returned to slotmachine
slotmachine collected $400 from pot
slotmachine: doesn't show hand
*** SUMMARY ***
Total pot $400 | Rake $0
Seat 1: Prateek1986 (button) folded before Flop (didn't bet)
Seat 2: sherpalife (small blind) folded before Flop
Seat 3: slotmachine (big blind) collected ($400)
Seat 4: Sam565 folded before Flop (didn't bet)
Seat 5: TurnOnTuneInDropOut folded before Flop (didn't bet)
Seat 6: soundfsilenz folded before Flop (didn't bet)

PokerStars Hand #1255059772: Omaha Pot Limit ($200/$400 USD) - 2020/10/23 14:30:55 ET
Table 'ADA675920511' 6-max Seat #2 is the button
Seat 1: Prateek1986 ($21986 in chips)
Seat 2: sherpalife ($49192 in chips)
Seat 3: slotmachine ($48200 in chips)
Seat 4: Sam565 ($11104 in chips)
Seat 5: TurnOnTuneInDropOut ($84039 in chips)
Seat 6: soundfsilenz ($38323 in chips)
slotmachine: posts small blind $200
Sam565: posts big blind $400
*** HOLE CARDS ***
Dealt to TurnOnTuneInDropOut [Ts 5s 6h 4c]
TurnOnTuneInDropOut: folds
soundfsilenz: folds
Prateek1986: raises $1000 to $1400
sherpalife: calls $1400
slotmachine: folds
Sam565: calls $1000
*** FLOP *** [Jc Td Ah]
Sam565: checks
Prateek1986: bets $4400
sherpalife: folds
Sam565: folds
Uncalled bet ($4400) returned to Prateek1986
Prateek1986 collected $4224 from pot
Prateek1986: doesn't show hand
*** SUMMARY ***
Total pot $4400 | Rake $176
Board [Jc Td Ah]
Seat 1: Prateek1986 collected ($4224)
Seat 2: sherpalife (button) folded on the Flop
Seat 3: slotmachine (small blind) folded before Flop
Seat 4: Sam565 (big blind) folded on the Flop
Seat 5: TurnOnTuneInDropOut folded before Flop (didn't bet)
Seat 6: soundfsilenz folded before Flop (didn't bet)

PokerStars Hand #1255059776: Omaha Pot Limit ($200/$400 USD) - 2020/10/23 14:35:38 ET
Table 'ADA675920511' 6-max Seat #6 is the button
Seat 1: Prateek1986 ($17382 in chips)
Seat 2: sherpalife ($40977 in chips)
Seat 3: slotmachine ($57082 in chips)
Seat 4: Sam565 ($9104 in chips)
Seat 5: TurnOnTuneInDropOut ($83439 in chips)
Seat 6: soundfsilenz ($43531 in chips)
Prateek1986: posts small blind $200
sherpalife: posts big blind $400
*** HOLE CARDS ***
Dealt to TurnOnTuneInDropOut [9d 3s Ks Qs]
slotmachine: raises $1000 to $1400
Sam565: folds
TurnOnTuneInDropOut: folds
soundfsilenz: folds
Prateek1986: calls $1200
sherpalife: calls $1000
*** FLOP *** [7s 6h Kd]
Prateek1986: bets $3150
sherpalife: raises $10500 to $13650
slotmachine: folds
Prateek1986: folds
Uncalled bet ($10500) returned to sherpalife
sherpalife collected $10079 from pot
sherpalife: doesn't show hand
*** SUMMARY ***
Total pot $10500 | Rake $421
Board [7s 6h Kd]
Seat 1: Prateek1986 (small blind) folded on the Flop
Seat 2: sherpalife (big blind) collected ($10079)
Seat 3: slotmachine folded on the Flop
Seat 4: Sam565 folded before Flop (didn't bet)
Seat 5: TurnOnTuneInDropOut folded before Flop (didn't bet)
Seat 6: soundfsilenz (button) folded before Flop (didn't bet)

PokerStars Hand #1255059777: Omaha Pot Limit ($200/$400 USD) - 2020/10/23 14:36:45 ET
Table 'ADA675920511' 6-max Seat #1 is the button
Seat 1: Prateek1986 ($12832 in chips)
Seat 2: sherpalife ($46506 in chips)
Seat 3: slotmachine ($55682 in chips)
Seat 4: Sam565 ($9104 in chips)
Seat 5: TurnOnTuneInDropOut ($83439 in chips)
Seat 6: soundfsilenz ($43531 in chips)
sherpalife: posts small blind $200
slotmachine: posts big blind $400
*** HOLE CARDS ***
Dealt to TurnOnTuneInDropOut [Tc 7s 9h 3c]
Sam565: folds
TurnOnTuneInDropOut: folds
soundfsilenz: raises $1000 to $1400
Prateek1986: raises $3400 to $4800
sherpalife: folds
slotmachine: folds
soundfsilenz: calls $3400
*** FLOP *** [4c 4h 6s]
soundfsilenz: checks
Prateek1986: bets $8032 and is all-in
soundfsilenz: folds
Uncalled bet ($8032) returned to Prateek1986
Prateek1986 collected $9791 from pot
Prateek1986: doesn't show hand
*** SUMMARY ***
Total pot $10200 | Rake $409
Board [4c 4h 6s]
Seat 1: Prateek1986 (button) collected ($9791)
Seat 2: sherpalife (small blind) folded before Flop
Seat 3: slotmachine (big blind) folded before Flop
Seat 4: Sam565 folded before Flop (didn't bet)
Seat 5: TurnOnTuneInDropOut folded before Flop (didn't bet)
Seat 6: soundfsilenz folded on the Flop

PokerStars Hand #1255059778: Omaha Pot Limit ($200/$400 USD) - 2020/10/23 14:37:54 ET
Table 'ADA675920511' 6-max Seat #2 is the button
Seat 1: Prateek1986 ($17823 in chips)
Seat 2: sherpalife ($46306 in chips)
Seat 3: slotmachine ($55282 in chips)
Seat 4: Sam565 ($9104 in chips)
Seat 5: TurnOnTuneInDropOut ($83439 in chips)
Seat 6: soundfsilenz ($38731 in chips)
slotmachine: posts small blind $200
Sam565: posts big blind $400
*** HOLE CARDS ***
Dealt to TurnOnTuneInDropOut [4d 7h 3c 9d]
TurnOnTuneInDropOut: folds
soundfsilenz: folds
Prateek1986: raises $1000 to $1400
sherpalife: folds
slotmachine: folds
Sam565: calls $1000
*** FLOP *** [8d Qc 8c]
Sam565: checks
Prateek1986: bets $3000
Sam565: calls $3000
*** TURN *** [8d Qc 8c] [Ad]
Sam565: bets $4704 and is all-in
Prateek1986: calls $4704
*** RIVER *** [8d Qc 8c Ad] [Ts]
*** SHOW DOWN ***
Sam565: shows [Jd Ac 6s 9c]
Prateek1986: shows [Qd 7c Kd 6c]
Sam565 collected $17670 from pot
*** SUMMARY ***
Total pot $18408 | Rake $738
Board [8d Qc 8c Ad Ts]
Seat 1: Prateek1986 showed [Qd 7c Kd 6c] and lost
Seat 2: sherpalife (button) folded before Flop (didn't bet)
Seat 3: slotmachine (small blind) folded before Flop
Seat 4: Sam565 (big blind) showed [Jd Ac 6s 9c] and won ($17670)
Seat 5: TurnOnTuneInDropOut folded before Flop (didn't bet)
Seat 6: soundfsilenz folded before Flop (didn't bet)

PokerStars Hand #1255059779: Omaha Pot Limit ($200/$400 USD) - 2020/10/23 14:39:00 ET
Table 'ADA675920511' 6-max Seat #3 is the button
Seat 1: Prateek1986 ($8719 in chips)
Seat 2: sherpalife ($46306 in chips)
Seat 3: slotmachine ($55082 in chips)
Seat 4: Sam565 ($17670 in chips)
Seat 5: TurnOnTuneInDropOut ($83439 in chips)
Seat 6: soundfsilenz ($38731 in chips)
Sam565: posts small blind $200
TurnOnTuneInDropOut: posts big blind $400
*** HOLE CARDS ***
Dealt to TurnOnTuneInDropOut [5c Qc 9s 2c]
soundfsilenz: folds
Prateek1986: raises $1000 to $1400
sherpalife: raises $3400 to $4800
slotmachine: folds
Sam565: folds
TurnOnTuneInDropOut: folds
Prateek1986: raises $3919 to $8719 and is all-in
sherpalife: calls $3919
*** FLOP *** [Ts Ah 4h]
*** TURN *** [Ts Ah 4h] [7h]
*** RIVER *** [Ts Ah 4h 7h] [8h]
*** SHOW DOWN ***
Prateek1986: shows [4c 3c Td 3d]
sherpalife: shows [Kc Tc Qh Ks]
Prateek1986 collected $17315 from pot
*** SUMMARY ***
Total pot $18038 | Rake $723
Board [Ts Ah 4h 7h 8h]
Seat 1: Prateek1986 showed [4c 3c Td 3d] and won ($17315)
Seat 2: sherpalife showed [Kc Tc Qh Ks] and lost
Seat 3: slotmachine (button) folded before Flop (didn't bet)
Seat 4: Sam565 (small blind) folded before Flop
Seat 5: TurnOnTuneInDropOut (big blind) folded before Flop
Seat 6: soundfsilenz folded before Flop (didn't bet)

PokerStars Hand #1255059781: Omaha Pot Limit ($200/$400 USD) - 2020/10/23 14:40:34 ET
Table 'ADA675920511' 6-max Seat #5 is the button
Seat 1: Prateek1986 ($17315 in chips)
Seat 2: sherpalife ($46850 in chips)
Seat 3: slotmachine ($45638 in chips)
Seat 4: Sam565 ($17470 in chips)
Seat 5: TurnOnTuneInDropOut ($82839 in chips)
Seat 6: soundfsilenz ($38331 in chips)
soundfsilenz: posts small blind $200
Prateek1986: posts big blind $400
*** HOLE CARDS ***
Dealt to TurnOnTuneInDropOut [Ad Qh 9c 5h]
sherpalife: folds
slotmachine: raises $1000 to $1400
Sam565: folds
TurnOnTuneInDropOut: folds
soundfsilenz: folds
Prateek1986: raises $3000 to $4400
slotmachine: raises $9000 to $13400
Prateek1986: raises $3915 to $17315 and is all-in
slotmachine: calls $3915
*** FLOP *** [Qs Qd 5s]
*** TURN *** [Qs Qd 5s] [8h]
*** RIVER *** [Qs Qd 5s 8h] [Kc]
*** SHOW DOWN ***
Prateek1986: shows [6c Jh 2c Jc]
slotmachine: shows [3c Kh Kd 6s]
slotmachine collected $34030 from pot
*** SUMMARY ***
Total pot $34830 | Rake $800
Board [Qs Qd 5s 8h Kc]
Seat 1: Prateek1986 (big blind) showed [6c Jh 2c Jc] and lost
Seat 2: sherpalife folded before Flop (didn't bet)
Seat 3: slotmachine showed [3c Kh Kd 6s] and won ($34030)
Seat 4: Sam565 folded before Flop (didn't bet)
Seat 5: TurnOnTuneInDropOut (button) folded before Flop (didn't bet)
Seat 6: soundfsilenz (small blind) folded before Flop

PokerStars Hand #1255059782: Omaha Pot Limit ($200/$400 USD) - 2020/10/23 14:41:21 ET
Table 'ADA675920511' 6-max Seat #6 is the button
Seat 2: sherpalife ($46850 in chips)
Seat 3: slotmachine ($62353 in chips)
Seat 4: Sam565 ($17470 in chips)
Seat 5: TurnOnTuneInDropOut ($82839 in chips)
Seat 6: soundfsilenz ($38131 in chips)
sherpalife: posts small blind $200
slotmachine: posts big blind $400
*** HOLE CARDS ***
Dealt to TurnOnTuneInDropOut [3c 5c 7h 8d]
Sam565: folds
TurnOnTuneInDropOut: folds
soundfsilenz: folds
sherpalife: calls $200
slotmachine: checks
*** FLOP *** [2h 9c Kc]
sherpalife: bets $400
slotmachine: raises $1600 to $2000
sherpalife: calls $1600
*** TURN *** [2h 9c Kc] [9s]
sherpalife: checks
slotmachine: bets $2400
sherpalife: calls $2400
*** RIVER *** [2h 9c Kc 9s] [Td]
sherpalife: checks
slotmachine: bets $4800
sherpalife: calls $4800
*** SHOW DOWN ***
sherpalife: mucks hand
slotmachine: shows [9h 6c Jh 9d]
slotmachine collected $18430 from pot
*** SUMMARY ***
Total pot $19200 | Rake $770
Board [2h 9c Kc 9s Td]
Seat 2: sherpalife (small blind) mucked
Seat 3: slotmachine (big blind) showed [9h 6c Jh 9d] and won ($18430)
Seat 4: Sam565 folded before Flop (didn't bet)
Seat 5: TurnOnTuneInDropOut folded before Flop (didn't bet)
Seat 6: soundfsilenz (button) folded before Flop (didn't bet)

PokerStars Hand #1109334719: Omaha Pot Limit ($200/$400 USD) - 2020/10/23 12:32:26 ET
Table 'ADA722387266' 6-max Seat #3 is the button
Seat 1: aakashchak76 ($47600 in chips)
Seat 2: TurnOnTuneInDropOut ($48000 in chips)
Seat 3: slotmachine ($45975 in chips)
aakashchak76: posts small blind $200
TurnOnTuneInDropOut: posts big blind $400
*** HOLE CARDS ***
Dealt to TurnOnTuneInDropOut [3c 5s Qc Qs]
slotmachine: folds
aakashchak76: calls $200
TurnOnTuneInDropOut: raises $800 to $1200
aakashchak76: calls $800
*** FLOP *** [5h 9c 8s]
aakashchak76: bets $400
TurnOnTuneInDropOut: calls $400
*** TURN *** [5h 9c 8s] [8d]
aakashchak76: checks
TurnOnTuneInDropOut: checks
*** RIVER *** [5h 9c 8s 8d] [Ac]
aakashchak76: checks
TurnOnTuneInDropOut: checks
*** SHOW DOWN ***
aakashchak76: shows [Qd 7h 4c Tc]
TurnOnTuneInDropOut: shows [3c 5s Qc Qs]
TurnOnTuneInDropOut collected $3072 from pot
*** SUMMARY ***
Total pot $3200 | Rake $128
Board [5h 9c 8s 8d Ac]
Seat 1: aakashchak76 (small blind) showed [Qd 7h 4c Tc] and lost
Seat 2: TurnOnTuneInDropOut (big blind) showed [3c 5s Qc Qs] and won ($3072)
Seat 3: slotmachine (button) folded before Flop (didn't bet)

PokerStars Hand #1109334720: Omaha Pot Limit ($200/$400 USD) - 2020/10/23 12:32:59 ET
Table 'ADA722387266' 6-max Seat #1 is the button
Seat 1: aakashchak76 ($46000 in chips)
Seat 2: TurnOnTuneInDropOut ($49472 in chips)
Seat 3: slotmachine ($45975 in chips)
TurnOnTuneInDropOut: posts small blind $200
slotmachine: posts big blind $400
*** HOLE CARDS ***
Dealt to TurnOnTuneInDropOut [8c As Tc 5h]
aakashchak76: folds
TurnOnTuneInDropOut: raises $800 to $1200
slotmachine: calls $800
*** FLOP *** [2d Jc Js]
TurnOnTuneInDropOut: bets $592
slotmachine: calls $592
*** TURN *** [2d Jc Js] [Qc]
TurnOnTuneInDropOut: bets $2366
slotmachine: calls $2366
*** RIVER *** [2d Jc Js Qc] [9s]
TurnOnTuneInDropOut: checks
slotmachine: checks
*** SHOW DOWN ***
TurnOnTuneInDropOut: shows [8c As Tc 5h]
slotmachine: mucks hand
TurnOnTuneInDropOut collected $7983 from pot
*** SUMMARY ***
Total pot $8316 | Rake $333
Board [2d Jc Js Qc 9s]
Seat 1: aakashchak76 (button) folded before Flop (didn't bet)
Seat 2: TurnOnTuneInDropOut (small blind) showed [8c As Tc 5h] and won ($7983)
Seat 3: slotmachine (big blind) mucked

PokerStars Hand #1109334721: Omaha Pot Limit ($200/$400 USD) - 2020/10/23 12:34:05 ET
Table 'ADA722387266' 6-max Seat #2 is the button
Seat 1: aakashchak76 ($46000 in chips)
Seat 2: TurnOnTuneInDropOut ($53297 in chips)
Seat 3: slotmachine ($41817 in chips)
slotmachine: posts small blind $200
aakashchak76: posts big blind $400
*** HOLE CARDS ***
Dealt to TurnOnTuneInDropOut [As Qh Ac 4h]
TurnOnTuneInDropOut: raises $1000 to $1400
slotmachine: folds
aakashchak76: calls $1000
*** FLOP *** [9c 5d 5c]
aakashchak76: bets $3000
TurnOnTuneInDropOut: calls $3000
*** TURN *** [9c 5d 5c] [7s]
aakashchak76: bets $9000
TurnOnTuneInDropOut: calls $9000
*** RIVER *** [9c 5d 5c 7s] [2c]
aakashchak76: bets $27000
TurnOnTuneInDropOut: folds
Uncalled bet ($27000) returned to aakashchak76
aakashchak76 collected $26300 from pot
aakashchak76: doesn't show hand
*** SUMMARY ***
Total pot $27000 | Rake $700
Board [9c 5d 5c 7s 2c]
Seat 1: aakashchak76 (big blind) collected ($26300)
Seat 2: TurnOnTuneInDropOut (button) folded on the River
Seat 3: slotmachine (small blind) folded before Flop

PokerStars Hand #1109334722: Omaha Pot Limit ($200/$400 USD) - 2020/10/23 12:35:10 ET
Table 'ADA722387266' 6-max Seat #3 is the button
Seat 1: aakashchak76 ($58900 in chips)
Seat 2: TurnOnTuneInDropOut ($48000 in chips)
Seat 3: slotmachine ($41617 in chips)
aakashchak76: posts small blind $200
TurnOnTuneInDropOut: posts big blind $400
*** HOLE CARDS ***
Dealt to TurnOnTuneInDropOut [9d 7s 6s 8c]
slotmachine: folds
aakashchak76: calls $200
TurnOnTuneInDropOut: raises $800 to $1200
aakashchak76: calls $800
*** FLOP *** [Ac 8s Jc]
aakashchak76: checks
TurnOnTuneInDropOut: bets $1200
aakashchak76: folds
Uncalled bet ($1200) returned to TurnOnTuneInDropOut
TurnOnTuneInDropOut collected $2304 from pot
TurnOnTuneInDropOut: doesn't show hand
*** SUMMARY ***
Total pot $2400 | Rake $96
Board [Ac 8s Jc]
Seat 1: aakashchak76 (small blind) folded on the Flop
Seat 2: TurnOnTuneInDropOut (big blind) collected ($2304)
Seat 3: slotmachine (button) folded before Flop (didn't bet)

PokerStars Hand #1109334786: Omaha Pot Limit ($200/$400 USD) - 2020/10/23 13:24:42 ET
Table 'ADA722387266' 6-max Seat #5 is the button
Seat 1: Lock2k16 ($24500 in chips)
Seat 2: TurnOnTuneInDropOut ($30000 in chips)
Seat 3: slotmachine ($49772 in chips)
Seat 4: XirT ($20466 in chips)
Seat 5: kimjongun ($34902 in chips)
Lock2k16: posts small blind $200
TurnOnTuneInDropOut: posts big blind $400
*** HOLE CARDS ***
Dealt to TurnOnTuneInDropOut [4c Qc 2s Th]
slotmachine: folds
XirT: folds
kimjongun: raises $1000 to $1400
Lock2k16: calls $1200
TurnOnTuneInDropOut: folds
*** FLOP *** [4s Ad Kd]
Lock2k16: checks
kimjongun: checks
*** TURN *** [4s Ad Kd] [As]
Lock2k16: bets $800
kimjongun: raises $3400 to $4200
Lock2k16: folds
Uncalled bet ($3400) returned to kimjongun
kimjongun collected $4608 from pot
kimjongun: doesn't show hand
*** SUMMARY ***
Total pot $4800 | Rake $192
Board [4s Ad Kd As]
Seat 1: Lock2k16 (small blind) folded on the Turn
Seat 2: TurnOnTuneInDropOut (big blind) folded before Flop
Seat 3: slotmachine folded before Flop (didn't bet)
Seat 4: XirT folded before Flop (didn't bet)
Seat 5: kimjongun (button) collected ($4608)

PokerStars Hand #1109334787: Omaha Pot Limit ($200/$400 USD) - 2020/10/23 13:25:44 ET
Table 'ADA722387266' 6-max Seat #1 is the button
Seat 1: Lock2k16 ($22300 in chips)
Seat 2: TurnOnTuneInDropOut ($29600 in chips)
Seat 3: slotmachine ($49772 in chips)
Seat 4: XirT ($20466 in chips)
Seat 5: kimjongun ($37310 in chips)
TurnOnTuneInDropOut: posts small blind $200
slotmachine: posts big blind $400
*** HOLE CARDS ***
Dealt to TurnOnTuneInDropOut [Td 2h Kd Ah]
XirT: folds
kimjongun: folds
Lock2k16: raises $400 to $800
TurnOnTuneInDropOut: raises $2000 to $2800
slotmachine: calls $2400
Lock2k16: calls $2000
*** FLOP *** [8d 7c 4s]
TurnOnTuneInDropOut: checks
slotmachine: checks
Lock2k16: bets $1200
TurnOnTuneInDropOut: folds
slotmachine: calls $1200
*** TURN *** [8d 7c 4s] [2c]
slotmachine: checks
Lock2k16: checks
*** RIVER *** [8d 7c 4s 2c] [4h]
slotmachine: checks
Lock2k16: checks
*** SHOW DOWN ***
slotmachine: mucks hand
Lock2k16: shows [Ks Tc Kc Ts]
Lock2k16 collected $10367 from pot
*** SUMMARY ***
Total pot $10800 | Rake $433
Board [8d 7c 4s 2c 4h]
Seat 1: Lock2k16 (button) showed [Ks Tc Kc Ts] and won ($10367)
Seat 2: TurnOnTuneInDropOut (small blind) folded on the Flop
Seat 3: slotmachine (big blind) mucked
Seat 4: XirT folded before Flop (didn't bet)
Seat 5: kimjongun folded before Flop (didn't bet)

PokerStars Hand #1109334791: Omaha Pot Limit ($200/$400 USD) - 2020/10/23 13:29:44 ET
Table 'ADA722387266' 6-max Seat #5 is the button
Seat 1: Lock2k16 ($29347 in chips)
Seat 2: TurnOnTuneInDropOut ($26800 in chips)
Seat 3: slotmachine ($49851 in chips)
Seat 4: XirT ($17866 in chips)
Seat 5: kimjongun ($33910 in chips)
Seat 6: vaibz16 ($12543 in chips)
vaibz16: posts small blind $200
Lock2k16: posts big blind $400
*** HOLE CARDS ***
Dealt to TurnOnTuneInDropOut [9d 5c As 3s]
TurnOnTuneInDropOut: folds
slotmachine: folds
XirT: calls $400
kimjongun: folds
vaibz16: folds
Lock2k16: raises $1000 to $1400
XirT: calls $1000
*** FLOP *** [9c Kh 7c]
Lock2k16: checks
XirT: bets $3000
Lock2k16: calls $3000
*** TURN *** [9c Kh 7c] [Jc]
Lock2k16: checks
XirT: checks
*** RIVER *** [9c Kh 7c Jc] [Qh]
Lock2k16: checks
XirT: checks
*** SHOW DOWN ***
Lock2k16: mucks hand
XirT: shows [4d Jd Kc Ks]
XirT collected $8639 from pot
*** SUMMARY ***
Total pot $9000 | Rake $361
Board [9c Kh 7c Jc Qh]
Seat 1: Lock2k16 (big blind) mucked
Seat 2: TurnOnTuneInDropOut folded before Flop (didn't bet)
Seat 3: slotmachine folded before Flop (didn't bet)
Seat 4: XirT showed [4d Jd Kc Ks] and won ($8639)
Seat 5: kimjongun (button) folded before Flop (didn't bet)
Seat 6: vaibz16 (small blind) folded before Flop

PokerStars Hand #1109334793: Omaha Pot Limit ($200/$400 USD) - 2020/10/23 13:31:45 ET
Table 'ADA722387266' 6-max Seat #1 is the button
Seat 1: Lock2k16 ($24147 in chips)
Seat 2: TurnOnTuneInDropOut ($39143 in chips)
Seat 3: slotmachine ($49851 in chips)
Seat 4: XirT ($22105 in chips)
Seat 5: kimjongun ($33910 in chips)
TurnOnTuneInDropOut: posts small blind $200
slotmachine: posts big blind $400
*** HOLE CARDS ***
Dealt to TurnOnTuneInDropOut [2s 2h 2d As]
XirT: folds
kimjongun: folds
Lock2k16: raises $400 to $800
TurnOnTuneInDropOut: folds
slotmachine: folds
Uncalled bet ($400) returned to Lock2k16
Lock2k16 collected $1000 from pot
Lock2k16: doesn't show hand
*** SUMMARY ***
Total pot $1000 | Rake $0
Seat 1: Lock2k16 (button) collected ($1000)
Seat 2: TurnOnTuneInDropOut (small blind) folded before Flop
Seat 3: slotmachine (big blind) folded before Flop
Seat 4: XirT folded before Flop (didn't bet)
Seat 5: kimjongun folded before Flop (didn't bet)

PokerStars Hand #1109334794: Omaha Pot Limit ($200/$400 USD) - 2020/10/23 13:32:00 ET
Table 'ADA722387266' 6-max Seat #2 is the button
Seat 1: Lock2k16 ($24747 in chips)
Seat 2: TurnOnTuneInDropOut ($38943 in chips)
Seat 3: slotmachine ($49451 in chips)
Seat 4: XirT ($22105 in chips)
Seat 5: kimjongun ($33910 in chips)
Seat 6: vaibz16 ($12000 in chips)
slotmachine: posts small blind $200
XirT: posts big blind $400
*** HOLE CARDS ***
Dealt to TurnOnTuneInDropOut [Qh 4h Jh 8s]
kimjongun: folds
vaibz16: folds
Lock2k16: raises $1000 to $1400
TurnOnTuneInDropOut: folds
slotmachine: folds
XirT: folds
Uncalled bet ($1000) returned to Lock2k16
Lock2k16 collected $1000 from pot
Lock2k16: doesn't show hand
*** SUMMARY ***
Total pot $1000 | Rake $0
Seat 1: Lock2k16 collected ($1000)
Seat 2: TurnOnTuneInDropOut (button) folded before Flop (didn't bet)
Seat 3: slotmachine (small blind) folded before Flop
Seat 4: XirT (big blind) folded before Flop
Seat 5: kimjongun folded before Flop (didn't bet)
Seat 6: vaibz16 folded before Flop (didn't bet)

PokerStars Hand #1109334796: Omaha Pot Limit ($200/$400 USD) - 2020/10/23 13:33:36 ET
Table 'ADA722387266' 6-max Seat #4 is the button
Seat 1: Lock2k16 ($62094 in chips)
Seat 2: TurnOnTuneInDropOut ($38943 in chips)
Seat 3: slotmachine ($49251 in chips)
Seat 4: XirT ($21505 in chips)
Seat 5: kimjongun ($8563 in chips)
kimjongun: posts small blind $200
Lock2k16: posts big blind $400
*** HOLE CARDS ***
Dealt to TurnOnTuneInDropOut [3h 4s 4h 6s]
TurnOnTuneInDropOut: folds
slotmachine: raises $1000 to $1400
XirT: folds
kimjongun: folds
Lock2k16: folds
Uncalled bet ($1000) returned to slotmachine
slotmachine collected $1000 from pot
slotmachine: doesn't show hand
*** SUMMARY ***
Total pot $1000 | Rake $0
Seat 1: Lock2k16 (big blind) folded before Flop
Seat 2: TurnOnTuneInDropOut folded before Flop (didn't bet)
Seat 3: slotmachine collected ($1000)
Seat 4: XirT (button) folded before Flop (didn't bet)
Seat 5: kimjongun (small blind) folded before Flop

PokerStars Hand #1109334797: Omaha Pot Limit ($200/$400 USD) - 2020/10/23 13:34:06 ET
Table 'ADA722387266' 6-max Seat #5 is the button
Seat 1: Lock2k16 ($61694 in chips)
Seat 2: TurnOnTuneInDropOut ($38943 in chips)
Seat 3: slotmachine ($49851 in chips)
Seat 4: XirT ($21505 in chips)
Seat 5: kimjongun ($8363 in chips)
Lock2k16: posts small blind $200
TurnOnTuneInDropOut: posts big blind $400
*** HOLE CARDS ***
Dealt to TurnOnTuneInDropOut [Jh 4d Ts Jd]
slotmachine: folds
XirT: raises $1000 to $1400
kimjongun: folds
Lock2k16: folds
TurnOnTuneInDropOut: calls $1000
*** FLOP *** [6s 7c 9d]
TurnOnTuneInDropOut: checks
XirT: checks
*** TURN *** [6s 7c 9d] [9s]
TurnOnTuneInDropOut: checks
XirT: bets $3000
TurnOnTuneInDropOut: calls $3000
*** RIVER *** [6s 7c 9d 9s] [2h]
TurnOnTuneInDropOut: checks
XirT: checks
*** SHOW DOWN ***
TurnOnTuneInDropOut: shows [Jh 4d Ts Jd]
XirT: mucks hand
TurnOnTuneInDropOut collected $8639 from pot
*** SUMMARY ***
Total pot $9000 | Rake $361
Board [6s 7c 9d 9s 2h]
Seat 1: Lock2k16 (small blind) folded before Flop
Seat 2: TurnOnTuneInDropOut (big blind) showed [Jh 4d Ts Jd] and won ($8639)
Seat 3: slotmachine folded before Flop (didn't bet)
Seat 4: XirT mucked
Seat 5: kimjongun (button) folded before Flop (didn't bet)

PokerStars Hand #1109334799: Omaha Pot Limit ($200/$400 USD) - 2020/10/23 13:35:47 ET
Table 'ADA722387266' 6-max Seat #2 is the button
Seat 1: Lock2k16 ($62630 in chips)
Seat 2: TurnOnTuneInDropOut ($42782 in chips)
Seat 3: slotmachine ($49451 in chips)
Seat 4: XirT ($16705 in chips)
Seat 5: kimjongun ($8363 in chips)
slotmachine: posts small blind $200
XirT: posts big blind $400
*** HOLE CARDS ***
Dealt to TurnOnTuneInDropOut [8c 6c Jh Jd]
kimjongun: folds
Lock2k16: raises $400 to $800
TurnOnTuneInDropOut: calls $800
slotmachine: folds
XirT: folds
*** FLOP *** [Ah 8d Th]
Lock2k16: bets $1650
TurnOnTuneInDropOut: folds
Uncalled bet ($1650) returned to Lock2k16
Lock2k16 collected $2112 from pot
Lock2k16: doesn't show hand
*** SUMMARY ***
Total pot $2200 | Rake $88
Board [Ah 8d Th]
Seat 1: Lock2k16 collected ($2112)
Seat 2: TurnOnTuneInDropOut (button) folded on the Flop
Seat 3: slotmachine (small blind) folded before Flop
Seat 4: XirT (big blind) folded before Flop
Seat 5: kimjongun folded before Flop (didn't bet)

PokerStars Hand #1109334802: Omaha Pot Limit ($200/$400 USD) - 2020/10/23 13:38:38 ET
Table 'ADA722387266' 6-max Seat #5 is the button
Seat 1: Lock2k16 ($62742 in chips)
Seat 2: TurnOnTuneInDropOut ($47111 in chips)
Seat 3: slotmachine ($49251 in chips)
Seat 4: XirT ($17425 in chips)
Seat 5: kimjongun ($27785 in chips)
Seat 6: vaibz16 ($7050 in chips)
vaibz16: posts small blind $200
Lock2k16: posts big blind $400
*** HOLE CARDS ***
Dealt to TurnOnTuneInDropOut [9d Tc As Js]
TurnOnTuneInDropOut: raises $1000 to $1400
slotmachine: calls $1400
XirT: folds
kimjongun: raises $4800 to $6200
vaibz16: folds
Lock2k16: folds
TurnOnTuneInDropOut: folds
slotmachine: calls $4800
*** FLOP *** [Jc Ts 2c]
slotmachine: checks
kimjongun: bets $14400
slotmachine: folds
Uncalled bet ($14400) returned to kimjongun
kimjongun collected $13823 from pot
kimjongun: doesn't show hand
*** SUMMARY ***
Total pot $14400 | Rake $577
Board [Jc Ts 2c]
Seat 1: Lock2k16 (big blind) folded before Flop
Seat 2: TurnOnTuneInDropOut folded before Flop
Seat 3: slotmachine folded on the Flop
Seat 4: XirT folded before Flop (didn't bet)
Seat 5: kimjongun (button) collected ($13823)
Seat 6: vaibz16 (small blind) folded before Flop

PokerStars Hand #1109334803: Omaha Pot Limit ($200/$400 USD) - 2020/10/23 13:39:26 ET
Table 'ADA722387266' 6-max Seat #6 is the button
Seat 1: Lock2k16 ($62342 in chips)
Seat 2: TurnOnTuneInDropOut ($45711 in chips)
Seat 3: slotmachine ($43051 in chips)
Seat 4: XirT ($17425 in chips)
Seat 5: kimjongun ($35408 in chips)
Seat 6: vaibz16 ($22673 in chips)
Lock2k16: posts small blind $200
TurnOnTuneInDropOut: posts big blind $400
*** HOLE CARDS ***
Dealt to TurnOnTuneInDropOut [3d 7h Kc Qd]
slotmachine: folds
XirT: folds
kimjongun: raises $1000 to $1400
vaibz16: folds
Lock2k16: calls $1200
TurnOnTuneInDropOut: folds
*** FLOP *** [Qh Kd 6s]
Lock2k16: bets $1600
kimjongun: folds
Uncalled bet ($1600) returned to Lock2k16
Lock2k16 collected $3072 from pot
Lock2k16: doesn't show hand
*** SUMMARY ***
Total pot $3200 | Rake $128
Board [Qh Kd 6s]
Seat 1: Lock2k16 (small blind) collected ($3072)
Seat 2: TurnOnTuneInDropOut (big blind) folded before Flop
Seat 3: slotmachine folded before Flop (didn't bet)
Seat 4: XirT folded before Flop (didn't bet)
Seat 5: kimjongun folded on the Flop
Seat 6: vaibz16 (button) folded before Flop (didn't bet)

PokerStars Hand #1109334804: Omaha Pot Limit ($200/$400 USD) - 2020/10/23 13:40:03 ET
Table 'ADA722387266' 6-max Seat #1 is the button
Seat 1: Lock2k16 ($64014 in chips)
Seat 2: TurnOnTuneInDropOut ($45311 in chips)
Seat 3: slotmachine ($43051 in chips)
Seat 4: XirT ($17425 in chips)
Seat 5: kimjongun ($34008 in chips)
Seat 6: vaibz16 ($22673 in chips)
TurnOnTuneInDropOut: posts small blind $200
slotmachine: posts big blind $400
*** HOLE CARDS ***
Dealt to TurnOnTuneInDropOut [3h 5s 8d Ad]
XirT: folds
kimjongun: folds
vaibz16: raises $1000 to $1400
Lock2k16: calls $1400
TurnOnTuneInDropOut: folds
slotmachine: raises $4400 to $5800
vaibz16: calls $4400
Lock2k16: calls $4400
*** FLOP *** [Kc Kd 3c]
slotmachine: bets $5808
vaibz16: calls $5808
Lock2k16: raises $35024 to $40832
slotmachine: folds
vaibz16: folds
Uncalled bet ($35024) returned to Lock2k16
Lock2k16 collected $34224 from pot
Lock2k16: doesn't show hand
*** SUMMARY ***
Total pot $35024 | Rake $800
Board [Kc Kd 3c]
Seat 1: Lock2k16 (button) collected ($34224)
Seat 2: TurnOnTuneInDropOut (small blind) folded before Flop
Seat 3: slotmachine (big blind) folded on the Flop
Seat 4: XirT folded before Flop (didn't bet)
Seat 5: kimjongun folded before Flop (didn't bet)
Seat 6: vaibz16 folded on the Flop

PokerStars Hand #1109334808: Omaha Pot Limit ($200/$400 USD) - 2020/10/23 13:44:32 ET
Table 'ADA722387266' 6-max Seat #5 is the button
Seat 1: Lock2k16 ($83762 in chips)
Seat 2: TurnOnTuneInDropOut ($56255 in chips)
Seat 3: slotmachine ($47800 in chips)
Seat 4: XirT ($16825 in chips)
Seat 5: kimjongun ($29367 in chips)
Seat 6: vaibz16 ($11713 in chips)
vaibz16: posts small blind $200
Lock2k16: posts big blind $400
*** HOLE CARDS ***
Dealt to TurnOnTuneInDropOut [6c 5d 3s Ts]
TurnOnTuneInDropOut: folds
slotmachine: raises $1000 to $1400
XirT: folds
kimjongun: folds
vaibz16: folds
Lock2k16: calls $1000
*** FLOP *** [Ah 9d 8h]
Lock2k16: checks
slotmachine: checks
*** TURN *** [Ah 9d 8h] [7c]
Lock2k16: bets $2250
slotmachine: folds
Uncalled bet ($2250) returned to Lock2k16
Lock2k16 collected $2880 from pot
Lock2k16: doesn't show hand
*** SUMMARY ***
Total pot $3000 | Rake $120
Board [Ah 9d 8h 7c]
Seat 1: Lock2k16 (big blind) collected ($2880)
Seat 2: TurnOnTuneInDropOut folded before Flop (didn't bet)
Seat 3: slotmachine folded on the Turn
Seat 4: XirT folded before Flop (didn't bet)
Seat 5: kimjongun (button) folded before Flop (didn't bet)
Seat 6: vaibz16 (small blind) folded before Flop

PokerStars Hand #1109334810: Omaha Pot Limit ($200/$400 USD) - 2020/10/23 13:46:21 ET
Table 'ADA722387266' 6-max Seat #1 is the button
Seat 1: Lock2k16 ($93449 in chips)
Seat 2: TurnOnTuneInDropOut ($50255 in chips)
Seat 3: slotmachine ($46400 in chips)
Seat 4: XirT ($16825 in chips)
Seat 5: kimjongun ($29367 in chips)
Seat 6: vaibz16 ($13288 in chips)
TurnOnTuneInDropOut: posts small blind $200
slotmachine: posts big blind $400
*** HOLE CARDS ***
Dealt to TurnOnTuneInDropOut [Qd 5s 3c Js]
XirT: folds
kimjongun: folds
vaibz16: folds
Lock2k16: raises $400 to $800
TurnOnTuneInDropOut: folds
slotmachine: folds
Uncalled bet ($400) returned to Lock2k16
Lock2k16 collected $1000 from pot
Lock2k16: doesn't show hand
*** SUMMARY ***
Total pot $1000 | Rake $0
Seat 1: Lock2k16 (button) collected ($1000)
Seat 2: TurnOnTuneInDropOut (small blind) folded before Flop
Seat 3: slotmachine (big blind) folded before Flop
Seat 4: XirT folded before Flop (didn't bet)
Seat 5: kimjongun folded before Flop (didn't bet)
Seat 6: vaibz16 folded before Flop (didn't bet)

PokerStars Hand #1109334811: Omaha Pot Limit ($200/$400 USD) - 2020/10/23 13:46:44 ET
Table 'ADA722387266' 6-max Seat #2 is the button
Seat 1: Lock2k16 ($94049 in chips)
Seat 2: TurnOnTuneInDropOut ($50055 in chips)
Seat 3: slotmachine ($46000 in chips)
Seat 4: XirT ($16825 in chips)
Seat 5: kimjongun ($29367 in chips)
Seat 6: vaibz16 ($13288 in chips)
slotmachine: posts small blind $200
XirT: posts big blind $400
*** HOLE CARDS ***
Dealt to TurnOnTuneInDropOut [Ts 4c 9c Js]
kimjongun: folds
vaibz16: folds
Lock2k16: raises $1000 to $1400
TurnOnTuneInDropOut: folds
slotmachine: raises $3200 to $4600
XirT: folds
Lock2k16: folds
Uncalled bet ($3200) returned to slotmachine
slotmachine collected $3200 from pot
slotmachine: doesn't show hand
*** SUMMARY ***
Total pot $3200 | Rake $0
Seat 1: Lock2k16 folded before Flop
Seat 2: TurnOnTuneInDropOut (button) folded before Flop (didn't bet)
Seat 3: slotmachine (small blind) collected ($3200)
Seat 4: XirT (big blind) folded before Flop
Seat 5: kimjongun folded before Flop (didn't bet)
Seat 6: vaibz16 folded before Flop (didn't bet)

PokerStars Hand #1109334812: Omaha Pot Limit ($200/$400 USD) - 2020/10/23 13:47:21 ET
Table 'ADA722387266' 6-max Seat #3 is the button
Seat 1: Lock2k16 ($92649 in chips)
Seat 2: TurnOnTuneInDropOut ($50055 in chips)
Seat 3: slotmachine ($47800 in chips)
Seat 4: XirT ($16425 in chips)
Seat 5: kimjongun ($29367 in chips)
Seat 6: vaibz16 ($13288 in chips)
XirT: posts small blind $200
kimjongun: posts big blind $400
*** HOLE CARDS ***
Dealt to TurnOnTuneInDropOut [3s 9d 4c Jh]
vaibz16: raises $1000 to $1400
Lock2k16: folds
TurnOnTuneInDropOut: folds
slotmachine: folds
XirT: calls $1200
kimjongun: folds
*** FLOP *** [Ks 2c 6d]
XirT: checks
vaibz16: bets $1600
XirT: calls $1600
*** TURN *** [Ks 2c 6d] [7c]
XirT: checks
vaibz16: checks
*** RIVER *** [Ks 2c 6d 7c] [As]
XirT: checks
vaibz16: bets $4800
XirT: folds
Uncalled bet ($4800) returned to vaibz16
vaibz16 collected $6143 from pot
vaibz16: doesn't show hand
*** SUMMARY ***
Total pot $6400 | Rake $257
Board [Ks 2c 6d 7c As]
Seat 1: Lock2k16 folded before Flop (didn't bet)
Seat 2: TurnOnTuneInDropOut folded before Flop (didn't bet)
Seat 3: slotmachine (button) folded before Flop (didn't bet)
Seat 4: XirT (small blind) folded on the River
Seat 5: kimjongun (big blind) folded before Flop
Seat 6: vaibz16 collected ($6143)

PokerStars Hand #1109334813: Omaha Pot Limit ($200/$400 USD) - 2020/10/23 13:48:17 ET
Table 'ADA722387266' 6-max Seat #4 is the button
Seat 2: TurnOnTuneInDropOut ($50055 in chips)
Seat 3: slotmachine ($47800 in chips)
Seat 4: XirT ($13425 in chips)
Seat 5: kimjongun ($28967 in chips)
Seat 6: vaibz16 ($16431 in chips)
kimjongun: posts small blind $200
vaibz16: posts big blind $400
*** HOLE CARDS ***
Dealt to TurnOnTuneInDropOut [Qh 8h Kc 4c]
TurnOnTuneInDropOut: raises $1000 to $1400
slotmachine: folds
XirT: folds
kimjongun: folds
vaibz16: calls $1000
*** FLOP *** [6d Ts Th]
vaibz16: checks
TurnOnTuneInDropOut: bets $990
vaibz16: calls $990
*** TURN *** [6d Ts Th] [2d]
vaibz16: checks
TurnOnTuneInDropOut: checks
*** RIVER *** [6d Ts Th 2d] [Jh]
vaibz16: checks
TurnOnTuneInDropOut: checks
*** SHOW DOWN ***
vaibz16: shows [Qs 6s 8c 9s]
vaibz16 collected $4780 from pot
*** SUMMARY ***
Total pot $4980 | Rake $200
Board [6d Ts Th 2d Jh]
Seat 2: TurnOnTuneInDropOut
Seat 3: slotmachine folded before Flop (didn't bet)
Seat 4: XirT (button) folded before Flop (didn't bet)
Seat 5: kimjongun (small blind) folded before Flop
Seat 6: vaibz16 (big blind) showed [Qs 6s 8c 9s] and won ($4780)

PokerStars Hand #1109334814: Omaha Pot Limit ($200/$400 USD) - 2020/10/23 13:49:09 ET
Table 'ADA722387266' 6-max Seat #5 is the button
Seat 1: soundfsilenz ($42000 in chips)
Seat 2: TurnOnTuneInDropOut ($47665 in chips)
Seat 3: slotmachine ($47800 in chips)
Seat 4: XirT ($13425 in chips)
Seat 5: kimjongun ($28767 in chips)
Seat 6: vaibz16 ($18821 in chips)
vaibz16: posts small blind $200
soundfsilenz: posts big blind $400
*** HOLE CARDS ***
Dealt to TurnOnTuneInDropOut [9d Tc 2s Qd]
TurnOnTuneInDropOut: folds
slotmachine: folds
XirT: folds
kimjongun: folds
vaibz16: raises $800 to $1200
soundfsilenz: folds
Uncalled bet ($800) returned to vaibz16
vaibz16 collected $800 from pot
vaibz16: doesn't show hand
*** SUMMARY ***
Total pot $800 | Rake $0
Seat 1: soundfsilenz (big blind) folded before Flop
Seat 2: TurnOnTuneInDropOut folded before Flop (didn't bet)
Seat 3: slotmachine folded before Flop (didn't bet)
Seat 4: XirT folded before Flop (didn't bet)
Seat 5: kimjongun (button) folded before Flop (didn't bet)
Seat 6: vaibz16 (small blind) collected ($800)

PokerStars Hand #1109334815: Omaha Pot Limit ($200/$400 USD) - 2020/10/23 13:49:39 ET
Table 'ADA722387266' 6-max Seat #6 is the button
Seat 1: soundfsilenz ($41600 in chips)
Seat 2: TurnOnTuneInDropOut ($47665 in chips)
Seat 3: slotmachine ($47800 in chips)
Seat 4: XirT ($13425 in chips)
Seat 5: kimjongun ($28767 in chips)
Seat 6: vaibz16 ($19221 in chips)
soundfsilenz: posts small blind $200
TurnOnTuneInDropOut: posts big blind $400
*** HOLE CARDS ***
Dealt to TurnOnTuneInDropOut [9s 6h 6s 8d]
slotmachine: raises $1000 to $1400
XirT: calls $1400
kimjongun: folds
vaibz16: folds
soundfsilenz: raises $4600 to $6000
TurnOnTuneInDropOut: folds
slotmachine: folds
XirT: calls $4600
*** FLOP *** [5s 9d Jc]
soundfsilenz: bets $9246
XirT: calls $7425 and is all-in
Uncalled bet ($1821) returned to soundfsilenz
*** TURN *** [5s 9d Jc] [8h]
*** RIVER *** [5s 9d Jc 8h] [5d]
*** SHOW DOWN ***
soundfsilenz: shows [Ah 8c Ac 2d]
XirT: shows [Jh 6c Kc Ts]
soundfsilenz collected $27850 from pot
*** SUMMARY ***
Total pot $28650 | Rake $800
Board [5s 9d Jc 8h 5d]
Seat 1: soundfsilenz (small blind) showed [Ah 8c Ac 2d] and won ($27850)
Seat 2: TurnOnTuneInDropOut (big blind) folded before Flop
Seat 3: slotmachine folded before Flop
Seat 4: XirT showed [Jh 6c Kc Ts] and lost
Seat 5: kimjongun folded before Flop (didn't bet)
Seat 6: vaibz16 (button) folded before Flop (didn't bet)

PokerStars Hand #1109334816: Omaha Pot Limit ($200/$400 USD) - 2020/10/23 13:50:33 ET
Table 'ADA722387266' 6-max Seat #1 is the button
Seat 1: soundfsilenz ($56025 in chips)
Seat 2: TurnOnTuneInDropOut ($47265 in chips)
Seat 3: slotmachine ($46400 in chips)
Seat 5: kimjongun ($28767 in chips)
Seat 6: vaibz16 ($19221 in chips)
TurnOnTuneInDropOut: posts small blind $200
slotmachine: posts big blind $400
*** HOLE CARDS ***
Dealt to TurnOnTuneInDropOut [7s Qc Ts 9h]
kimjongun: folds
vaibz16: folds
soundfsilenz: folds
TurnOnTuneInDropOut: raises $800 to $1200
slotmachine: calls $800
*** FLOP *** [Tc 4s 3s]
TurnOnTuneInDropOut: checks
slotmachine: checks
*** TURN *** [Tc 4s 3s] [5d]
TurnOnTuneInDropOut: checks
slotmachine: checks
*** RIVER *** [Tc 4s 3s 5d] [3h]
TurnOnTuneInDropOut: checks
slotmachine: checks
*** SHOW DOWN ***
TurnOnTuneInDropOut: shows [7s Qc Ts 9h]
slotmachine: mucks hand
TurnOnTuneInDropOut collected $2304 from pot
*** SUMMARY ***
Total pot $2400 | Rake $96
Board [Tc 4s 3s 5d 3h]
Seat 1: soundfsilenz (button) folded before Flop (didn't bet)
Seat 2: TurnOnTuneInDropOut (small blind) showed [7s Qc Ts 9h] and won ($2304)
Seat 3: slotmachine (big blind) mucked
Seat 5: kimjongun folded before Flop (didn't bet)
Seat 6: vaibz16 folded before Flop (didn't bet)

PokerStars Hand #1109334817: Omaha Pot Limit ($200/$400 USD) - 2020/10/23 13:51:11 ET
Table 'ADA722387266' 6-max Seat #2 is the button
Seat 1: soundfsilenz ($56025 in chips)
Seat 2: TurnOnTuneInDropOut ($48369 in chips)
Seat 3: slotmachine ($45200 in chips)
Seat 4: Sam565 ($12462 in chips)
Seat 5: kimjongun ($28767 in chips)
Seat 6: vaibz16 ($19221 in chips)
slotmachine: posts small blind $200
Sam565: posts big blind $400
*** HOLE CARDS ***
Dealt to TurnOnTuneInDropOut [8s 4h Ac 8d]
kimjongun: folds
vaibz16: raises $1000 to $1400
soundfsilenz: raises $3400 to $4800
TurnOnTuneInDropOut: folds
slotmachine: folds
Sam565: calls $4400
vaibz16: calls $3400
*** FLOP *** [8h 4c 9c]
Sam565: bets $7662 and is all-in
vaibz16: calls $7662
soundfsilenz: raises $7662 to $15324
vaibz16: calls $6759 and is all-in
Uncalled bet ($903) returned to soundfsilenz
*** TURN *** [8h 4c 9c] [3h]
*** RIVER *** [8h 4c 9c 3h] [3s]
*** SHOW DOWN ***
vaibz16: shows [Th Jh Kd Td]
soundfsilenz: shows [Jd Tc Ah Qc]
vaibz16 collected $13518 from side pot
Sam565: shows [7h 9s Kh Kc]
Sam565 collected $36786 from main pot
*** SUMMARY ***
Total pot $51104 Main pot $36786. Side pot $13518. | Rake $800
Board [8h 4c 9c 3h 3s]
Seat 1: soundfsilenz showed [Jd Tc Ah Qc] and lost
Seat 2: TurnOnTuneInDropOut (button) folded before Flop (didn't bet)
Seat 3: slotmachine (small blind) folded before Flop
Seat 4: Sam565 (big blind) showed [7h 9s Kh Kc] and won ($36786)
Seat 5: kimjongun folded before Flop (didn't bet)
Seat 6: vaibz16 showed [Th Jh Kd Td] and won ($13518)

PokerStars Hand #1109334841: Omaha Pot Limit ($200/$400 USD) - 2020/10/23 14:12:06 ET
Table 'ADA722387266' 6-max Seat #4 is the button
Seat 1: soundfsilenz ($45605 in chips)
Seat 2: gaganhyd ($16539 in chips)
Seat 3: slotmachine ($43000 in chips)
Seat 4: mangeshnc ($19959 in chips)
Seat 5: kimjongun ($22926 in chips)
Seat 6: TurnOnTuneInDropOut ($48369 in chips)
kimjongun: posts small blind $200
TurnOnTuneInDropOut: posts big blind $400
*** HOLE CARDS ***
Dealt to TurnOnTuneInDropOut [8h 7d Ts 6c]
soundfsilenz: folds
gaganhyd: folds
slotmachine: raises $1000 to $1400
mangeshnc: folds
kimjongun: folds
TurnOnTuneInDropOut: folds
Uncalled bet ($1000) returned to slotmachine
slotmachine collected $1000 from pot
slotmachine: doesn't show hand
*** SUMMARY ***
Total pot $1000 | Rake $0
Seat 1: soundfsilenz folded before Flop (didn't bet)
Seat 2: gaganhyd folded before Flop (didn't bet)
Seat 3: slotmachine collected ($1000)
Seat 4: mangeshnc (button) folded before Flop (didn't bet)
Seat 5: kimjongun (small blind) folded before Flop
Seat 6: TurnOnTuneInDropOut (big blind) folded before Flop

PokerStars Hand #1109334842: Omaha Pot Limit ($200/$400 USD) - 2020/10/23 14:12:44 ET
Table 'ADA722387266' 6-max Seat #5 is the button
Seat 1: soundfsilenz ($45605 in chips)
Seat 2: gaganhyd ($16539 in chips)
Seat 3: slotmachine ($43600 in chips)
Seat 4: mangeshnc ($19959 in chips)
Seat 5: kimjongun ($22726 in chips)
Seat 6: TurnOnTuneInDropOut ($47969 in chips)
TurnOnTuneInDropOut: posts small blind $200
soundfsilenz: posts big blind $400
*** HOLE CARDS ***
Dealt to TurnOnTuneInDropOut [Kc Ts 6h 7h]
gaganhyd: folds
slotmachine: folds
mangeshnc: folds
kimjongun: raises $1000 to $1400
TurnOnTuneInDropOut: folds
soundfsilenz: folds
Uncalled bet ($1000) returned to kimjongun
kimjongun collected $1000 from pot
kimjongun: doesn't show hand
*** SUMMARY ***
Total pot $1000 | Rake $0
Seat 1: soundfsilenz (big blind) folded before Flop
Seat 2: gaganhyd folded before Flop (didn't bet)
Seat 3: slotmachine folded before Flop (didn't bet)
Seat 4: mangeshnc folded before Flop (didn't bet)
Seat 5: kimjongun (button) collected ($1000)
Seat 6: TurnOnTuneInDropOut (small blind) folded before Flop

PokerStars Hand #1109334843: Omaha Pot Limit ($200/$400 USD) - 2020/10/23 14:13:24 ET
Table 'ADA722387266' 6-max Seat #6 is the button
Seat 1: soundfsilenz ($45205 in chips)
Seat 2: gaganhyd ($16539 in chips)
Seat 3: slotmachine ($43600 in chips)
Seat 4: mangeshnc ($19959 in chips)
Seat 5: kimjongun ($23326 in chips)
Seat 6: TurnOnTuneInDropOut ($47769 in chips)
soundfsilenz: posts small blind $200
gaganhyd: posts big blind $400
*** HOLE CARDS ***
Dealt to TurnOnTuneInDropOut [Qc Ah 7d 6c]
slotmachine: raises $1000 to $1400
mangeshnc: folds
kimjongun: folds
TurnOnTuneInDropOut: folds
soundfsilenz: folds
gaganhyd: folds
Uncalled bet ($1000) returned to slotmachine
slotmachine collected $1000 from pot
slotmachine: doesn't show hand
*** SUMMARY ***
Total pot $1000 | Rake $0
Seat 1: soundfsilenz (small blind) folded before Flop
Seat 2: gaganhyd (big blind) folded before Flop
Seat 3: slotmachine collected ($1000)
Seat 4: mangeshnc folded before Flop (didn't bet)
Seat 5: kimjongun folded before Flop (didn't bet)
Seat 6: TurnOnTuneInDropOut (button) folded before Flop (didn't bet)

PokerStars Hand #1109334844: Omaha Pot Limit ($200/$400 USD) - 2020/10/23 14:14:05 ET
Table 'ADA722387266' 6-max Seat #1 is the button
Seat 1: soundfsilenz ($45005 in chips)
Seat 2: gaganhyd ($16139 in chips)
Seat 3: slotmachine ($44200 in chips)
Seat 4: mangeshnc ($19959 in chips)
Seat 5: kimjongun ($23326 in chips)
Seat 6: TurnOnTuneInDropOut ($47769 in chips)
gaganhyd: posts small blind $200
slotmachine: posts big blind $400
*** HOLE CARDS ***
Dealt to TurnOnTuneInDropOut [8h Kc 5d 9s]
mangeshnc: raises $1000 to $1400
kimjongun: folds
TurnOnTuneInDropOut: folds
soundfsilenz: folds
gaganhyd: calls $1200
slotmachine: folds
*** FLOP *** [5c 3s Kh]
gaganhyd: checks
mangeshnc: bets $3200
gaganhyd: raises $9600 to $12800
mangeshnc: calls $9600
*** TURN *** [5c 3s Kh] [7h]
gaganhyd: bets $1939 and is all-in
mangeshnc: calls $1939
*** RIVER *** [5c 3s Kh 7h] [7c]
*** SHOW DOWN ***
gaganhyd: shows [3c 2h 4h Ac]
mangeshnc: shows [Jc 7s Jh 4c]
mangeshnc collected $31878 from pot
*** SUMMARY ***
Total pot $32678 | Rake $800
Board [5c 3s Kh 7h 7c]
Seat 1: soundfsilenz (button) folded before Flop (didn't bet)
Seat 2: gaganhyd (small blind) showed [3c 2h 4h Ac] and lost
Seat 3: slotmachine (big blind) folded before Flop
Seat 4: mangeshnc showed [Jc 7s Jh 4c] and won ($31878)
Seat 5: kimjongun folded before Flop (didn't bet)
Seat 6: TurnOnTuneInDropOut folded before Flop (didn't bet)

PokerStars Hand #1109334845: Omaha Pot Limit ($200/$400 USD) - 2020/10/23 14:15:04 ET
Table 'ADA722387266' 6-max Seat #3 is the button
Seat 1: soundfsilenz ($45005 in chips)
Seat 3: slotmachine ($43800 in chips)
Seat 4: mangeshnc ($35698 in chips)
Seat 5: kimjongun ($23326 in chips)
Seat 6: TurnOnTuneInDropOut ($47769 in chips)
mangeshnc: posts small blind $200
kimjongun: posts big blind $400
*** HOLE CARDS ***
Dealt to TurnOnTuneInDropOut [6h 4h Qc 8c]
TurnOnTuneInDropOut: folds
soundfsilenz: folds
slotmachine: folds
mangeshnc: calls $200
kimjongun: checks
*** FLOP *** [3s 7h 8s]
mangeshnc: checks
kimjongun: checks
*** TURN *** [3s 7h 8s] [6c]
mangeshnc: bets $800
kimjongun: calls $800
*** RIVER *** [3s 7h 8s 6c] [Kh]
mangeshnc: bets $2400
kimjongun: calls $2400
*** SHOW DOWN ***
mangeshnc: shows [4c Ks 5d Ac]
kimjongun: mucks hand
mangeshnc collected $6911 from pot
*** SUMMARY ***
Total pot $7200 | Rake $289
Board [3s 7h 8s 6c Kh]
Seat 1: soundfsilenz folded before Flop (didn't bet)
Seat 3: slotmachine (button) folded before Flop (didn't bet)
Seat 4: mangeshnc (small blind) showed [4c Ks 5d Ac] and won ($6911)
Seat 5: kimjongun (big blind) mucked
Seat 6: TurnOnTuneInDropOut folded before Flop (didn't bet)

PokerStars Hand #1109334846: Omaha Pot Limit ($200/$400 USD) - 2020/10/23 14:16:28 ET
Table 'ADA722387266' 6-max Seat #4 is the button
Seat 1: soundfsilenz ($45005 in chips)
Seat 2: gaganhyd ($20682 in chips)
Seat 3: slotmachine ($43800 in chips)
Seat 4: mangeshnc ($39009 in chips)
Seat 5: kimjongun ($19726 in chips)
Seat 6: TurnOnTuneInDropOut ($47769 in chips)
kimjongun: posts small blind $200
TurnOnTuneInDropOut: posts big blind $400
*** HOLE CARDS ***
Dealt to TurnOnTuneInDropOut [Th Ts Ah 6d]
soundfsilenz: folds
gaganhyd: raises $650 to $1050
slotmachine: calls $1050
mangeshnc: calls $1050
kimjongun: folds
TurnOnTuneInDropOut: calls $650
*** FLOP *** [Js 9d Jd]
TurnOnTuneInDropOut: checks
gaganhyd: checks
slotmachine: checks
mangeshnc: checks
*** TURN *** [Js 9d Jd] [Jh]
TurnOnTuneInDropOut: checks
gaganhyd: checks
slotmachine: checks
mangeshnc: bets $4400
TurnOnTuneInDropOut: folds
gaganhyd: folds
slotmachine: calls $4400
*** RIVER *** [Js 9d Jd Jh] [2s]
slotmachine: checks
mangeshnc: checks
*** SHOW DOWN ***
slotmachine: shows [9s Kh 2c Ks]
mangeshnc: mucks hand
slotmachine collected $12671 from pot
*** SUMMARY ***
Total pot $13200 | Rake $529
Board [Js 9d Jd Jh 2s]
Seat 1: soundfsilenz folded before Flop (didn't bet)
Seat 2: gaganhyd folded on the Turn
Seat 3: slotmachine showed [9s Kh 2c Ks] and won ($12671)
Seat 4: mangeshnc (button) mucked
Seat 5: kimjongun (small blind) folded before Flop
Seat 6: TurnOnTuneInDropOut (big blind) folded on the Turn

PokerStars Hand #1109334850: Omaha Pot Limit ($200/$400 USD) - 2020/10/23 14:20:10 ET
Table 'ADA722387266' 6-max Seat #2 is the button
Seat 1: soundfsilenz ($46285 in chips)
Seat 2: gaganhyd ($19032 in chips)
Seat 3: slotmachine ($50621 in chips)
Seat 4: mangeshnc ($33279 in chips)
Seat 5: kimjongun ($19526 in chips)
Seat 6: TurnOnTuneInDropOut ($46519 in chips)
slotmachine: posts small blind $200
mangeshnc: posts big blind $400
*** HOLE CARDS ***
Dealt to TurnOnTuneInDropOut [Jc 9h 5h Kh]
kimjongun: raises $600 to $1000
TurnOnTuneInDropOut: folds
soundfsilenz: folds
gaganhyd: folds
slotmachine: folds
mangeshnc: calls $600
*** FLOP *** [4h Td Js]
mangeshnc: checks
kimjongun: bets $1452
mangeshnc: calls $1452
*** TURN *** [4h Td Js] [7d]
mangeshnc: checks
kimjongun: bets $3828
mangeshnc: calls $3828
*** RIVER *** [4h Td Js 7d] [6d]
mangeshnc: bets $12760
kimjongun: raises $486 to $13246 and is all-in
mangeshnc: calls $486
*** SHOW DOWN ***
mangeshnc: shows [Ad 3c Tc 3d]
kimjongun: shows [9d 9c Qd 7c]
mangeshnc collected $38452 from pot
*** SUMMARY ***
Total pot $39252 | Rake $800
Board [4h Td Js 7d 6d]
Seat 1: soundfsilenz folded before Flop (didn't bet)
Seat 2: gaganhyd (button) folded before Flop (didn't bet)
Seat 3: slotmachine (small blind) folded before Flop
Seat 4: mangeshnc (big blind) showed [Ad 3c Tc 3d] and won ($38452)
Seat 5: kimjongun showed [9d 9c Qd 7c] and lost
Seat 6: TurnOnTuneInDropOut folded before Flop (didn't bet)

PokerStars Hand #1109334851: Omaha Pot Limit ($200/$400 USD) - 2020/10/23 14:21:13 ET
Table 'ADA722387266' 6-max Seat #3 is the button
Seat 1: soundfsilenz ($46285 in chips)
Seat 2: gaganhyd ($19032 in chips)
Seat 3: slotmachine ($50421 in chips)
Seat 4: mangeshnc ($52205 in chips)
Seat 5: kimjongun ($27462 in chips)
Seat 6: TurnOnTuneInDropOut ($46519 in chips)
mangeshnc: posts small blind $200
kimjongun: posts big blind $400
*** HOLE CARDS ***
Dealt to TurnOnTuneInDropOut [Jd 4s Qc 5s]
TurnOnTuneInDropOut: folds
soundfsilenz: raises $1000 to $1400
gaganhyd: folds
slotmachine: raises $3400 to $4800
mangeshnc: folds
kimjongun: folds
soundfsilenz: folds
Uncalled bet ($3400) returned to slotmachine
slotmachine collected $3400 from pot
slotmachine: doesn't show hand
*** SUMMARY ***
Total pot $3400 | Rake $0
Seat 1: soundfsilenz folded before Flop
Seat 2: gaganhyd folded before Flop (didn't bet)
Seat 3: slotmachine (button) collected ($3400)
Seat 4: mangeshnc (small blind) folded before Flop
Seat 5: kimjongun (big blind) folded before Flop
Seat 6: TurnOnTuneInDropOut folded before Flop (didn't bet)

PokerStars Hand #1109334854: Omaha Pot Limit ($200/$400 USD) - 2020/10/23 14:23:30 ET
Table 'ADA722387266' 6-max Seat #6 is the button
Seat 1: soundfsilenz ($44485 in chips)
Seat 2: gaganhyd ($19032 in chips)
Seat 3: slotmachine ($52421 in chips)
Seat 4: mangeshnc ($52414 in chips)
Seat 5: kimjongun ($26862 in chips)
Seat 6: TurnOnTuneInDropOut ($46400 in chips)
soundfsilenz: posts small blind $200
gaganhyd: posts big blind $400
*** HOLE CARDS ***
Dealt to TurnOnTuneInDropOut [8h Jc 5d Kd]
slotmachine: folds
mangeshnc: folds
kimjongun: folds
TurnOnTuneInDropOut: folds
soundfsilenz: raises $800 to $1200
gaganhyd: calls $800
*** FLOP *** [4h 9s 5c]
soundfsilenz: bets $1608
gaganhyd: calls $1608
*** TURN *** [4h 9s 5c] [Qs]
soundfsilenz: checks
gaganhyd: checks
*** RIVER *** [4h 9s 5c Qs] [Jd]
soundfsilenz: checks
gaganhyd: bets $4212
soundfsilenz: calls $4212
*** SHOW DOWN ***
soundfsilenz: mucks hand
gaganhyd: shows [Kc Ts 8c 6d]
gaganhyd collected $13477 from pot
*** SUMMARY ***
Total pot $14040 | Rake $563
Board [4h 9s 5c Qs Jd]
Seat 1: soundfsilenz (small blind) mucked
Seat 2: gaganhyd (big blind) showed [Kc Ts 8c 6d] and won ($13477)
Seat 3: slotmachine folded before Flop (didn't bet)
Seat 4: mangeshnc folded before Flop (didn't bet)
Seat 5: kimjongun folded before Flop (didn't bet)
Seat 6: TurnOnTuneInDropOut (button) folded before Flop (didn't bet)

PokerStars Hand #1109334855: Omaha Pot Limit ($200/$400 USD) - 2020/10/23 14:24:47 ET
Table 'ADA722387266' 6-max Seat #1 is the button
Seat 1: soundfsilenz ($37465 in chips)
Seat 2: gaganhyd ($25489 in chips)
Seat 3: slotmachine ($52421 in chips)
Seat 4: mangeshnc ($52414 in chips)
Seat 5: kimjongun ($26862 in chips)
Seat 6: TurnOnTuneInDropOut ($46400 in chips)
gaganhyd: posts small blind $200
slotmachine: posts big blind $400
*** HOLE CARDS ***
Dealt to TurnOnTuneInDropOut [2s Th 4c As]
mangeshnc: folds
kimjongun: folds
TurnOnTuneInDropOut: folds
soundfsilenz: folds
gaganhyd: folds
Uncalled bet ($200) returned to slotmachine
slotmachine collected $400 from pot
slotmachine: doesn't show hand
*** SUMMARY ***
Total pot $400 | Rake $0
Seat 1: soundfsilenz (button) folded before Flop (didn't bet)
Seat 2: gaganhyd (small blind) folded before Flop
Seat 3: slotmachine (big blind) collected ($400)
Seat 4: mangeshnc folded before Flop (didn't bet)
Seat 5: kimjongun folded before Flop (didn't bet)
Seat 6: TurnOnTuneInDropOut folded before Flop (didn't bet)

PokerStars Hand #1109334856: Omaha Pot Limit ($200/$400 USD) - 2020/10/23 14:25:14 ET
Table 'ADA722387266' 6-max Seat #2 is the button
Seat 1: soundfsilenz ($37465 in chips)
Seat 2: gaganhyd ($25289 in chips)
Seat 3: slotmachine ($52621 in chips)
Seat 4: mangeshnc ($52414 in chips)
Seat 5: kimjongun ($26862 in chips)
Seat 6: TurnOnTuneInDropOut ($46400 in chips)
slotmachine: posts small blind $200
mangeshnc: posts big blind $400
*** HOLE CARDS ***
Dealt to TurnOnTuneInDropOut [2h 4d 6s 3h]
kimjongun: folds
TurnOnTuneInDropOut: folds
soundfsilenz: folds
gaganhyd: folds
slotmachine: raises $800 to $1200
mangeshnc: folds
Uncalled bet ($800) returned to slotmachine
slotmachine collected $800 from pot
slotmachine: doesn't show hand
*** SUMMARY ***
Total pot $800 | Rake $0
Seat 1: soundfsilenz folded before Flop (didn't bet)
Seat 2: gaganhyd (button) folded before Flop (didn't bet)
Seat 3: slotmachine (small blind) collected ($800)
Seat 4: mangeshnc (big blind) folded before Flop
Seat 5: kimjongun folded before Flop (didn't bet)
Seat 6: TurnOnTuneInDropOut folded before Flop (didn't bet)

PokerStars Hand #1109334857: Omaha Pot Limit ($200/$400 USD) - 2020/10/23 14:26:01 ET
Table 'ADA722387266' 6-max Seat #3 is the button
Seat 1: soundfsilenz ($37465 in chips)
Seat 2: gaganhyd ($25289 in chips)
Seat 3: slotmachine ($53021 in chips)
Seat 4: mangeshnc ($52014 in chips)
Seat 5: kimjongun ($26862 in chips)
Seat 6: TurnOnTuneInDropOut ($46400 in chips)
mangeshnc: posts small blind $200
kimjongun: posts big blind $400
*** HOLE CARDS ***
Dealt to TurnOnTuneInDropOut [Ah 2d 3s Kc]
TurnOnTuneInDropOut: folds
soundfsilenz: raises $1000 to $1400
gaganhyd: calls $1400
slotmachine: folds
mangeshnc: folds
kimjongun: folds
*** FLOP *** [7d 6h 5c]
soundfsilenz: checks
gaganhyd: checks
*** TURN *** [7d 6h 5c] [Th]
soundfsilenz: checks
gaganhyd: bets $1700
soundfsilenz: raises $4760 to $6460
gaganhyd: raises $16320 to $22780
soundfsilenz: folds
Uncalled bet ($16320) returned to gaganhyd
gaganhyd collected $15666 from pot
gaganhyd: doesn't show hand
*** SUMMARY ***
Total pot $16320 | Rake $654
Board [7d 6h 5c Th]
Seat 1: soundfsilenz folded on the Turn
Seat 2: gaganhyd collected ($15666)
Seat 3: slotmachine (button) folded before Flop (didn't bet)
Seat 4: mangeshnc (small blind) folded before Flop
Seat 5: kimjongun (big blind) folded before Flop
Seat 6: TurnOnTuneInDropOut folded before Flop (didn't bet)

PokerStars Hand #1109334859: Omaha Pot Limit ($200/$400 USD) - 2020/10/23 14:28:34 ET
Table 'ADA722387266' 6-max Seat #6 is the button
Seat 1: soundfsilenz ($29205 in chips)
Seat 2: gaganhyd ($33095 in chips)
Seat 3: slotmachine ($53021 in chips)
Seat 4: mangeshnc ($53294 in chips)
Seat 6: TurnOnTuneInDropOut ($45208 in chips)
soundfsilenz: posts small blind $200
gaganhyd: posts big blind $400
*** HOLE CARDS ***
Dealt to TurnOnTuneInDropOut [3h 2h 9s 3c]
slotmachine: folds
mangeshnc: folds
TurnOnTuneInDropOut: folds
soundfsilenz: folds
Uncalled bet ($200) returned to gaganhyd
gaganhyd collected $400 from pot
gaganhyd: doesn't show hand
*** SUMMARY ***
Total pot $400 | Rake $0
Seat 1: soundfsilenz (small blind) folded before Flop
Seat 2: gaganhyd (big blind) collected ($400)
Seat 3: slotmachine folded before Flop (didn't bet)
Seat 4: mangeshnc folded before Flop (didn't bet)
Seat 6: TurnOnTuneInDropOut (button) folded before Flop (didn't bet)

PokerStars Hand #1109334860: Omaha Pot Limit ($200/$400 USD) - 2020/10/23 14:28:56 ET
Table 'ADA722387266' 6-max Seat #1 is the button
Seat 1: soundfsilenz ($29005 in chips)
Seat 2: gaganhyd ($33295 in chips)
Seat 3: slotmachine ($53021 in chips)
Seat 4: mangeshnc ($53294 in chips)
Seat 6: TurnOnTuneInDropOut ($45208 in chips)
gaganhyd: posts small blind $200
slotmachine: posts big blind $400
*** HOLE CARDS ***
Dealt to TurnOnTuneInDropOut [6d Kd Td Th]
mangeshnc: folds
TurnOnTuneInDropOut: folds
soundfsilenz: folds
gaganhyd: folds
Uncalled bet ($200) returned to slotmachine
slotmachine collected $400 from pot
slotmachine: doesn't show hand
*** SUMMARY ***
Total pot $400 | Rake $0
Seat 1: soundfsilenz (button) folded before Flop (didn't bet)
Seat 2: gaganhyd (small blind) folded before Flop
Seat 3: slotmachine (big blind) collected ($400)
Seat 4: mangeshnc folded before Flop (didn't bet)
Seat 6: TurnOnTuneInDropOut folded before Flop (didn't bet)

PokerStars Hand #1109334861: Omaha Pot Limit ($200/$400 USD) - 2020/10/23 14:29:29 ET
Table 'ADA722387266' 6-max Seat #2 is the button
Seat 1: soundfsilenz ($29005 in chips)
Seat 2: gaganhyd ($33095 in chips)
Seat 3: slotmachine ($53221 in chips)
Seat 4: mangeshnc ($53294 in chips)
Seat 6: TurnOnTuneInDropOut ($45208 in chips)
slotmachine: posts small blind $200
mangeshnc: posts big blind $400
*** HOLE CARDS ***
Dealt to TurnOnTuneInDropOut [2h 9c 4c Th]
TurnOnTuneInDropOut: folds
soundfsilenz: folds
gaganhyd: folds
slotmachine: folds
Uncalled bet ($200) returned to mangeshnc
mangeshnc collected $400 from pot
mangeshnc: doesn't show hand
*** SUMMARY ***
Total pot $400 | Rake $0
Seat 1: soundfsilenz folded before Flop (didn't bet)
Seat 2: gaganhyd (button) folded before Flop (didn't bet)
Seat 3: slotmachine (small blind) folded before Flop
Seat 4: mangeshnc (big blind) collected ($400)
Seat 6: TurnOnTuneInDropOut folded before Flop (didn't bet)

PokerStars Hand #1109334862: Omaha Pot Limit ($200/$400 USD) - 2020/10/23 14:29:43 ET
Table 'ADA722387266' 6-max Seat #3 is the button
Seat 1: soundfsilenz ($29005 in chips)
Seat 2: gaganhyd ($33095 in chips)
Seat 3: slotmachine ($53021 in chips)
Seat 4: mangeshnc ($53494 in chips)
Seat 5: kimjongun ($26462 in chips)
Seat 6: TurnOnTuneInDropOut ($45208 in chips)
mangeshnc: posts small blind $200
kimjongun: posts big blind $400
*** HOLE CARDS ***
Dealt to TurnOnTuneInDropOut [5c 9h Ah 2d]
TurnOnTuneInDropOut: folds
soundfsilenz: folds
gaganhyd: folds
slotmachine: raises $1000 to $1400
mangeshnc: calls $1200
kimjongun: folds
*** FLOP *** [9d 4d 3c]
mangeshnc: checks
slotmachine: bets $3200
mangeshnc: calls $3200
*** TURN *** [9d 4d 3c] [5d]
mangeshnc: checks
slotmachine: bets $9600
mangeshnc: folds
Uncalled bet ($9600) returned to slotmachine
slotmachine collected $9215 from pot
slotmachine: doesn't show hand
*** SUMMARY ***
Total pot $9600 | Rake $385
Board [9d 4d 3c 5d]
Seat 1: soundfsilenz folded before Flop (didn't bet)
Seat 2: gaganhyd folded before Flop (didn't bet)
Seat 3: slotmachine (button) collected ($9215)
Seat 4: mangeshnc (small blind) folded on the Turn
Seat 5: kimjongun (big blind) folded before Flop
Seat 6: TurnOnTuneInDropOut folded before Flop (didn't bet)

PokerStars Hand #1109334864: Omaha Pot Limit ($200/$400 USD) - 2020/10/23 14:32:37 ET
Table 'ADA722387266' 6-max Seat #5 is the button
Seat 1: soundfsilenz ($29005 in chips)
Seat 2: gaganhyd ($27645 in chips)
Seat 3: slotmachine ($48000 in chips)
Seat 4: mangeshnc ($47844 in chips)
Seat 5: kimjongun ($25862 in chips)
Seat 6: TurnOnTuneInDropOut ($96316 in chips)
TurnOnTuneInDropOut: posts small blind $200
soundfsilenz: posts big blind $400
*** HOLE CARDS ***
Dealt to TurnOnTuneInDropOut [3c Qs 6h Ad]
gaganhyd: folds
slotmachine: folds
mangeshnc: raises $1000 to $1400
kimjongun: calls $1400
TurnOnTuneInDropOut: folds
soundfsilenz: folds
*** FLOP *** [8c 5h 4s]
mangeshnc: bets $3400
kimjongun: calls $3400
*** TURN *** [8c 5h 4s] [9d]
mangeshnc: checks
kimjongun: checks
*** RIVER *** [8c 5h 4s 9d] [Ts]
mangeshnc: bets $10200
kimjongun: raises $10862 to $21062 and is all-in
mangeshnc: calls $10862
*** SHOW DOWN ***
mangeshnc: shows [Jc Qc Qh Kc]
kimjongun: shows [Jh 7s Th Jd]
mangeshnc collected $51524 from pot
*** SUMMARY ***
Total pot $52324 | Rake $800
Board [8c 5h 4s 9d Ts]
Seat 1: soundfsilenz (big blind) folded before Flop
Seat 2: gaganhyd folded before Flop (didn't bet)
Seat 3: slotmachine folded before Flop (didn't bet)
Seat 4: mangeshnc showed [Jc Qc Qh Kc] and won ($51524)
Seat 5: kimjongun (button) showed [Jh 7s Th Jd] and lost
Seat 6: TurnOnTuneInDropOut (small blind) folded before Flop

PokerStars Hand #1109334865: Omaha Pot Limit ($200/$400 USD) - 2020/10/23 14:33:55 ET
Table 'ADA722387266' 6-max Seat #6 is the button
Seat 1: soundfsilenz ($28605 in chips)
Seat 2: gaganhyd ($27645 in chips)
Seat 3: slotmachine ($48000 in chips)
Seat 4: mangeshnc ($73506 in chips)
Seat 6: TurnOnTuneInDropOut ($96116 in chips)
soundfsilenz: posts small blind $200
gaganhyd: posts big blind $400
*** HOLE CARDS ***
Dealt to TurnOnTuneInDropOut [4s Jd 5s 8h]
slotmachine: folds
mangeshnc: folds
TurnOnTuneInDropOut: folds
soundfsilenz: folds
Uncalled bet ($200) returned to gaganhyd
gaganhyd collected $400 from pot
gaganhyd: doesn't show hand
*** SUMMARY ***
Total pot $400 | Rake $0
Seat 1: soundfsilenz (small blind) folded before Flop
Seat 2: gaganhyd (big blind) collected ($400)
Seat 3: slotmachine folded before Flop (didn't bet)
Seat 4: mangeshnc folded before Flop (didn't bet)
Seat 6: TurnOnTuneInDropOut (button) folded before Flop (didn't bet)

PokerStars Hand #1109334866: Omaha Pot Limit ($200/$400 USD) - 2020/10/23 14:34:16 ET
Table 'ADA722387266' 6-max Seat #1 is the button
Seat 1: soundfsilenz ($28405 in chips)
Seat 2: gaganhyd ($27845 in chips)
Seat 3: slotmachine ($48000 in chips)
Seat 4: mangeshnc ($73506 in chips)
Seat 6: TurnOnTuneInDropOut ($96116 in chips)
gaganhyd: posts small blind $200
slotmachine: posts big blind $400
*** HOLE CARDS ***
Dealt to TurnOnTuneInDropOut [6d 5h 6s Th]
mangeshnc: folds
TurnOnTuneInDropOut: folds
soundfsilenz: folds
gaganhyd: folds
Uncalled bet ($200) returned to slotmachine
slotmachine collected $400 from pot
slotmachine: doesn't show hand
*** SUMMARY ***
Total pot $400 | Rake $0
Seat 1: soundfsilenz (button) folded before Flop (didn't bet)
Seat 2: gaganhyd (small blind) folded before Flop
Seat 3: slotmachine (big blind) collected ($400)
Seat 4: mangeshnc folded before Flop (didn't bet)
Seat 6: TurnOnTuneInDropOut folded before Flop (didn't bet)

PokerStars Hand #1109334867: Omaha Pot Limit ($200/$400 USD) - 2020/10/23 14:34:42 ET
Table 'ADA722387266' 6-max Seat #2 is the button
Seat 1: soundfsilenz ($28405 in chips)
Seat 2: gaganhyd ($27645 in chips)
Seat 3: slotmachine ($48200 in chips)
Seat 4: mangeshnc ($73506 in chips)
Seat 6: TurnOnTuneInDropOut ($96116 in chips)
slotmachine: posts small blind $200
mangeshnc: posts big blind $400
*** HOLE CARDS ***
Dealt to TurnOnTuneInDropOut [4s 6s 9h 2h]
TurnOnTuneInDropOut: folds
soundfsilenz: raises $1000 to $1400
gaganhyd: calls $1400
slotmachine: calls $1200
mangeshnc: calls $1000
*** FLOP *** [3c 8c Kh]
slotmachine: checks
mangeshnc: checks
soundfsilenz: checks
gaganhyd: bets $2800
slotmachine: folds
mangeshnc: calls $2800
soundfsilenz: folds
*** TURN *** [3c 8c Kh] [8d]
mangeshnc: checks
gaganhyd: bets $4904
mangeshnc: calls $4904
*** RIVER *** [3c 8c Kh 8d] [4d]
mangeshnc: checks
gaganhyd: bets $9409
mangeshnc: folds
Uncalled bet ($9409) returned to gaganhyd
gaganhyd collected $20208 from pot
gaganhyd: doesn't show hand
*** SUMMARY ***
Total pot $21008 | Rake $800
Board [3c 8c Kh 8d 4d]
Seat 1: soundfsilenz folded on the Flop
Seat 2: gaganhyd (button) collected ($20208)
Seat 3: slotmachine (small blind) folded on the Flop
Seat 4: mangeshnc (big blind) folded on the River
Seat 6: TurnOnTuneInDropOut folded before Flop (didn't bet)

PokerStars Hand #1109334868: Omaha Pot Limit ($200/$400 USD) - 2020/10/23 14:36:16 ET
Table 'ADA722387266' 6-max Seat #3 is the button
Seat 1: soundfsilenz ($27005 in chips)
Seat 2: gaganhyd ($38749 in chips)
Seat 3: slotmachine ($46800 in chips)
Seat 4: mangeshnc ($64402 in chips)
Seat 5: kimjongun ($28001 in chips)
Seat 6: TurnOnTuneInDropOut ($96116 in chips)
mangeshnc: posts small blind $200
kimjongun: posts big blind $400
*** HOLE CARDS ***
Dealt to TurnOnTuneInDropOut [3h Tc 9c Ah]
TurnOnTuneInDropOut: folds
soundfsilenz: folds
gaganhyd: raises $1000 to $1400
slotmachine: folds
mangeshnc: calls $1200
kimjongun: folds
*** FLOP *** [4s As 9h]
mangeshnc: bets $3200
gaganhyd: folds
Uncalled bet ($3200) returned to mangeshnc
mangeshnc collected $3072 from pot
mangeshnc: doesn't show hand
*** SUMMARY ***
Total pot $3200 | Rake $128
Board [4s As 9h]
Seat 1: soundfsilenz folded before Flop (didn't bet)
Seat 2: gaganhyd folded on the Flop
Seat 3: slotmachine (button) folded before Flop (didn't bet)
Seat 4: mangeshnc (small blind) collected ($3072)
Seat 5: kimjongun (big blind) folded before Flop
Seat 6: TurnOnTuneInDropOut folded before Flop (didn't bet)

PokerStars Hand #1109334869: Omaha Pot Limit ($200/$400 USD) - 2020/10/23 14:37:37 ET
Table 'ADA722387266' 6-max Seat #4 is the button
Seat 1: soundfsilenz ($39006 in chips)
Seat 2: gaganhyd ($37349 in chips)
Seat 3: slotmachine ($46800 in chips)
Seat 4: mangeshnc ($66074 in chips)
Seat 5: kimjongun ($27601 in chips)
Seat 6: TurnOnTuneInDropOut ($96116 in chips)
kimjongun: posts small blind $200
TurnOnTuneInDropOut: posts big blind $400
*** HOLE CARDS ***
Dealt to TurnOnTuneInDropOut [9c 6h 6s 4d]
soundfsilenz: folds
gaganhyd: raises $650 to $1050
slotmachine: folds
mangeshnc: folds
kimjongun: folds
TurnOnTuneInDropOut: folds
Uncalled bet ($650) returned to gaganhyd
gaganhyd collected $1000 from pot
gaganhyd: doesn't show hand
*** SUMMARY ***
Total pot $1000 | Rake $0
Seat 1: soundfsilenz folded before Flop (didn't bet)
Seat 2: gaganhyd collected ($1000)
Seat 3: slotmachine folded before Flop (didn't bet)
Seat 4: mangeshnc (button) folded before Flop (didn't bet)
Seat 5: kimjongun (small blind) folded before Flop
Seat 6: TurnOnTuneInDropOut (big blind) folded before Flop

PokerStars Hand #1109334870: Omaha Pot Limit ($200/$400 USD) - 2020/10/23 14:38:03 ET
Table 'ADA722387266' 6-max Seat #5 is the button
Seat 1: soundfsilenz ($39006 in chips)
Seat 2: gaganhyd ($37949 in chips)
Seat 3: slotmachine ($46800 in chips)
Seat 4: mangeshnc ($66074 in chips)
Seat 5: kimjongun ($27401 in chips)
Seat 6: TurnOnTuneInDropOut ($95716 in chips)
TurnOnTuneInDropOut: posts small blind $200
soundfsilenz: posts big blind $400
*** HOLE CARDS ***
Dealt to TurnOnTuneInDropOut [7d Ac 6d 8c]
gaganhyd: folds
slotmachine: raises $1000 to $1400
mangeshnc: calls $1400
kimjongun: folds
TurnOnTuneInDropOut: folds
soundfsilenz: folds
*** FLOP *** [7c 6c 2d]
slotmachine: checks
mangeshnc: bets $3400
slotmachine: folds
Uncalled bet ($3400) returned to mangeshnc
mangeshnc collected $3264 from pot
mangeshnc: doesn't show hand
*** SUMMARY ***
Total pot $3400 | Rake $136
Board [7c 6c 2d]
Seat 1: soundfsilenz (big blind) folded before Flop
Seat 2: gaganhyd folded before Flop (didn't bet)
Seat 3: slotmachine folded on the Flop
Seat 4: mangeshnc collected ($3264)
Seat 5: kimjongun (button) folded before Flop (didn't bet)
Seat 6: TurnOnTuneInDropOut (small blind) folded before Flop

PokerStars Hand #1109334872: Omaha Pot Limit ($200/$400 USD) - 2020/10/23 14:40:37 ET
Table 'ADA722387266' 6-max Seat #1 is the button
Seat 1: soundfsilenz ($38406 in chips)
Seat 2: gaganhyd ($46327 in chips)
Seat 3: slotmachine ($45400 in chips)
Seat 4: mangeshnc ($59038 in chips)
Seat 5: kimjongun ($27401 in chips)
Seat 6: TurnOnTuneInDropOut ($95516 in chips)
gaganhyd: posts small blind $200
slotmachine: posts big blind $400
*** HOLE CARDS ***
Dealt to TurnOnTuneInDropOut [9h 8c 4s 4h]
mangeshnc: raises $1000 to $1400
kimjongun: folds
TurnOnTuneInDropOut: folds
soundfsilenz: raises $3400 to $4800
gaganhyd: folds
slotmachine: folds
mangeshnc: calls $3400
*** FLOP *** [8d As Th]
mangeshnc: checks
soundfsilenz: bets $5508
mangeshnc: calls $5508
*** TURN *** [8d As Th] [Kd]
mangeshnc: checks
soundfsilenz: checks
*** RIVER *** [8d As Th Kd] [Jc]
mangeshnc: bets $10608
soundfsilenz: folds
Uncalled bet ($10608) returned to mangeshnc
mangeshnc collected $20416 from pot
mangeshnc: doesn't show hand
*** SUMMARY ***
Total pot $21216 | Rake $800
Board [8d As Th Kd Jc]
Seat 1: soundfsilenz (button) folded on the River
Seat 2: gaganhyd (small blind) folded before Flop
Seat 3: slotmachine (big blind) folded before Flop
Seat 4: mangeshnc collected ($20416)
Seat 5: kimjongun folded before Flop (didn't bet)
Seat 6: TurnOnTuneInDropOut folded before Flop (didn't bet)

PokerStars Hand #1109334873: Omaha Pot Limit ($200/$400 USD) - 2020/10/23 14:42:17 ET
Table 'ADA722387266' 6-max Seat #2 is the button
Seat 1: soundfsilenz ($28098 in chips)
Seat 2: gaganhyd ($46127 in chips)
Seat 3: slotmachine ($45000 in chips)
Seat 4: mangeshnc ($69146 in chips)
Seat 5: kimjongun ($27401 in chips)
Seat 6: TurnOnTuneInDropOut ($95516 in chips)
slotmachine: posts small blind $200
mangeshnc: posts big blind $400
*** HOLE CARDS ***
Dealt to TurnOnTuneInDropOut [4c 5c 4h Qc]
kimjongun: folds
TurnOnTuneInDropOut: folds
soundfsilenz: raises $1000 to $1400
gaganhyd: raises $3400 to $4800
slotmachine: folds
mangeshnc: folds
soundfsilenz: calls $3400
*** FLOP *** [Ac Qh Qd]
soundfsilenz: checks
gaganhyd: checks
*** TURN *** [Ac Qh Qd] [7s]
soundfsilenz: checks
gaganhyd: bets $3465
soundfsilenz: folds
Uncalled bet ($3465) returned to gaganhyd
gaganhyd collected $9791 from pot
gaganhyd: doesn't show hand
*** SUMMARY ***
Total pot $10200 | Rake $409
Board [Ac Qh Qd 7s]
Seat 1: soundfsilenz folded on the Turn
Seat 2: gaganhyd (button) collected ($9791)
Seat 3: slotmachine (small blind) folded before Flop
Seat 4: mangeshnc (big blind) folded before Flop
Seat 5: kimjongun folded before Flop (didn't bet)
Seat 6: TurnOnTuneInDropOut folded before Flop (didn't bet)

PokerStars Hand #1109334874: Omaha Pot Limit ($200/$400 USD) - 2020/10/23 14:43:31 ET
Table 'ADA722387266' 6-max Seat #3 is the button
Seat 1: soundfsilenz ($40099 in chips)
Seat 2: gaganhyd ($51118 in chips)
Seat 3: slotmachine ($44800 in chips)
Seat 4: mangeshnc ($68746 in chips)
Seat 5: kimjongun ($27401 in chips)
Seat 6: TurnOnTuneInDropOut ($95516 in chips)
mangeshnc: posts small blind $200
kimjongun: posts big blind $400
*** HOLE CARDS ***
Dealt to TurnOnTuneInDropOut [7c 2c Th 8d]
TurnOnTuneInDropOut: folds
soundfsilenz: folds
gaganhyd: folds
slotmachine: raises $1000 to $1400
mangeshnc: calls $1200
kimjongun: folds
*** FLOP *** [Ac 6s Js]
mangeshnc: checks
slotmachine: checks
*** TURN *** [Ac 6s Js] [4d]
mangeshnc: bets $3200
slotmachine: folds
Uncalled bet ($3200) returned to mangeshnc
mangeshnc collected $3072 from pot
mangeshnc: doesn't show hand
*** SUMMARY ***
Total pot $3200 | Rake $128
Board [Ac 6s Js 4d]
Seat 1: soundfsilenz folded before Flop (didn't bet)
Seat 2: gaganhyd folded before Flop (didn't bet)
Seat 3: slotmachine (button) folded on the Turn
Seat 4: mangeshnc (small blind) collected ($3072)
Seat 5: kimjongun (big blind) folded before Flop
Seat 6: TurnOnTuneInDropOut folded before Flop (didn't bet)

PokerStars Hand #155975274: Omaha Pot Limit ($500/$1000 USD) - 2020/10/23 13:56:32 ET
Table 'ADA766532706' 6-max Seat #1 is the button
Seat 1: slotmachine ($136209 in chips)
Seat 2: TurnOnTuneInDropOut ($74000 in chips)
Seat 3: vaibz16 ($30000 in chips)
Seat 4: slowcoach ($60995 in chips)
Seat 5: badtameez_donk ($124108 in chips)
Seat 6: aggtarun ($127841 in chips)
TurnOnTuneInDropOut: posts small blind $500
vaibz16: posts big blind $1000
*** HOLE CARDS ***
Dealt to TurnOnTuneInDropOut [4s Td 6s Kh]
slowcoach: raises $1000 to $2000
badtameez_donk: folds
aggtarun: calls $2000
slotmachine: folds
TurnOnTuneInDropOut: folds
vaibz16: calls $1000
*** FLOP *** [3c Ts 4d]
vaibz16: checks
slowcoach: bets $4875
aggtarun: calls $4875
vaibz16: folds
*** TURN *** [3c Ts 4d] [3s]
slowcoach: bets $8125
aggtarun: calls $8125
*** RIVER *** [3c Ts 4d 3s] [9s]
slowcoach: checks
aggtarun: bets $20725
slowcoach: folds
Uncalled bet ($20725) returned to aggtarun
aggtarun collected $31522 from pot
aggtarun: doesn't show hand
*** SUMMARY ***
Total pot $32500 | Rake $978
Board [3c Ts 4d 3s 9s]
Seat 1: slotmachine (button) folded before Flop (didn't bet)
Seat 2: TurnOnTuneInDropOut (small blind) folded before Flop
Seat 3: vaibz16 (big blind) folded on the Flop
Seat 4: slowcoach folded on the River
Seat 5: badtameez_donk folded before Flop (didn't bet)
Seat 6: aggtarun collected ($31522)

PokerStars Hand #155975276: Omaha Pot Limit ($500/$1000 USD) - 2020/10/23 14:00:29 ET
Table 'ADA766532706' 6-max Seat #3 is the button
Seat 1: slotmachine ($135209 in chips)
Seat 2: TurnOnTuneInDropOut ($73500 in chips)
Seat 3: vaibz16 ($27000 in chips)
Seat 4: slowcoach ($1995 in chips)
Seat 5: badtameez_donk ($168709 in chips)
Seat 6: aggtarun ($144363 in chips)
slowcoach: posts small blind $500
badtameez_donk: posts big blind $1000
*** HOLE CARDS ***
Dealt to TurnOnTuneInDropOut [2d 3s 5h 3d]
aggtarun: raises $2500 to $3500
slotmachine: folds
TurnOnTuneInDropOut: folds
vaibz16: calls $3500
slowcoach: calls $1495 and is all-in
badtameez_donk: folds
*** FLOP *** [Qs Jh 5c]
aggtarun: bets $9995
vaibz16: folds
Uncalled bet ($9995) returned to aggtarun
*** TURN *** [Qs Jh 5c] [4h]
*** RIVER *** [Qs Jh 5c 4h] [2s]
*** SHOW DOWN ***
aggtarun: shows [Js Ad 6c Qd]
aggtarun collected $3010 from side pot
slowcoach: shows [4c Ac Kh 4d]
slowcoach collected $6684 from main pot
*** SUMMARY ***
Total pot $9995 Main pot $6684. Side pot $3010. | Rake $301
Board [Qs Jh 5c 4h 2s]
Seat 1: slotmachine folded before Flop (didn't bet)
Seat 2: TurnOnTuneInDropOut folded before Flop (didn't bet)
Seat 3: vaibz16 (button) folded on the Flop
Seat 4: slowcoach (small blind) showed [4c Ac Kh 4d] and won ($6684)
Seat 5: badtameez_donk (big blind) folded before Flop
Seat 6: aggtarun showed [Js Ad 6c Qd] and won ($3010)

PokerStars Hand #155975277: Omaha Pot Limit ($500/$1000 USD) - 2020/10/23 14:01:12 ET
Table 'ADA766532706' 6-max Seat #4 is the button
Seat 1: slotmachine ($135209 in chips)
Seat 2: TurnOnTuneInDropOut ($73500 in chips)
Seat 3: vaibz16 ($23500 in chips)
Seat 4: slowcoach ($6775 in chips)
Seat 5: badtameez_donk ($167709 in chips)
badtameez_donk: posts small blind $500
slotmachine: posts big blind $1000
*** HOLE CARDS ***
Dealt to TurnOnTuneInDropOut [Jd Th 9c Ts]
TurnOnTuneInDropOut: folds
vaibz16: folds
slowcoach: raises $2500 to $3500
badtameez_donk: folds
slotmachine: raises $5500 to $9000
slowcoach: calls $3275 and is all-in
Uncalled bet ($2225) returned to slotmachine
*** FLOP *** [8d 4h 5c]
*** TURN *** [8d 4h 5c] [5s]
*** RIVER *** [8d 4h 5c 5s] [3s]
*** SHOW DOWN ***
slotmachine: shows [9h Qc 3h Tc]
slowcoach: shows [Kc Jc 7c 8s]
slowcoach collected $13627 from pot
*** SUMMARY ***
Total pot $14050 | Rake $423
Board [8d 4h 5c 5s 3s]
Seat 1: slotmachine (big blind) showed [9h Qc 3h Tc] and lost
Seat 2: TurnOnTuneInDropOut folded before Flop (didn't bet)
Seat 3: vaibz16 folded before Flop (didn't bet)
Seat 4: slowcoach (button) showed [Kc Jc 7c 8s] and won ($13627)
Seat 5: badtameez_donk (small blind) folded before Flop

PokerStars Hand #1099153772: Omaha Pot Limit ($200/$400 USD) - 2020/10/24 06:23:33 ET
Table 'ADA120881500' 6-max Seat #1 is the button
Seat 1: DoJingBULLETS ($48000 in chips)
Seat 2: bothras ($52447 in chips)
Seat 3: vimalchotai001 ($15320 in chips)
Seat 4: TurnOnTuneInDropOut ($30200 in chips)
Seat 6: yatin47 ($44400 in chips)
bothras: posts small blind $200
vimalchotai001: posts big blind $400
*** HOLE CARDS ***
Dealt to TurnOnTuneInDropOut [4c Ts 8c 8d]
TurnOnTuneInDropOut: folds
yatin47: folds
DoJingBULLETS: folds
bothras: calls $200
vimalchotai001: checks
*** FLOP *** [8h Ad Jh]
bothras: bets $600
vimalchotai001: folds
Uncalled bet ($600) returned to bothras
bothras collected $768 from pot
bothras: doesn't show hand
*** SUMMARY ***
Total pot $800 | Rake $32
Board [8h Ad Jh]
Seat 1: DoJingBULLETS (button) folded before Flop (didn't bet)
Seat 2: bothras (small blind) collected ($768)
Seat 3: vimalchotai001 (big blind) folded on the Flop
Seat 4: TurnOnTuneInDropOut folded before Flop (didn't bet)
Seat 6: yatin47 folded before Flop (didn't bet)

PokerStars Hand #1099153773: Omaha Pot Limit ($200/$400 USD) - 2020/10/24 06:24:08 ET
Table 'ADA120881500' 6-max Seat #2 is the button
Seat 1: DoJingBULLETS ($48000 in chips)
Seat 2: bothras ($52815 in chips)
Seat 3: vimalchotai001 ($14920 in chips)
Seat 4: TurnOnTuneInDropOut ($30200 in chips)
Seat 6: yatin47 ($44400 in chips)
vimalchotai001: posts small blind $200
TurnOnTuneInDropOut: posts big blind $400
*** HOLE CARDS ***
Dealt to TurnOnTuneInDropOut [Ad Js 7s Qd]
yatin47: folds
DoJingBULLETS: folds
bothras: raises $1000 to $1400
vimalchotai001: calls $1200
TurnOnTuneInDropOut: raises $4200 to $5600
bothras: calls $4200
vimalchotai001: folds
*** FLOP *** [Td 5h Qc]
TurnOnTuneInDropOut: bets $8116
bothras: folds
Uncalled bet ($8116) returned to TurnOnTuneInDropOut
TurnOnTuneInDropOut collected $12095 from pot
TurnOnTuneInDropOut: doesn't show hand
*** SUMMARY ***
Total pot $12600 | Rake $505
Board [Td 5h Qc]
Seat 1: DoJingBULLETS folded before Flop (didn't bet)
Seat 2: bothras (button) folded on the Flop
Seat 3: vimalchotai001 (small blind) folded before Flop
Seat 4: TurnOnTuneInDropOut (big blind) collected ($12095)
Seat 6: yatin47 folded before Flop (didn't bet)

PokerStars Hand #1099153777: Omaha Pot Limit ($200/$400 USD) - 2020/10/24 06:27:07 ET
Table 'ADA120881500' 6-max Seat #1 is the button
Seat 1: DoJingBULLETS ($48000 in chips)
Seat 2: bothras ($46815 in chips)
Seat 3: vimalchotai001 ($17156 in chips)
Seat 4: TurnOnTuneInDropOut ($36495 in chips)
Seat 6: yatin47 ($43400 in chips)
bothras: posts small blind $200
vimalchotai001: posts big blind $400
*** HOLE CARDS ***
Dealt to TurnOnTuneInDropOut [Qh 7c 8c 8s]
TurnOnTuneInDropOut: folds
yatin47: calls $400
DoJingBULLETS: folds
bothras: calls $200
vimalchotai001: checks
*** FLOP *** [7h 3h 2h]
bothras: checks
vimalchotai001: checks
yatin47: checks
*** TURN *** [7h 3h 2h] [6d]
bothras: bets $900
vimalchotai001: folds
yatin47: folds
Uncalled bet ($900) returned to bothras
bothras collected $1152 from pot
bothras: doesn't show hand
*** SUMMARY ***
Total pot $1200 | Rake $48
Board [7h 3h 2h 6d]
Seat 1: DoJingBULLETS (button) folded before Flop (didn't bet)
Seat 2: bothras (small blind) collected ($1152)
Seat 3: vimalchotai001 (big blind) folded on the Turn
Seat 4: TurnOnTuneInDropOut folded before Flop (didn't bet)
Seat 6: yatin47 folded on the Turn

PokerStars Hand #1099153778: Omaha Pot Limit ($200/$400 USD) - 2020/10/24 06:27:41 ET
Table 'ADA120881500' 6-max Seat #2 is the button
Seat 1: DoJingBULLETS ($48000 in chips)
Seat 2: bothras ($47567 in chips)
Seat 3: vimalchotai001 ($16756 in chips)
Seat 4: TurnOnTuneInDropOut ($36495 in chips)
Seat 6: yatin47 ($43000 in chips)
vimalchotai001: posts small blind $200
TurnOnTuneInDropOut: posts big blind $400
*** HOLE CARDS ***
Dealt to TurnOnTuneInDropOut [Kd 4s Tc 8h]
yatin47: folds
DoJingBULLETS: folds
bothras: raises $1000 to $1400
vimalchotai001: folds
TurnOnTuneInDropOut: folds
Uncalled bet ($1000) returned to bothras
bothras collected $1000 from pot
bothras: doesn't show hand
*** SUMMARY ***
Total pot $1000 | Rake $0
Seat 1: DoJingBULLETS folded before Flop (didn't bet)
Seat 2: bothras (button) collected ($1000)
Seat 3: vimalchotai001 (small blind) folded before Flop
Seat 4: TurnOnTuneInDropOut (big blind) folded before Flop
Seat 6: yatin47 folded before Flop (didn't bet)

PokerStars Hand #1099153779: Omaha Pot Limit ($200/$400 USD) - 2020/10/24 06:28:17 ET
Table 'ADA120881500' 6-max Seat #3 is the button
Seat 1: DoJingBULLETS ($48000 in chips)
Seat 2: bothras ($48167 in chips)
Seat 3: vimalchotai001 ($16556 in chips)
Seat 4: TurnOnTuneInDropOut ($36095 in chips)
Seat 6: yatin47 ($43000 in chips)
TurnOnTuneInDropOut: posts small blind $200
yatin47: posts big blind $400
*** HOLE CARDS ***
Dealt to TurnOnTuneInDropOut [Qh 7d Jd 3h]
DoJingBULLETS: folds
bothras: raises $1000 to $1400
vimalchotai001: folds
TurnOnTuneInDropOut: folds
yatin47: calls $1000
*** FLOP *** [4h 8d 3s]
yatin47: checks
bothras: bets $1800
yatin47: folds
Uncalled bet ($1800) returned to bothras
bothras collected $2880 from pot
bothras: doesn't show hand
*** SUMMARY ***
Total pot $3000 | Rake $120
Board [4h 8d 3s]
Seat 1: DoJingBULLETS folded before Flop (didn't bet)
Seat 2: bothras collected ($2880)
Seat 3: vimalchotai001 (button) folded before Flop (didn't bet)
Seat 4: TurnOnTuneInDropOut (small blind) folded before Flop
Seat 6: yatin47 (big blind) folded on the Flop

PokerStars Hand #1099153781: Omaha Pot Limit ($200/$400 USD) - 2020/10/24 06:29:22 ET
Table 'ADA120881500' 6-max Seat #6 is the button
Seat 2: bothras ($50207 in chips)
Seat 3: vimalchotai001 ($16156 in chips)
Seat 4: TurnOnTuneInDropOut ($35895 in chips)
Seat 6: yatin47 ($41400 in chips)
bothras: posts small blind $200
vimalchotai001: posts big blind $400
*** HOLE CARDS ***
Dealt to TurnOnTuneInDropOut [8d Jd 9h Js]
TurnOnTuneInDropOut: raises $1000 to $1400
yatin47: folds
bothras: folds
vimalchotai001: folds
Uncalled bet ($1000) returned to TurnOnTuneInDropOut
TurnOnTuneInDropOut collected $1000 from pot
TurnOnTuneInDropOut: doesn't show hand
*** SUMMARY ***
Total pot $1000 | Rake $0
Seat 2: bothras (small blind) folded before Flop
Seat 3: vimalchotai001 (big blind) folded before Flop
Seat 4: TurnOnTuneInDropOut collected ($1000)
Seat 6: yatin47 (button) folded before Flop (didn't bet)

PokerStars Hand #1099153782: Omaha Pot Limit ($200/$400 USD) - 2020/10/24 06:29:38 ET
Table 'ADA120881500' 6-max Seat #2 is the button
Seat 2: bothras ($50007 in chips)
Seat 3: vimalchotai001 ($15756 in chips)
Seat 4: TurnOnTuneInDropOut ($36495 in chips)
Seat 6: yatin47 ($41400 in chips)
vimalchotai001: posts small blind $200
TurnOnTuneInDropOut: posts big blind $400
*** HOLE CARDS ***
Dealt to TurnOnTuneInDropOut [Kd 9c 3h Ts]
yatin47: folds
bothras: raises $1000 to $1400
vimalchotai001: calls $1200
TurnOnTuneInDropOut: folds
*** FLOP *** [5h 7h 7s]
vimalchotai001: checks
bothras: checks
*** TURN *** [5h 7h 7s] [2d]
vimalchotai001: bets $800
bothras: calls $800
*** RIVER *** [5h 7h 7s 2d] [8d]
vimalchotai001: bets $1200
bothras: calls $1200
*** SHOW DOWN ***
vimalchotai001: mucks hand
bothras: shows [Ks Ad Ac Js]
bothras collected $6911 from pot
*** SUMMARY ***
Total pot $7200 | Rake $289
Board [5h 7h 7s 2d 8d]
Seat 2: bothras (button) showed [Ks Ad Ac Js] and won ($6911)
Seat 3: vimalchotai001 (small blind) mucked
Seat 4: TurnOnTuneInDropOut (big blind) folded before Flop
Seat 6: yatin47 folded before Flop (didn't bet)

PokerStars Hand #163848419: Omaha Pot Limit ($200/$400 USD) - 2020/10/24 06:01:29 ET
Table 'ADA874189191' 6-max Seat #3 is the button
Seat 1: fernz666 ($48000 in chips)
Seat 3: vimalchotai001 ($14186 in chips)
Seat 4: TurnOnTuneInDropOut ($30368 in chips)
Seat 5: hashstack ($22317 in chips)
Seat 6: nimit2908 ($17704 in chips)
TurnOnTuneInDropOut: posts small blind $200
hashstack: posts big blind $400
*** HOLE CARDS ***
Dealt to TurnOnTuneInDropOut [7s 6d 3d 5h]
nimit2908: folds
fernz666: raises $1000 to $1400
vimalchotai001: calls $1400
TurnOnTuneInDropOut: folds
hashstack: folds
*** FLOP *** [9c Ac 6c]
fernz666: bets $2150
vimalchotai001: folds
Uncalled bet ($2150) returned to fernz666
fernz666 collected $3264 from pot
fernz666: doesn't show hand
*** SUMMARY ***
Total pot $3400 | Rake $136
Board [9c Ac 6c]
Seat 1: fernz666 collected ($3264)
Seat 3: vimalchotai001 (button) folded on the Flop
Seat 4: TurnOnTuneInDropOut (small blind) folded before Flop
Seat 5: hashstack (big blind) folded before Flop
Seat 6: nimit2908 folded before Flop (didn't bet)

PokerStars Hand #163848422: Omaha Pot Limit ($200/$400 USD) - 2020/10/24 06:03:02 ET
Table 'ADA874189191' 6-max Seat #6 is the button
Seat 1: fernz666 ($49464 in chips)
Seat 3: vimalchotai001 ($13346 in chips)
Seat 4: TurnOnTuneInDropOut ($25768 in chips)
Seat 5: hashstack ($21717 in chips)
Seat 6: nimit2908 ($21743 in chips)
fernz666: posts small blind $200
vimalchotai001: posts big blind $400
*** HOLE CARDS ***
Dealt to TurnOnTuneInDropOut [9h Ks 3s Jc]
TurnOnTuneInDropOut: folds
hashstack: raises $650 to $1050
nimit2908: folds
fernz666: folds
vimalchotai001: calls $650
*** FLOP *** [3c Ad 9c]
vimalchotai001: bets $800
hashstack: calls $800
*** TURN *** [3c Ad 9c] [Qc]
vimalchotai001: bets $800
hashstack: raises $1797 to $2597
vimalchotai001: calls $1797
*** RIVER *** [3c Ad 9c Qc] [7s]
vimalchotai001: bets $1600
hashstack: folds
Uncalled bet ($1600) returned to vimalchotai001
vimalchotai001 collected $8729 from pot
vimalchotai001: doesn't show hand
*** SUMMARY ***
Total pot $9094 | Rake $365
Board [3c Ad 9c Qc 7s]
Seat 1: fernz666 (small blind) folded before Flop
Seat 3: vimalchotai001 (big blind) collected ($8729)
Seat 4: TurnOnTuneInDropOut folded before Flop (didn't bet)
Seat 5: hashstack folded on the River
Seat 6: nimit2908 (button) folded before Flop (didn't bet)

PokerStars Hand #163848426: Omaha Pot Limit ($200/$400 USD) - 2020/10/24 06:05:55 ET
Table 'ADA874189191' 6-max Seat #5 is the button
Seat 1: fernz666 ($49264 in chips)
Seat 3: vimalchotai001 ($13628 in chips)
Seat 4: TurnOnTuneInDropOut ($25168 in chips)
Seat 5: hashstack ($21158 in chips)
Seat 6: nimit2908 ($22095 in chips)
nimit2908: posts small blind $200
fernz666: posts big blind $400
*** HOLE CARDS ***
Dealt to TurnOnTuneInDropOut [Ah Ts 9c Kh]
vimalchotai001: raises $800 to $1200
TurnOnTuneInDropOut: raises $3000 to $4200
hashstack: folds
nimit2908: folds
fernz666: folds
vimalchotai001: calls $3000
*** FLOP *** [Td 4s Kd]
vimalchotai001: bets $1600
TurnOnTuneInDropOut: raises $12200 to $13800
vimalchotai001: calls $7828 and is all-in
Uncalled bet ($4372) returned to TurnOnTuneInDropOut
*** TURN *** [Td 4s Kd] [4c]
*** RIVER *** [Td 4s Kd 4c] [8s]
*** SHOW DOWN ***
vimalchotai001: shows [Qd Ac 5h As]
TurnOnTuneInDropOut: shows [Ah Ts 9c Kh]
vimalchotai001 collected $27056 from pot
*** SUMMARY ***
Total pot $27856 | Rake $800
Board [Td 4s Kd 4c 8s]
Seat 1: fernz666 (big blind) folded before Flop
Seat 3: vimalchotai001 showed [Qd Ac 5h As] and won ($27056)
Seat 4: TurnOnTuneInDropOut showed [Ah Ts 9c Kh] and lost
Seat 5: hashstack (button) folded before Flop (didn't bet)
Seat 6: nimit2908 (small blind) folded before Flop

PokerStars Hand #163848427: Omaha Pot Limit ($200/$400 USD) - 2020/10/24 06:06:29 ET
Table 'ADA874189191' 6-max Seat #6 is the button
Seat 1: fernz666 ($48864 in chips)
Seat 2: bothras ($48000 in chips)
Seat 3: vimalchotai001 ($27056 in chips)
Seat 4: TurnOnTuneInDropOut ($11540 in chips)
Seat 5: hashstack ($21158 in chips)
Seat 6: nimit2908 ($21895 in chips)
fernz666: posts small blind $200
bothras: posts big blind $400
*** HOLE CARDS ***
Dealt to TurnOnTuneInDropOut [2h 5c 4h 3s]
vimalchotai001: folds
TurnOnTuneInDropOut: folds
hashstack: folds
nimit2908: folds
fernz666: folds
Uncalled bet ($200) returned to bothras
bothras collected $400 from pot
bothras: doesn't show hand
*** SUMMARY ***
Total pot $400 | Rake $0
Seat 1: fernz666 (small blind) folded before Flop
Seat 2: bothras (big blind) collected ($400)
Seat 3: vimalchotai001 folded before Flop (didn't bet)
Seat 4: TurnOnTuneInDropOut folded before Flop (didn't bet)
Seat 5: hashstack folded before Flop (didn't bet)
Seat 6: nimit2908 (button) folded before Flop (didn't bet)

PokerStars Hand #163848428: Omaha Pot Limit ($200/$400 USD) - 2020/10/24 06:06:48 ET
Table 'ADA874189191' 6-max Seat #1 is the button
Seat 1: fernz666 ($48664 in chips)
Seat 2: bothras ($48200 in chips)
Seat 3: vimalchotai001 ($27056 in chips)
Seat 4: TurnOnTuneInDropOut ($24000 in chips)
Seat 5: hashstack ($21158 in chips)
Seat 6: nimit2908 ($21895 in chips)
bothras: posts small blind $200
vimalchotai001: posts big blind $400
*** HOLE CARDS ***
Dealt to TurnOnTuneInDropOut [Qs 3h 2s 4c]
TurnOnTuneInDropOut: folds
hashstack: raises $650 to $1050
nimit2908: folds
fernz666: folds
bothras: folds
vimalchotai001: folds
Uncalled bet ($650) returned to hashstack
hashstack collected $1000 from pot
hashstack: doesn't show hand
*** SUMMARY ***
Total pot $1000 | Rake $0
Seat 1: fernz666 (button) folded before Flop (didn't bet)
Seat 2: bothras (small blind) folded before Flop
Seat 3: vimalchotai001 (big blind) folded before Flop
Seat 4: TurnOnTuneInDropOut folded before Flop (didn't bet)
Seat 5: hashstack collected ($1000)
Seat 6: nimit2908 folded before Flop (didn't bet)

PokerStars Hand #163848429: Omaha Pot Limit ($200/$400 USD) - 2020/10/24 06:07:05 ET
Table 'ADA874189191' 6-max Seat #2 is the button
Seat 1: fernz666 ($48664 in chips)
Seat 2: bothras ($48000 in chips)
Seat 3: vimalchotai001 ($26656 in chips)
Seat 4: TurnOnTuneInDropOut ($24000 in chips)
Seat 5: hashstack ($21758 in chips)
Seat 6: nimit2908 ($21895 in chips)
vimalchotai001: posts small blind $200
TurnOnTuneInDropOut: posts big blind $400
*** HOLE CARDS ***
Dealt to TurnOnTuneInDropOut [5s 3d 5c 6s]
hashstack: folds
nimit2908: folds
fernz666: folds
bothras: raises $1000 to $1400
vimalchotai001: calls $1200
TurnOnTuneInDropOut: folds
*** FLOP *** [Ah 6d 8s]
vimalchotai001: checks
bothras: checks
*** TURN *** [Ah 6d 8s] [5d]
vimalchotai001: bets $1200
bothras: folds
Uncalled bet ($1200) returned to vimalchotai001
vimalchotai001 collected $3072 from pot
vimalchotai001: doesn't show hand
*** SUMMARY ***
Total pot $3200 | Rake $128
Board [Ah 6d 8s 5d]
Seat 1: fernz666 folded before Flop (didn't bet)
Seat 2: bothras (button) folded on the Turn
Seat 3: vimalchotai001 (small blind) collected ($3072)
Seat 4: TurnOnTuneInDropOut (big blind) folded before Flop
Seat 5: hashstack folded before Flop (didn't bet)
Seat 6: nimit2908 folded before Flop (didn't bet)

PokerStars Hand #163848431: Omaha Pot Limit ($200/$400 USD) - 2020/10/24 06:08:22 ET
Table 'ADA874189191' 6-max Seat #4 is the button
Seat 1: fernz666 ($48664 in chips)
Seat 2: bothras ($46600 in chips)
Seat 3: vimalchotai001 ($27428 in chips)
Seat 4: TurnOnTuneInDropOut ($23400 in chips)
Seat 5: hashstack ($22778 in chips)
Seat 6: nimit2908 ($21895 in chips)
hashstack: posts small blind $200
nimit2908: posts big blind $400
*** HOLE CARDS ***
Dealt to TurnOnTuneInDropOut [4c Jd Ac 5c]
fernz666: raises $1000 to $1400
bothras: folds
vimalchotai001: folds
TurnOnTuneInDropOut: folds
hashstack: folds
nimit2908: folds
Uncalled bet ($1000) returned to fernz666
fernz666 collected $1000 from pot
fernz666: doesn't show hand
*** SUMMARY ***
Total pot $1000 | Rake $0
Seat 1: fernz666 collected ($1000)
Seat 2: bothras folded before Flop (didn't bet)
Seat 3: vimalchotai001 folded before Flop (didn't bet)
Seat 4: TurnOnTuneInDropOut (button) folded before Flop (didn't bet)
Seat 5: hashstack (small blind) folded before Flop
Seat 6: nimit2908 (big blind) folded before Flop

PokerStars Hand #163848437: Omaha Pot Limit ($200/$400 USD) - 2020/10/24 06:12:01 ET
Table 'ADA874189191' 6-max Seat #4 is the button
Seat 1: fernz666 ($57179 in chips)
Seat 2: bothras ($37360 in chips)
Seat 3: vimalchotai001 ($29212 in chips)
Seat 4: TurnOnTuneInDropOut ($32226 in chips)
Seat 5: hashstack ($22178 in chips)
Seat 6: nimit2908 ($17695 in chips)
hashstack: posts small blind $200
nimit2908: posts big blind $400
*** HOLE CARDS ***
Dealt to TurnOnTuneInDropOut [7s 4h 2s 6s]
fernz666: folds
bothras: folds
vimalchotai001: folds
TurnOnTuneInDropOut: folds
hashstack: calls $200
nimit2908: raises $800 to $1200
hashstack: calls $800
*** FLOP *** [4s Qc Ts]
hashstack: checks
nimit2908: bets $1800
hashstack: raises $6000 to $7800
nimit2908: folds
Uncalled bet ($6000) returned to hashstack
hashstack collected $5759 from pot
hashstack: doesn't show hand
*** SUMMARY ***
Total pot $6000 | Rake $241
Board [4s Qc Ts]
Seat 1: fernz666 folded before Flop (didn't bet)
Seat 2: bothras folded before Flop (didn't bet)
Seat 3: vimalchotai001 folded before Flop (didn't bet)
Seat 4: TurnOnTuneInDropOut (button) folded before Flop (didn't bet)
Seat 5: hashstack (small blind) collected ($5759)
Seat 6: nimit2908 (big blind) folded on the Flop

PokerStars Hand #163848438: Omaha Pot Limit ($200/$400 USD) - 2020/10/24 06:12:42 ET
Table 'ADA874189191' 6-max Seat #5 is the button
Seat 1: fernz666 ($57179 in chips)
Seat 2: bothras ($37360 in chips)
Seat 3: vimalchotai001 ($29212 in chips)
Seat 4: TurnOnTuneInDropOut ($32226 in chips)
Seat 5: hashstack ($24937 in chips)
Seat 6: nimit2908 ($14695 in chips)
nimit2908: posts small blind $200
fernz666: posts big blind $400
*** HOLE CARDS ***
Dealt to TurnOnTuneInDropOut [Ks Tc 7d 9d]
bothras: folds
vimalchotai001: folds
TurnOnTuneInDropOut: raises $1000 to $1400
hashstack: calls $1400
nimit2908: calls $1200
fernz666: folds
*** FLOP *** [7s 6d 2d]
nimit2908: checks
TurnOnTuneInDropOut: checks
hashstack: checks
*** TURN *** [7s 6d 2d] [As]
nimit2908: checks
TurnOnTuneInDropOut: checks
hashstack: checks
*** RIVER *** [7s 6d 2d As] [Ad]
nimit2908: checks
TurnOnTuneInDropOut: checks
hashstack: bets $2250
nimit2908: folds
TurnOnTuneInDropOut: calls $2250
*** SHOW DOWN ***
TurnOnTuneInDropOut: shows [Ks Tc 7d 9d]
hashstack: shows [Qh Td Js 2s]
TurnOnTuneInDropOut collected $8735 from pot
*** SUMMARY ***
Total pot $9100 | Rake $365
Board [7s 6d 2d As Ad]
Seat 1: fernz666 (big blind) folded before Flop
Seat 2: bothras folded before Flop (didn't bet)
Seat 3: vimalchotai001 folded before Flop (didn't bet)
Seat 4: TurnOnTuneInDropOut showed [Ks Tc 7d 9d] and won ($8735)
Seat 5: hashstack (button) showed [Qh Td Js 2s] and lost
Seat 6: nimit2908 (small blind) folded on the River

PokerStars Hand #163848440: Omaha Pot Limit ($200/$400 USD) - 2020/10/24 06:14:19 ET
Table 'ADA874189191' 6-max Seat #1 is the button
Seat 1: fernz666 ($56579 in chips)
Seat 2: bothras ($36960 in chips)
Seat 3: vimalchotai001 ($28812 in chips)
Seat 4: TurnOnTuneInDropOut ($50806 in chips)
Seat 5: hashstack ($21287 in chips)
bothras: posts small blind $200
vimalchotai001: posts big blind $400
*** HOLE CARDS ***
Dealt to TurnOnTuneInDropOut [2c Kd Qd Td]
TurnOnTuneInDropOut: folds
hashstack: folds
fernz666: folds
bothras: folds
Uncalled bet ($200) returned to vimalchotai001
vimalchotai001 collected $400 from pot
vimalchotai001: doesn't show hand
*** SUMMARY ***
Total pot $400 | Rake $0
Seat 1: fernz666 (button) folded before Flop (didn't bet)
Seat 2: bothras (small blind) folded before Flop
Seat 3: vimalchotai001 (big blind) collected ($400)
Seat 4: TurnOnTuneInDropOut folded before Flop (didn't bet)
Seat 5: hashstack folded before Flop (didn't bet)

PokerStars Hand #163848441: Omaha Pot Limit ($200/$400 USD) - 2020/10/24 06:14:32 ET
Table 'ADA874189191' 6-max Seat #2 is the button
Seat 1: fernz666 ($56579 in chips)
Seat 2: bothras ($36760 in chips)
Seat 3: vimalchotai001 ($29012 in chips)
Seat 4: TurnOnTuneInDropOut ($50806 in chips)
Seat 5: hashstack ($21287 in chips)
vimalchotai001: posts small blind $200
TurnOnTuneInDropOut: posts big blind $400
*** HOLE CARDS ***
Dealt to TurnOnTuneInDropOut [9d Kh 2c 9s]
hashstack: folds
fernz666: raises $1000 to $1400
bothras: folds
vimalchotai001: calls $1200
TurnOnTuneInDropOut: folds
*** FLOP *** [4d 5c 7d]
vimalchotai001: checks
fernz666: checks
*** TURN *** [4d 5c 7d] [Kd]
vimalchotai001: bets $800
fernz666: folds
Uncalled bet ($800) returned to vimalchotai001
vimalchotai001 collected $3072 from pot
vimalchotai001: doesn't show hand
*** SUMMARY ***
Total pot $3200 | Rake $128
Board [4d 5c 7d Kd]
Seat 1: fernz666 folded on the Turn
Seat 2: bothras (button) folded before Flop (didn't bet)
Seat 3: vimalchotai001 (small blind) collected ($3072)
Seat 4: TurnOnTuneInDropOut (big blind) folded before Flop
Seat 5: hashstack folded before Flop (didn't bet)

PokerStars Hand #163848442: Omaha Pot Limit ($200/$400 USD) - 2020/10/24 06:15:02 ET
Table 'ADA874189191' 6-max Seat #3 is the button
Seat 1: fernz666 ($55179 in chips)
Seat 2: bothras ($36760 in chips)
Seat 3: vimalchotai001 ($30684 in chips)
Seat 4: TurnOnTuneInDropOut ($50406 in chips)
Seat 5: hashstack ($21287 in chips)
TurnOnTuneInDropOut: posts small blind $200
hashstack: posts big blind $400
*** HOLE CARDS ***
Dealt to TurnOnTuneInDropOut [6c 7s Tc 8d]
fernz666: raises $1000 to $1400
bothras: folds
vimalchotai001: folds
TurnOnTuneInDropOut: folds
hashstack: folds
Uncalled bet ($1000) returned to fernz666
fernz666 collected $1000 from pot
fernz666: doesn't show hand
*** SUMMARY ***
Total pot $1000 | Rake $0
Seat 1: fernz666 collected ($1000)
Seat 2: bothras folded before Flop (didn't bet)
Seat 3: vimalchotai001 (button) folded before Flop (didn't bet)
Seat 4: TurnOnTuneInDropOut (small blind) folded before Flop
Seat 5: hashstack (big blind) folded before Flop

PokerStars Hand #163848443: Omaha Pot Limit ($200/$400 USD) - 2020/10/24 06:15:20 ET
Table 'ADA874189191' 6-max Seat #4 is the button
Seat 1: fernz666 ($55779 in chips)
Seat 2: bothras ($36760 in chips)
Seat 3: vimalchotai001 ($30684 in chips)
Seat 4: TurnOnTuneInDropOut ($50206 in chips)
Seat 5: hashstack ($20887 in chips)
hashstack: posts small blind $200
fernz666: posts big blind $400
*** HOLE CARDS ***
Dealt to TurnOnTuneInDropOut [Th 7c 3h 8s]
bothras: folds
vimalchotai001: folds
TurnOnTuneInDropOut: raises $1000 to $1400
hashstack: folds
fernz666: folds
Uncalled bet ($1000) returned to TurnOnTuneInDropOut
TurnOnTuneInDropOut collected $1000 from pot
TurnOnTuneInDropOut: doesn't show hand
*** SUMMARY ***
Total pot $1000 | Rake $0
Seat 1: fernz666 (big blind) folded before Flop
Seat 2: bothras folded before Flop (didn't bet)
Seat 3: vimalchotai001 folded before Flop (didn't bet)
Seat 4: TurnOnTuneInDropOut (button) collected ($1000)
Seat 5: hashstack (small blind) folded before Flop

PokerStars Hand #163848445: Omaha Pot Limit ($200/$400 USD) - 2020/10/24 06:16:06 ET
Table 'ADA874189191' 6-max Seat #1 is the button
Seat 1: fernz666 ($55179 in chips)
Seat 2: bothras ($37320 in chips)
Seat 3: vimalchotai001 ($30284 in chips)
Seat 4: TurnOnTuneInDropOut ($50806 in chips)
Seat 5: hashstack ($20687 in chips)
bothras: posts small blind $200
vimalchotai001: posts big blind $400
*** HOLE CARDS ***
Dealt to TurnOnTuneInDropOut [Ad Kc 5h 9d]
TurnOnTuneInDropOut: folds
hashstack: folds
fernz666: raises $1000 to $1400
bothras: folds
vimalchotai001: calls $1000
*** FLOP *** [7h Qc Qh]
vimalchotai001: checks
fernz666: bets $1900
vimalchotai001: calls $1900
*** TURN *** [7h Qc Qh] [Qs]
vimalchotai001: checks
fernz666: bets $4200
vimalchotai001: calls $4200
*** RIVER *** [7h Qc Qh Qs] [As]
vimalchotai001: bets $3200
fernz666: folds
Uncalled bet ($3200) returned to vimalchotai001
vimalchotai001 collected $14590 from pot
vimalchotai001: doesn't show hand
*** SUMMARY ***
Total pot $15200 | Rake $610
Board [7h Qc Qh Qs As]
Seat 1: fernz666 (button) folded on the River
Seat 2: bothras (small blind) folded before Flop
Seat 3: vimalchotai001 (big blind) collected ($14590)
Seat 4: TurnOnTuneInDropOut folded before Flop (didn't bet)
Seat 5: hashstack folded before Flop (didn't bet)

PokerStars Hand #163848450: Omaha Pot Limit ($200/$400 USD) - 2020/10/24 06:19:33 ET
Table 'ADA874189191' 6-max Seat #1 is the button
Seat 1: fernz666 ($47079 in chips)
Seat 2: bothras ($38952 in chips)
Seat 3: vimalchotai001 ($35726 in chips)
Seat 4: TurnOnTuneInDropOut ($53965 in chips)
Seat 5: hashstack ($17439 in chips)
bothras: posts small blind $200
vimalchotai001: posts big blind $400
*** HOLE CARDS ***
Dealt to TurnOnTuneInDropOut [Jc 3d 4s 9c]
TurnOnTuneInDropOut: folds
hashstack: folds
fernz666: raises $1000 to $1400
bothras: folds
vimalchotai001: calls $1000
*** FLOP *** [Ts Kd Qd]
vimalchotai001: bets $800
fernz666: raises $3250 to $4050
vimalchotai001: calls $3250
*** TURN *** [Ts Kd Qd] [5c]
vimalchotai001: bets $1200
fernz666: raises $9825 to $11025
vimalchotai001: folds
Uncalled bet ($9825) returned to fernz666
fernz666 collected $12959 from pot
fernz666: doesn't show hand
*** SUMMARY ***
Total pot $13500 | Rake $541
Board [Ts Kd Qd 5c]
Seat 1: fernz666 (button) collected ($12959)
Seat 2: bothras (small blind) folded before Flop
Seat 3: vimalchotai001 (big blind) folded on the Turn
Seat 4: TurnOnTuneInDropOut folded before Flop (didn't bet)
Seat 5: hashstack folded before Flop (didn't bet)

PokerStars Hand #163848451: Omaha Pot Limit ($200/$400 USD) - 2020/10/24 06:20:19 ET
Table 'ADA874189191' 6-max Seat #2 is the button
Seat 1: fernz666 ($53388 in chips)
Seat 2: bothras ($38752 in chips)
Seat 3: vimalchotai001 ($29076 in chips)
Seat 4: TurnOnTuneInDropOut ($53965 in chips)
Seat 5: hashstack ($17439 in chips)
vimalchotai001: posts small blind $200
TurnOnTuneInDropOut: posts big blind $400
*** HOLE CARDS ***
Dealt to TurnOnTuneInDropOut [9s Jc 7s 2h]
hashstack: raises $400 to $800
fernz666: folds
bothras: calls $800
vimalchotai001: folds
TurnOnTuneInDropOut: folds
*** FLOP *** [8s Qh 4c]
hashstack: checks
bothras: checks
*** TURN *** [8s Qh 4c] [4s]
hashstack: bets $1500
bothras: folds
Uncalled bet ($1500) returned to hashstack
hashstack collected $2112 from pot
hashstack: doesn't show hand
*** SUMMARY ***
Total pot $2200 | Rake $88
Board [8s Qh 4c 4s]
Seat 1: fernz666 folded before Flop (didn't bet)
Seat 2: bothras (button) folded on the Turn
Seat 3: vimalchotai001 (small blind) folded before Flop
Seat 4: TurnOnTuneInDropOut (big blind) folded before Flop
Seat 5: hashstack collected ($2112)

PokerStars Hand #163848452: Omaha Pot Limit ($200/$400 USD) - 2020/10/24 06:20:58 ET
Table 'ADA874189191' 6-max Seat #3 is the button
Seat 1: fernz666 ($53388 in chips)
Seat 2: bothras ($37952 in chips)
Seat 3: vimalchotai001 ($28876 in chips)
Seat 4: TurnOnTuneInDropOut ($53565 in chips)
Seat 5: hashstack ($18751 in chips)
TurnOnTuneInDropOut: posts small blind $200
hashstack: posts big blind $400
*** HOLE CARDS ***
Dealt to TurnOnTuneInDropOut [4d 2c 4c Qd]
fernz666: folds
bothras: raises $1000 to $1400
vimalchotai001: folds
TurnOnTuneInDropOut: folds
hashstack: calls $1000
*** FLOP *** [2d Jh 8s]
hashstack: checks
bothras: bets $2250
hashstack: folds
Uncalled bet ($2250) returned to bothras
bothras collected $2880 from pot
bothras: doesn't show hand
*** SUMMARY ***
Total pot $3000 | Rake $120
Board [2d Jh 8s]
Seat 1: fernz666 folded before Flop (didn't bet)
Seat 2: bothras collected ($2880)
Seat 3: vimalchotai001 (button) folded before Flop (didn't bet)
Seat 4: TurnOnTuneInDropOut (small blind) folded before Flop
Seat 5: hashstack (big blind) folded on the Flop

PokerStars Hand #163848454: Omaha Pot Limit ($200/$400 USD) - 2020/10/24 06:22:13 ET
Table 'ADA874189191' 6-max Seat #5 is the button
Seat 1: fernz666 ($36037 in chips)
Seat 2: bothras ($39432 in chips)
Seat 3: vimalchotai001 ($28476 in chips)
Seat 4: TurnOnTuneInDropOut ($51565 in chips)
Seat 5: hashstack ($36102 in chips)
fernz666: posts small blind $200
bothras: posts big blind $400
*** HOLE CARDS ***
Dealt to TurnOnTuneInDropOut [Jh Tc 9d 9c]
vimalchotai001: folds
TurnOnTuneInDropOut: raises $1000 to $1400
hashstack: folds
fernz666: folds
bothras: calls $1000
*** FLOP *** [Ad 4h Qh]
bothras: checks
TurnOnTuneInDropOut: bets $1980
bothras: calls $1980
*** TURN *** [Ad 4h Qh] [7h]
bothras: checks
TurnOnTuneInDropOut: bets $2854
bothras: folds
Uncalled bet ($2854) returned to TurnOnTuneInDropOut
TurnOnTuneInDropOut collected $6681 from pot
TurnOnTuneInDropOut: doesn't show hand
*** SUMMARY ***
Total pot $6960 | Rake $279
Board [Ad 4h Qh 7h]
Seat 1: fernz666 (small blind) folded before Flop
Seat 2: bothras (big blind) folded on the Turn
Seat 3: vimalchotai001 folded before Flop (didn't bet)
Seat 4: TurnOnTuneInDropOut collected ($6681)
Seat 5: hashstack (button) folded before Flop (didn't bet)

PokerStars Hand #163848455: Omaha Pot Limit ($200/$400 USD) - 2020/10/24 06:22:50 ET
Table 'ADA874189191' 6-max Seat #1 is the button
Seat 1: fernz666 ($48000 in chips)
Seat 2: bothras ($36052 in chips)
Seat 3: vimalchotai001 ($28476 in chips)
Seat 4: TurnOnTuneInDropOut ($54866 in chips)
Seat 5: hashstack ($36102 in chips)
bothras: posts small blind $200
vimalchotai001: posts big blind $400
*** HOLE CARDS ***
Dealt to TurnOnTuneInDropOut [4d 6s 3c 4c]
TurnOnTuneInDropOut: folds
hashstack: folds
fernz666: folds
bothras: folds
Uncalled bet ($200) returned to vimalchotai001
vimalchotai001 collected $400 from pot
vimalchotai001: doesn't show hand
*** SUMMARY ***
Total pot $400 | Rake $0
Seat 1: fernz666 (button) folded before Flop (didn't bet)
Seat 2: bothras (small blind) folded before Flop
Seat 3: vimalchotai001 (big blind) collected ($400)
Seat 4: TurnOnTuneInDropOut folded before Flop (didn't bet)
Seat 5: hashstack folded before Flop (didn't bet)

PokerStars Hand #163848456: Omaha Pot Limit ($200/$400 USD) - 2020/10/24 06:23:02 ET
Table 'ADA874189191' 6-max Seat #2 is the button
Seat 1: fernz666 ($48000 in chips)
Seat 2: bothras ($35852 in chips)
Seat 3: vimalchotai001 ($28676 in chips)
Seat 4: TurnOnTuneInDropOut ($54866 in chips)
Seat 5: hashstack ($36102 in chips)
vimalchotai001: posts small blind $200
TurnOnTuneInDropOut: posts big blind $400
*** HOLE CARDS ***
Dealt to TurnOnTuneInDropOut [5c 9c Jd Qd]
hashstack: folds
fernz666: folds
bothras: folds
vimalchotai001: calls $200
TurnOnTuneInDropOut: raises $800 to $1200
vimalchotai001: calls $800
*** FLOP *** [7s 9h 6h]
vimalchotai001: checks
TurnOnTuneInDropOut: checks
*** TURN *** [7s 9h 6h] [2h]
vimalchotai001: checks
TurnOnTuneInDropOut: checks
*** RIVER *** [7s 9h 6h 2h] [Ah]
vimalchotai001: checks
TurnOnTuneInDropOut: checks
*** SHOW DOWN ***
vimalchotai001: shows [As 8d Js 9d]
vimalchotai001 collected $2304 from pot
*** SUMMARY ***
Total pot $2400 | Rake $96
Board [7s 9h 6h 2h Ah]
Seat 1: fernz666 folded before Flop (didn't bet)
Seat 2: bothras (button) folded before Flop (didn't bet)
Seat 3: vimalchotai001 (small blind) showed [As 8d Js 9d] and won ($2304)
Seat 4: TurnOnTuneInDropOut (big blind)
Seat 5: hashstack folded before Flop (didn't bet)

PokerStars Hand #163848457: Omaha Pot Limit ($200/$400 USD) - 2020/10/24 06:23:53 ET
Table 'ADA874189191' 6-max Seat #3 is the button
Seat 1: fernz666 ($48000 in chips)
Seat 2: bothras ($35852 in chips)
Seat 3: vimalchotai001 ($29780 in chips)
Seat 4: TurnOnTuneInDropOut ($53666 in chips)
TurnOnTuneInDropOut: posts small blind $200
fernz666: posts big blind $400
*** HOLE CARDS ***
Dealt to TurnOnTuneInDropOut [8d 8c 4h Js]
bothras: folds
vimalchotai001: folds
TurnOnTuneInDropOut: folds
Uncalled bet ($200) returned to fernz666
fernz666 collected $400 from pot
fernz666: doesn't show hand
*** SUMMARY ***
Total pot $400 | Rake $0
Seat 1: fernz666 (big blind) collected ($400)
Seat 2: bothras folded before Flop (didn't bet)
Seat 3: vimalchotai001 (button) folded before Flop (didn't bet)
Seat 4: TurnOnTuneInDropOut (small blind) folded before Flop

PokerStars Hand #163848459: Omaha Pot Limit ($200/$400 USD) - 2020/10/24 06:24:53 ET
Table 'ADA874189191' 6-max Seat #1 is the button
Seat 1: fernz666 ($48000 in chips)
Seat 2: bothras ($36412 in chips)
Seat 3: vimalchotai001 ($29380 in chips)
Seat 4: TurnOnTuneInDropOut ($53466 in chips)
bothras: posts small blind $200
vimalchotai001: posts big blind $400
*** HOLE CARDS ***
Dealt to TurnOnTuneInDropOut [Ac 6h 3c Ks]
TurnOnTuneInDropOut: folds
fernz666: folds
bothras: calls $200
vimalchotai001: checks
*** FLOP *** [6d Kc Th]
bothras: bets $480
vimalchotai001: folds
Uncalled bet ($480) returned to bothras
bothras collected $768 from pot
bothras: doesn't show hand
*** SUMMARY ***
Total pot $800 | Rake $32
Board [6d Kc Th]
Seat 1: fernz666 (button) folded before Flop (didn't bet)
Seat 2: bothras (small blind) collected ($768)
Seat 3: vimalchotai001 (big blind) folded on the Flop
Seat 4: TurnOnTuneInDropOut folded before Flop (didn't bet)

PokerStars Hand #1922877784: Omaha Pot Limit ($200/$400 USD) - 2020/10/23 12:20:03 ET
Table 'ADA179504417' 6-max Seat #4 is the button
Seat 1: kaushal222 ($9309 in chips)
Seat 2: soundfsilenz ($90274 in chips)
Seat 3: TurnOnTuneInDropOut ($29400 in chips)
Seat 4: karanchawla09 ($18891 in chips)
Seat 5: PokerMessi ($91597 in chips)
Seat 6: slotmachine ($51871 in chips)
PokerMessi: posts small blind $200
slotmachine: posts big blind $400
*** HOLE CARDS ***
Dealt to TurnOnTuneInDropOut [4c 9d 5c 4h]
kaushal222: folds
soundfsilenz: folds
TurnOnTuneInDropOut: folds
karanchawla09: calls $400
PokerMessi: folds
slotmachine: checks
*** FLOP *** [As 3h 8c]
slotmachine: checks
karanchawla09: checks
*** TURN *** [As 3h 8c] [Jc]
slotmachine: checks
karanchawla09: checks
*** RIVER *** [As 3h 8c Jc] [8d]
slotmachine: checks
karanchawla09: bets $400
slotmachine: folds
Uncalled bet ($400) returned to karanchawla09
karanchawla09 collected $960 from pot
karanchawla09: doesn't show hand
*** SUMMARY ***
Total pot $1000 | Rake $40
Board [As 3h 8c Jc 8d]
Seat 1: kaushal222 folded before Flop (didn't bet)
Seat 2: soundfsilenz folded before Flop (didn't bet)
Seat 3: TurnOnTuneInDropOut folded before Flop (didn't bet)
Seat 4: karanchawla09 (button) collected ($960)
Seat 5: PokerMessi (small blind) folded before Flop
Seat 6: slotmachine (big blind) folded on the River

PokerStars Hand #1922877785: Omaha Pot Limit ($200/$400 USD) - 2020/10/23 12:20:56 ET
Table 'ADA179504417' 6-max Seat #5 is the button
Seat 1: kaushal222 ($9309 in chips)
Seat 2: soundfsilenz ($90274 in chips)
Seat 3: TurnOnTuneInDropOut ($29400 in chips)
Seat 4: karanchawla09 ($19451 in chips)
Seat 5: PokerMessi ($91397 in chips)
Seat 6: slotmachine ($51471 in chips)
slotmachine: posts small blind $200
kaushal222: posts big blind $400
*** HOLE CARDS ***
Dealt to TurnOnTuneInDropOut [Qh 8h Ks 6d]
soundfsilenz: folds
TurnOnTuneInDropOut: folds
karanchawla09: calls $400
PokerMessi: folds
slotmachine: folds
kaushal222: checks
*** FLOP *** [Td 3d As]
kaushal222: checks
karanchawla09: checks
*** TURN *** [Td 3d As] [4h]
kaushal222: checks
karanchawla09: checks
*** RIVER *** [Td 3d As 4h] [4c]
kaushal222: bets $400
karanchawla09: calls $400
*** SHOW DOWN ***
kaushal222: shows [9c 4s 7h Ac]
karanchawla09: mucks hand
kaushal222 collected $1728 from pot
*** SUMMARY ***
Total pot $1800 | Rake $72
Board [Td 3d As 4h 4c]
Seat 1: kaushal222 (big blind) showed [9c 4s 7h Ac] and won ($1728)
Seat 2: soundfsilenz folded before Flop (didn't bet)
Seat 3: TurnOnTuneInDropOut folded before Flop (didn't bet)
Seat 4: karanchawla09 mucked
Seat 5: PokerMessi (button) folded before Flop (didn't bet)
Seat 6: slotmachine (small blind) folded before Flop

PokerStars Hand #1922877786: Omaha Pot Limit ($200/$400 USD) - 2020/10/23 12:22:38 ET
Table 'ADA179504417' 6-max Seat #6 is the button
Seat 1: kaushal222 ($10237 in chips)
Seat 2: soundfsilenz ($90274 in chips)
Seat 3: TurnOnTuneInDropOut ($29400 in chips)
Seat 4: karanchawla09 ($18651 in chips)
Seat 5: PokerMessi ($91397 in chips)
Seat 6: slotmachine ($51271 in chips)
kaushal222: posts small blind $200
soundfsilenz: posts big blind $400
*** HOLE CARDS ***
Dealt to TurnOnTuneInDropOut [Qh 8s Jd 2c]
TurnOnTuneInDropOut: folds
karanchawla09: calls $400
PokerMessi: folds
slotmachine: folds
kaushal222: calls $200
soundfsilenz: checks
*** FLOP *** [Ts 6s Qs]
kaushal222: checks
soundfsilenz: checks
karanchawla09: bets $1200
kaushal222: folds
soundfsilenz: folds
Uncalled bet ($1200) returned to karanchawla09
karanchawla09 collected $1152 from pot
karanchawla09: doesn't show hand
*** SUMMARY ***
Total pot $1200 | Rake $48
Board [Ts 6s Qs]
Seat 1: kaushal222 (small blind) folded on the Flop
Seat 2: soundfsilenz (big blind) folded on the Flop
Seat 3: TurnOnTuneInDropOut folded before Flop (didn't bet)
Seat 4: karanchawla09 collected ($1152)
Seat 5: PokerMessi folded before Flop (didn't bet)
Seat 6: slotmachine (button) folded before Flop (didn't bet)

PokerStars Hand #1922877864: Omaha Pot Limit ($200/$400 USD) - 2020/10/23 13:43:38 ET
Table 'ADA179504417' 6-max Seat #2 is the button
Seat 1: ag2703 ($87187 in chips)
Seat 2: MadMonkey ($12161 in chips)
Seat 3: kimjongun ($73123 in chips)
Seat 4: TurnOnTuneInDropOut ($30000 in chips)
Seat 5: soundfsilenz ($44947 in chips)
Seat 6: slotmachine ($72776 in chips)
kimjongun: posts small blind $200
TurnOnTuneInDropOut: posts big blind $400
*** HOLE CARDS ***
Dealt to TurnOnTuneInDropOut [5d 2c 2d 5h]
soundfsilenz: folds
slotmachine: folds
ag2703: folds
MadMonkey: folds
kimjongun: folds
Uncalled bet ($200) returned to TurnOnTuneInDropOut
TurnOnTuneInDropOut collected $400 from pot
TurnOnTuneInDropOut: doesn't show hand
*** SUMMARY ***
Total pot $400 | Rake $0
Seat 1: ag2703 folded before Flop (didn't bet)
Seat 2: MadMonkey (button) folded before Flop (didn't bet)
Seat 3: kimjongun (small blind) folded before Flop
Seat 4: TurnOnTuneInDropOut (big blind) collected ($400)
Seat 5: soundfsilenz folded before Flop (didn't bet)
Seat 6: slotmachine folded before Flop (didn't bet)

PokerStars Hand #1922877867: Omaha Pot Limit ($200/$400 USD) - 2020/10/23 13:45:50 ET
Table 'ADA179504417' 6-max Seat #5 is the button
Seat 1: ag2703 ($86387 in chips)
Seat 2: MadMonkey ($13857 in chips)
Seat 3: kimjongun ($73523 in chips)
Seat 4: TurnOnTuneInDropOut ($30000 in chips)
Seat 5: soundfsilenz ($43947 in chips)
Seat 6: slotmachine ($72376 in chips)
slotmachine: posts small blind $200
ag2703: posts big blind $400
*** HOLE CARDS ***
Dealt to TurnOnTuneInDropOut [Qh Kh 4d 6d]
MadMonkey: folds
kimjongun: folds
TurnOnTuneInDropOut: raises $1000 to $1400
soundfsilenz: raises $3400 to $4800
slotmachine: folds
ag2703: calls $4400
TurnOnTuneInDropOut: folds
*** FLOP *** [4c 4h 6c]
ag2703: checks
soundfsilenz: bets $7504
ag2703: folds
Uncalled bet ($7504) returned to soundfsilenz
soundfsilenz collected $10751 from pot
soundfsilenz: doesn't show hand
*** SUMMARY ***
Total pot $11200 | Rake $449
Board [4c 4h 6c]
Seat 1: ag2703 (big blind) folded on the Flop
Seat 2: MadMonkey folded before Flop (didn't bet)
Seat 3: kimjongun folded before Flop (didn't bet)
Seat 4: TurnOnTuneInDropOut folded before Flop
Seat 5: soundfsilenz (button) collected ($10751)
Seat 6: slotmachine (small blind) folded before Flop

PokerStars Hand #1922877868: Omaha Pot Limit ($200/$400 USD) - 2020/10/23 13:47:19 ET
Table 'ADA179504417' 6-max Seat #6 is the button
Seat 1: ag2703 ($81587 in chips)
Seat 2: MadMonkey ($13857 in chips)
Seat 3: kimjongun ($73523 in chips)
Seat 4: TurnOnTuneInDropOut ($28600 in chips)
Seat 5: soundfsilenz ($49898 in chips)
Seat 6: slotmachine ($72176 in chips)
ag2703: posts small blind $200
MadMonkey: posts big blind $400
*** HOLE CARDS ***
Dealt to TurnOnTuneInDropOut [8h 3d Ac 2h]
kimjongun: raises $600 to $1000
TurnOnTuneInDropOut: folds
soundfsilenz: folds
slotmachine: calls $1000
ag2703: calls $800
MadMonkey: calls $600
*** FLOP *** [Td Jh 6s]
ag2703: checks
MadMonkey: bets $400
kimjongun: calls $400
slotmachine: calls $400
ag2703: raises $5600 to $6000
MadMonkey: folds
kimjongun: folds
slotmachine: folds
Uncalled bet ($5600) returned to ag2703
ag2703: shows [Js 5s 5c Ah]
ag2703 collected $5375 from pot
*** SUMMARY ***
Total pot $5600 | Rake $225
Board [Td Jh 6s]
Seat 1: ag2703 (small blind) collected ($5375)
Seat 2: MadMonkey (big blind) folded on the Flop
Seat 3: kimjongun folded on the Flop
Seat 4: TurnOnTuneInDropOut folded before Flop (didn't bet)
Seat 5: soundfsilenz folded before Flop (didn't bet)
Seat 6: slotmachine (button) folded on the Flop

PokerStars Hand #1922877869: Omaha Pot Limit ($200/$400 USD) - 2020/10/23 13:48:54 ET
Table 'ADA179504417' 6-max Seat #1 is the button
Seat 1: ag2703 ($85562 in chips)
Seat 2: MadMonkey ($12457 in chips)
Seat 3: kimjongun ($72123 in chips)
Seat 4: TurnOnTuneInDropOut ($28600 in chips)
Seat 5: soundfsilenz ($49898 in chips)
Seat 6: slotmachine ($70776 in chips)
MadMonkey: posts small blind $200
kimjongun: posts big blind $400
*** HOLE CARDS ***
Dealt to TurnOnTuneInDropOut [Ac 5h 6d 8c]
TurnOnTuneInDropOut: folds
soundfsilenz: raises $1000 to $1400
slotmachine: folds
ag2703: folds
MadMonkey: calls $1200
kimjongun: calls $1000
*** FLOP *** [9c 5d Kh]
MadMonkey: bets $4200
kimjongun: folds
soundfsilenz: raises $8568 to $12768
MadMonkey: calls $6857 and is all-in
Uncalled bet ($1711) returned to soundfsilenz
*** TURN *** [9c 5d Kh] [Ad]
*** RIVER *** [9c 5d Kh Ad] [Jd]
*** SHOW DOWN ***
MadMonkey: shows [9h Qc 9s 3h]
soundfsilenz: shows [Ks Th Jh Ts]
MadMonkey collected $25514 from pot
*** SUMMARY ***
Total pot $26314 | Rake $800
Board [9c 5d Kh Ad Jd]
Seat 1: ag2703 (button) folded before Flop (didn't bet)
Seat 2: MadMonkey (small blind) showed [9h Qc 9s 3h] and won ($25514)
Seat 3: kimjongun (big blind) folded on the Flop
Seat 4: TurnOnTuneInDropOut folded before Flop (didn't bet)
Seat 5: soundfsilenz showed [Ks Th Jh Ts] and lost
Seat 6: slotmachine folded before Flop (didn't bet)

PokerStars Hand #1922877870: Omaha Pot Limit ($200/$400 USD) - 2020/10/23 13:49:50 ET
Table 'ADA179504417' 6-max Seat #2 is the button
Seat 1: ag2703 ($85562 in chips)
Seat 2: MadMonkey ($25514 in chips)
Seat 3: kimjongun ($70723 in chips)
Seat 4: TurnOnTuneInDropOut ($28600 in chips)
Seat 5: soundfsilenz ($37441 in chips)
Seat 6: slotmachine ($70776 in chips)
kimjongun: posts small blind $200
TurnOnTuneInDropOut: posts big blind $400
*** HOLE CARDS ***
Dealt to TurnOnTuneInDropOut [9c Ad Qd 7d]
soundfsilenz: raises $1000 to $1400
slotmachine: folds
ag2703: folds
MadMonkey: folds
kimjongun: folds
TurnOnTuneInDropOut: folds
Uncalled bet ($1000) returned to soundfsilenz
soundfsilenz collected $1000 from pot
soundfsilenz: doesn't show hand
*** SUMMARY ***
Total pot $1000 | Rake $0
Seat 1: ag2703 folded before Flop (didn't bet)
Seat 2: MadMonkey (button) folded before Flop (didn't bet)
Seat 3: kimjongun (small blind) folded before Flop
Seat 4: TurnOnTuneInDropOut (big blind) folded before Flop
Seat 5: soundfsilenz collected ($1000)
Seat 6: slotmachine folded before Flop (didn't bet)

PokerStars Hand #1922877873: Omaha Pot Limit ($200/$400 USD) - 2020/10/23 13:52:01 ET
Table 'ADA179504417' 6-max Seat #5 is the button
Seat 1: ag2703 ($83272 in chips)
Seat 2: MadMonkey ($25514 in chips)
Seat 3: kimjongun ($73720 in chips)
Seat 4: TurnOnTuneInDropOut ($28000 in chips)
Seat 5: soundfsilenz ($37441 in chips)
Seat 6: slotmachine ($70376 in chips)
slotmachine: posts small blind $200
ag2703: posts big blind $400
*** HOLE CARDS ***
Dealt to TurnOnTuneInDropOut [Th 3d Jc Td]
MadMonkey: folds
kimjongun: folds
TurnOnTuneInDropOut: folds
soundfsilenz: folds
slotmachine: folds
Uncalled bet ($200) returned to ag2703
ag2703 collected $400 from pot
ag2703: doesn't show hand
*** SUMMARY ***
Total pot $400 | Rake $0
Seat 1: ag2703 (big blind) collected ($400)
Seat 2: MadMonkey folded before Flop (didn't bet)
Seat 3: kimjongun folded before Flop (didn't bet)
Seat 4: TurnOnTuneInDropOut folded before Flop (didn't bet)
Seat 5: soundfsilenz (button) folded before Flop (didn't bet)
Seat 6: slotmachine (small blind) folded before Flop

PokerStars Hand #1922877874: Omaha Pot Limit ($200/$400 USD) - 2020/10/23 13:52:27 ET
Table 'ADA179504417' 6-max Seat #6 is the button
Seat 1: ag2703 ($83472 in chips)
Seat 2: MadMonkey ($25514 in chips)
Seat 3: kimjongun ($73720 in chips)
Seat 4: TurnOnTuneInDropOut ($28000 in chips)
Seat 5: soundfsilenz ($37441 in chips)
Seat 6: slotmachine ($70176 in chips)
ag2703: posts small blind $200
MadMonkey: posts big blind $400
*** HOLE CARDS ***
Dealt to TurnOnTuneInDropOut [Qs Jd Th 5d]
kimjongun: folds
TurnOnTuneInDropOut: folds
soundfsilenz: raises $1000 to $1400
slotmachine: folds
ag2703: folds
MadMonkey: folds
Uncalled bet ($1000) returned to soundfsilenz
soundfsilenz collected $1000 from pot
soundfsilenz: doesn't show hand
*** SUMMARY ***
Total pot $1000 | Rake $0
Seat 1: ag2703 (small blind) folded before Flop
Seat 2: MadMonkey (big blind) folded before Flop
Seat 3: kimjongun folded before Flop (didn't bet)
Seat 4: TurnOnTuneInDropOut folded before Flop (didn't bet)
Seat 5: soundfsilenz collected ($1000)
Seat 6: slotmachine (button) folded before Flop (didn't bet)

PokerStars Hand #1922877875: Omaha Pot Limit ($200/$400 USD) - 2020/10/23 13:53:01 ET
Table 'ADA179504417' 6-max Seat #1 is the button
Seat 1: ag2703 ($83272 in chips)
Seat 2: MadMonkey ($25114 in chips)
Seat 3: kimjongun ($73720 in chips)
Seat 4: TurnOnTuneInDropOut ($28000 in chips)
Seat 5: soundfsilenz ($38041 in chips)
Seat 6: slotmachine ($70176 in chips)
MadMonkey: posts small blind $200
kimjongun: posts big blind $400
*** HOLE CARDS ***
Dealt to TurnOnTuneInDropOut [Jh 4h Ah 3s]
TurnOnTuneInDropOut: folds
soundfsilenz: folds
slotmachine: folds
ag2703: calls $400
MadMonkey: calls $200
kimjongun: checks
*** FLOP *** [9d 8s 4c]
MadMonkey: bets $400
kimjongun: folds
ag2703: calls $400
*** TURN *** [9d 8s 4c] [3d]
MadMonkey: checks
ag2703: checks
*** RIVER *** [9d 8s 4c 3d] [Kc]
MadMonkey: checks
ag2703: bets $2000
MadMonkey: folds
Uncalled bet ($2000) returned to ag2703
ag2703 collected $1920 from pot
ag2703: doesn't show hand
*** SUMMARY ***
Total pot $2000 | Rake $80
Board [9d 8s 4c 3d Kc]
Seat 1: ag2703 (button) collected ($1920)
Seat 2: MadMonkey (small blind) folded on the River
Seat 3: kimjongun (big blind) folded on the Flop
Seat 4: TurnOnTuneInDropOut folded before Flop (didn't bet)
Seat 5: soundfsilenz folded before Flop (didn't bet)
Seat 6: slotmachine folded before Flop (didn't bet)

PokerStars Hand #1922877876: Omaha Pot Limit ($200/$400 USD) - 2020/10/23 13:54:15 ET
Table 'ADA179504417' 6-max Seat #2 is the button
Seat 1: ag2703 ($84392 in chips)
Seat 2: MadMonkey ($24314 in chips)
Seat 3: kimjongun ($73320 in chips)
Seat 4: TurnOnTuneInDropOut ($28000 in chips)
Seat 5: soundfsilenz ($38041 in chips)
Seat 6: slotmachine ($70176 in chips)
kimjongun: posts small blind $200
TurnOnTuneInDropOut: posts big blind $400
*** HOLE CARDS ***
Dealt to TurnOnTuneInDropOut [6c Td Ac 8h]
soundfsilenz: raises $1000 to $1400
slotmachine: folds
ag2703: folds
MadMonkey: folds
kimjongun: folds
TurnOnTuneInDropOut: calls $1000
*** FLOP *** [5d Qs Ks]
TurnOnTuneInDropOut: checks
soundfsilenz: bets $2010
TurnOnTuneInDropOut: folds
Uncalled bet ($2010) returned to soundfsilenz
soundfsilenz collected $2880 from pot
soundfsilenz: doesn't show hand
*** SUMMARY ***
Total pot $3000 | Rake $120
Board [5d Qs Ks]
Seat 1: ag2703 folded before Flop (didn't bet)
Seat 2: MadMonkey (button) folded before Flop (didn't bet)
Seat 3: kimjongun (small blind) folded before Flop
Seat 4: TurnOnTuneInDropOut (big blind) folded on the Flop
Seat 5: soundfsilenz collected ($2880)
Seat 6: slotmachine folded before Flop (didn't bet)

PokerStars Hand #1922877877: Omaha Pot Limit ($200/$400 USD) - 2020/10/23 13:55:04 ET
Table 'ADA179504417' 6-max Seat #3 is the button
Seat 1: ag2703 ($84392 in chips)
Seat 2: MadMonkey ($24314 in chips)
Seat 3: kimjongun ($73120 in chips)
Seat 4: TurnOnTuneInDropOut ($26600 in chips)
Seat 5: soundfsilenz ($39521 in chips)
Seat 6: slotmachine ($70176 in chips)
TurnOnTuneInDropOut: posts small blind $200
soundfsilenz: posts big blind $400
*** HOLE CARDS ***
Dealt to TurnOnTuneInDropOut [4c 7c Jh 3h]
slotmachine: folds
ag2703: folds
MadMonkey: folds
kimjongun: folds
TurnOnTuneInDropOut: folds
Uncalled bet ($200) returned to soundfsilenz
soundfsilenz collected $400 from pot
soundfsilenz: doesn't show hand
*** SUMMARY ***
Total pot $400 | Rake $0
Seat 1: ag2703 folded before Flop (didn't bet)
Seat 2: MadMonkey folded before Flop (didn't bet)
Seat 3: kimjongun (button) folded before Flop (didn't bet)
Seat 4: TurnOnTuneInDropOut (small blind) folded before Flop
Seat 5: soundfsilenz (big blind) collected ($400)
Seat 6: slotmachine folded before Flop (didn't bet)

PokerStars Hand #1922877879: Omaha Pot Limit ($200/$400 USD) - 2020/10/23 13:56:30 ET
Table 'ADA179504417' 6-max Seat #5 is the button
Seat 1: ag2703 ($82592 in chips)
Seat 2: MadMonkey ($24314 in chips)
Seat 3: kimjongun ($73120 in chips)
Seat 4: TurnOnTuneInDropOut ($28632 in chips)
Seat 5: soundfsilenz ($39521 in chips)
Seat 6: slotmachine ($69776 in chips)
slotmachine: posts small blind $200
ag2703: posts big blind $400
*** HOLE CARDS ***
Dealt to TurnOnTuneInDropOut [7h 3d Ts Jh]
MadMonkey: folds
kimjongun: folds
TurnOnTuneInDropOut: folds
soundfsilenz: folds
slotmachine: folds
Uncalled bet ($200) returned to ag2703
ag2703 collected $400 from pot
ag2703: doesn't show hand
*** SUMMARY ***
Total pot $400 | Rake $0
Seat 1: ag2703 (big blind) collected ($400)
Seat 2: MadMonkey folded before Flop (didn't bet)
Seat 3: kimjongun folded before Flop (didn't bet)
Seat 4: TurnOnTuneInDropOut folded before Flop (didn't bet)
Seat 5: soundfsilenz (button) folded before Flop (didn't bet)
Seat 6: slotmachine (small blind) folded before Flop

PokerStars Hand #1922877880: Omaha Pot Limit ($200/$400 USD) - 2020/10/23 13:56:56 ET
Table 'ADA179504417' 6-max Seat #6 is the button
Seat 1: ag2703 ($82792 in chips)
Seat 2: MadMonkey ($24314 in chips)
Seat 3: kimjongun ($73120 in chips)
Seat 4: TurnOnTuneInDropOut ($28632 in chips)
Seat 5: soundfsilenz ($39521 in chips)
Seat 6: slotmachine ($69576 in chips)
ag2703: posts small blind $200
MadMonkey: posts big blind $400
*** HOLE CARDS ***
Dealt to TurnOnTuneInDropOut [Ts As 6d 4d]
kimjongun: folds
TurnOnTuneInDropOut: raises $1000 to $1400
soundfsilenz: folds
slotmachine: folds
ag2703: calls $1200
MadMonkey: folds
*** FLOP *** [Kd Jh 7d]
ag2703: checks
TurnOnTuneInDropOut: checks
*** TURN *** [Kd Jh 7d] [4c]
ag2703: checks
TurnOnTuneInDropOut: checks
*** RIVER *** [Kd Jh 7d 4c] [5h]
ag2703: bets $3200
TurnOnTuneInDropOut: folds
Uncalled bet ($3200) returned to ag2703
ag2703: shows [6h Th Td Kc]
ag2703 collected $3072 from pot
*** SUMMARY ***
Total pot $3200 | Rake $128
Board [Kd Jh 7d 4c 5h]
Seat 1: ag2703 (small blind) collected ($3072)
Seat 2: MadMonkey (big blind) folded before Flop
Seat 3: kimjongun folded before Flop (didn't bet)
Seat 4: TurnOnTuneInDropOut folded on the River
Seat 5: soundfsilenz folded before Flop (didn't bet)
Seat 6: slotmachine (button) folded before Flop (didn't bet)

PokerStars Hand #1922877881: Omaha Pot Limit ($200/$400 USD) - 2020/10/23 13:58:19 ET
Table 'ADA179504417' 6-max Seat #1 is the button
Seat 1: ag2703 ($84464 in chips)
Seat 2: MadMonkey ($23914 in chips)
Seat 3: kimjongun ($73120 in chips)
Seat 4: TurnOnTuneInDropOut ($27232 in chips)
Seat 5: soundfsilenz ($39521 in chips)
Seat 6: slotmachine ($69576 in chips)
MadMonkey: posts small blind $200
kimjongun: posts big blind $400
*** HOLE CARDS ***
Dealt to TurnOnTuneInDropOut [6h Jh 2s As]
TurnOnTuneInDropOut: folds
soundfsilenz: folds
slotmachine: folds
ag2703: raises $1000 to $1400
MadMonkey: calls $1200
kimjongun: calls $1000
*** FLOP *** [6d 4s Js]
MadMonkey: bets $2100
kimjongun: calls $2100
ag2703: raises $10500 to $12600
MadMonkey: folds
kimjongun: folds
Uncalled bet ($10500) returned to ag2703
ag2703 collected $10079 from pot
ag2703: doesn't show hand
*** SUMMARY ***
Total pot $10500 | Rake $421
Board [6d 4s Js]
Seat 1: ag2703 (button) collected ($10079)
Seat 2: MadMonkey (small blind) folded on the Flop
Seat 3: kimjongun (big blind) folded on the Flop
Seat 4: TurnOnTuneInDropOut folded before Flop (didn't bet)
Seat 5: soundfsilenz folded before Flop (didn't bet)
Seat 6: slotmachine folded before Flop (didn't bet)

PokerStars Hand #1922877885: Omaha Pot Limit ($200/$400 USD) - 2020/10/23 14:02:09 ET
Table 'ADA179504417' 6-max Seat #5 is the button
Seat 1: ag2703 ($89803 in chips)
Seat 2: MadMonkey ($20414 in chips)
Seat 3: kimjongun ($71652 in chips)
Seat 4: TurnOnTuneInDropOut ($27232 in chips)
Seat 5: soundfsilenz ($38921 in chips)
Seat 6: slotmachine ($69176 in chips)
slotmachine: posts small blind $200
ag2703: posts big blind $400
*** HOLE CARDS ***
Dealt to TurnOnTuneInDropOut [3h Js 9h 3c]
MadMonkey: raises $400 to $800
kimjongun: raises $2200 to $3000
TurnOnTuneInDropOut: folds
soundfsilenz: folds
slotmachine: folds
ag2703: calls $2600
MadMonkey: calls $2200
*** FLOP *** [Jd 6d 6s]
ag2703: checks
MadMonkey: checks
kimjongun: bets $3220
ag2703: calls $3220
MadMonkey: folds
*** TURN *** [Jd 6d 6s] [Qs]
ag2703: checks
kimjongun: checks
*** RIVER *** [Jd 6d 6s Qs] [8s]
ag2703: checks
kimjongun: checks
*** SHOW DOWN ***
ag2703: shows [7d 7c Ad 4c]
kimjongun: mucks hand
ag2703 collected $15013 from pot
*** SUMMARY ***
Total pot $15640 | Rake $627
Board [Jd 6d 6s Qs 8s]
Seat 1: ag2703 (big blind) showed [7d 7c Ad 4c] and won ($15013)
Seat 2: MadMonkey folded on the Flop
Seat 3: kimjongun mucked
Seat 4: TurnOnTuneInDropOut folded before Flop (didn't bet)
Seat 5: soundfsilenz (button) folded before Flop (didn't bet)
Seat 6: slotmachine (small blind) folded before Flop

PokerStars Hand #1922877886: Omaha Pot Limit ($200/$400 USD) - 2020/10/23 14:02:55 ET
Table 'ADA179504417' 6-max Seat #6 is the button
Seat 1: ag2703 ($98596 in chips)
Seat 2: MadMonkey ($17414 in chips)
Seat 3: kimjongun ($65432 in chips)
Seat 4: TurnOnTuneInDropOut ($27232 in chips)
Seat 5: soundfsilenz ($38921 in chips)
Seat 6: slotmachine ($68976 in chips)
ag2703: posts small blind $200
MadMonkey: posts big blind $400
*** HOLE CARDS ***
Dealt to TurnOnTuneInDropOut [Ts 6d Ad Th]
kimjongun: folds
TurnOnTuneInDropOut: raises $1000 to $1400
soundfsilenz: folds
slotmachine: calls $1400
ag2703: calls $1200
MadMonkey: folds
*** FLOP *** [Tc 4h 9s]
ag2703: checks
TurnOnTuneInDropOut: bets $4050
slotmachine: folds
ag2703: folds
Uncalled bet ($4050) returned to TurnOnTuneInDropOut
TurnOnTuneInDropOut collected $4416 from pot
TurnOnTuneInDropOut: doesn't show hand
*** SUMMARY ***
Total pot $4600 | Rake $184
Board [Tc 4h 9s]
Seat 1: ag2703 (small blind) folded on the Flop
Seat 2: MadMonkey (big blind) folded before Flop
Seat 3: kimjongun folded before Flop (didn't bet)
Seat 4: TurnOnTuneInDropOut collected ($4416)
Seat 5: soundfsilenz folded before Flop (didn't bet)
Seat 6: slotmachine (button) folded on the Flop

PokerStars Hand #1922877887: Omaha Pot Limit ($200/$400 USD) - 2020/10/23 14:03:44 ET
Table 'ADA179504417' 6-max Seat #1 is the button
Seat 1: ag2703 ($97196 in chips)
Seat 2: MadMonkey ($17014 in chips)
Seat 3: kimjongun ($65432 in chips)
Seat 4: TurnOnTuneInDropOut ($30248 in chips)
Seat 5: soundfsilenz ($38921 in chips)
Seat 6: slotmachine ($67576 in chips)
MadMonkey: posts small blind $200
kimjongun: posts big blind $400
*** HOLE CARDS ***
Dealt to TurnOnTuneInDropOut [5d 4d 9h 9c]
TurnOnTuneInDropOut: folds
soundfsilenz: folds
slotmachine: raises $1000 to $1400
ag2703: calls $1400
MadMonkey: folds
kimjongun: raises $4400 to $5800
slotmachine: calls $4400
ag2703: calls $4400
*** FLOP *** [Kc Th 7c]
kimjongun: checks
slotmachine: bets $11616
ag2703: calls $11616
kimjongun: folds
*** TURN *** [Kc Th 7c] [5s]
slotmachine: bets $33424
ag2703: folds
Uncalled bet ($33424) returned to slotmachine
slotmachine collected $40032 from pot
slotmachine: doesn't show hand
*** SUMMARY ***
Total pot $40832 | Rake $800
Board [Kc Th 7c 5s]
Seat 1: ag2703 (button) folded on the Turn
Seat 2: MadMonkey (small blind) folded before Flop
Seat 3: kimjongun (big blind) folded on the Flop
Seat 4: TurnOnTuneInDropOut folded before Flop (didn't bet)
Seat 5: soundfsilenz folded before Flop (didn't bet)
Seat 6: slotmachine collected ($40032)

PokerStars Hand #1922877894: Omaha Pot Limit ($200/$400 USD) - 2020/10/23 14:11:04 ET
Table 'ADA179504417' 6-max Seat #3 is the button
Seat 1: ag2703 ($78190 in chips)
Seat 2: MadMonkey ($16774 in chips)
Seat 3: kimjongun ($63801 in chips)
Seat 4: TurnOnTuneInDropOut ($29848 in chips)
Seat 5: soundfsilenz ($37521 in chips)
Seat 6: slotmachine ($88800 in chips)
TurnOnTuneInDropOut: posts small blind $200
soundfsilenz: posts big blind $400
*** HOLE CARDS ***
Dealt to TurnOnTuneInDropOut [9d 9h 9s Ad]
slotmachine: raises $1000 to $1400
ag2703: folds
MadMonkey: calls $1400
kimjongun: calls $1400
TurnOnTuneInDropOut: folds
soundfsilenz: folds
*** FLOP *** [8c 2c Js]
slotmachine: checks
MadMonkey: checks
kimjongun: bets $2400
slotmachine: folds
MadMonkey: folds
Uncalled bet ($2400) returned to kimjongun
kimjongun collected $4608 from pot
kimjongun: doesn't show hand
*** SUMMARY ***
Total pot $4800 | Rake $192
Board [8c 2c Js]
Seat 1: ag2703 folded before Flop (didn't bet)
Seat 2: MadMonkey folded on the Flop
Seat 3: kimjongun (button) collected ($4608)
Seat 4: TurnOnTuneInDropOut (small blind) folded before Flop
Seat 5: soundfsilenz (big blind) folded before Flop
Seat 6: slotmachine folded on the Flop

PokerStars Hand #1922877896: Omaha Pot Limit ($200/$400 USD) - 2020/10/23 14:13:26 ET
Table 'ADA179504417' 6-max Seat #5 is the button
Seat 1: ag2703 ($72190 in chips)
Seat 2: MadMonkey ($21469 in chips)
Seat 3: kimjongun ($67009 in chips)
Seat 4: TurnOnTuneInDropOut ($29648 in chips)
Seat 5: soundfsilenz ($36921 in chips)
Seat 6: slotmachine ($87000 in chips)
slotmachine: posts small blind $200
ag2703: posts big blind $400
*** HOLE CARDS ***
Dealt to TurnOnTuneInDropOut [Kh 4s 3c As]
MadMonkey: folds
kimjongun: folds
TurnOnTuneInDropOut: raises $1000 to $1400
soundfsilenz: calls $1400
slotmachine: folds
ag2703: calls $1000
*** FLOP *** [9h Ad Qh]
ag2703: checks
TurnOnTuneInDropOut: bets $2904
soundfsilenz: calls $2904
ag2703: calls $2904
*** TURN *** [9h Ad Qh] [Jd]
ag2703: checks
TurnOnTuneInDropOut: checks
soundfsilenz: checks
*** RIVER *** [9h Ad Qh Jd] [7s]
ag2703: checks
TurnOnTuneInDropOut: checks
soundfsilenz: checks
*** SHOW DOWN ***
ag2703: shows [Ac 5d Qd 5s]
soundfsilenz: mucks hand
ag2703 collected $12586 from pot
*** SUMMARY ***
Total pot $13112 | Rake $526
Board [9h Ad Qh Jd 7s]
Seat 1: ag2703 (big blind) showed [Ac 5d Qd 5s] and won ($12586)
Seat 2: MadMonkey folded before Flop (didn't bet)
Seat 3: kimjongun folded before Flop (didn't bet)
Seat 4: TurnOnTuneInDropOut
Seat 5: soundfsilenz (button) mucked
Seat 6: slotmachine (small blind) folded before Flop

PokerStars Hand #1922877897: Omaha Pot Limit ($200/$400 USD) - 2020/10/23 14:15:12 ET
Table 'ADA179504417' 6-max Seat #6 is the button
Seat 1: ag2703 ($80472 in chips)
Seat 2: MadMonkey ($21469 in chips)
Seat 3: kimjongun ($67009 in chips)
Seat 4: TurnOnTuneInDropOut ($25344 in chips)
Seat 5: soundfsilenz ($32617 in chips)
Seat 6: slotmachine ($86800 in chips)
ag2703: posts small blind $200
MadMonkey: posts big blind $400
*** HOLE CARDS ***
Dealt to TurnOnTuneInDropOut [4d 7s 4h Jd]
kimjongun: folds
TurnOnTuneInDropOut: folds
soundfsilenz: raises $1000 to $1400
slotmachine: folds
ag2703: folds
MadMonkey: folds
Uncalled bet ($1000) returned to soundfsilenz
soundfsilenz collected $1000 from pot
soundfsilenz: doesn't show hand
*** SUMMARY ***
Total pot $1000 | Rake $0
Seat 1: ag2703 (small blind) folded before Flop
Seat 2: MadMonkey (big blind) folded before Flop
Seat 3: kimjongun folded before Flop (didn't bet)
Seat 4: TurnOnTuneInDropOut folded before Flop (didn't bet)
Seat 5: soundfsilenz collected ($1000)
Seat 6: slotmachine (button) folded before Flop (didn't bet)

PokerStars Hand #1922877898: Omaha Pot Limit ($200/$400 USD) - 2020/10/23 14:15:58 ET
Table 'ADA179504417' 6-max Seat #1 is the button
Seat 1: ag2703 ($80272 in chips)
Seat 2: MadMonkey ($21069 in chips)
Seat 3: kimjongun ($67009 in chips)
Seat 4: TurnOnTuneInDropOut ($48000 in chips)
Seat 5: soundfsilenz ($33217 in chips)
Seat 6: slotmachine ($86800 in chips)
MadMonkey: posts small blind $200
kimjongun: posts big blind $400
*** HOLE CARDS ***
Dealt to TurnOnTuneInDropOut [Kc Qc Jh Qh]
TurnOnTuneInDropOut: raises $1000 to $1400
soundfsilenz: folds
slotmachine: calls $1400
ag2703: folds
MadMonkey: folds
kimjongun: folds
*** FLOP *** [9h Kd 7h]
TurnOnTuneInDropOut: checks
slotmachine: bets $3400
TurnOnTuneInDropOut: calls $3400
*** TURN *** [9h Kd 7h] [Js]
TurnOnTuneInDropOut: checks
slotmachine: bets $5100
TurnOnTuneInDropOut: raises $13425 to $18525
slotmachine: calls $13425
*** RIVER *** [9h Kd 7h Js] [7d]
TurnOnTuneInDropOut: checks
slotmachine: bets $35438
TurnOnTuneInDropOut: folds
Uncalled bet ($35438) returned to slotmachine
slotmachine collected $46450 from pot
slotmachine: doesn't show hand
*** SUMMARY ***
Total pot $47250 | Rake $800
Board [9h Kd 7h Js 7d]
Seat 1: ag2703 (button) folded before Flop (didn't bet)
Seat 2: MadMonkey (small blind) folded before Flop
Seat 3: kimjongun (big blind) folded before Flop
Seat 4: TurnOnTuneInDropOut folded on the River
Seat 5: soundfsilenz folded before Flop (didn't bet)
Seat 6: slotmachine collected ($46450)

PokerStars Hand #1922877904: Omaha Pot Limit ($200/$400 USD) - 2020/10/23 14:23:44 ET
Table 'ADA179504417' 6-max Seat #2 is the button
Seat 1: ag2703 ($74572 in chips)
Seat 2: MadMonkey ($25040 in chips)
Seat 3: kimjongun ($66009 in chips)
Seat 4: TurnOnTuneInDropOut ($48000 in chips)
Seat 5: soundfsilenz ($35376 in chips)
Seat 6: slotmachine ($109325 in chips)
kimjongun: posts small blind $200
TurnOnTuneInDropOut: posts big blind $400
*** HOLE CARDS ***
Dealt to TurnOnTuneInDropOut [5h Tc As Js]
soundfsilenz: folds
slotmachine: raises $1000 to $1400
ag2703: folds
MadMonkey: calls $1400
kimjongun: folds
TurnOnTuneInDropOut: calls $1000
*** FLOP *** [3s 6c Qc]
TurnOnTuneInDropOut: checks
slotmachine: checks
MadMonkey: checks
*** TURN *** [3s 6c Qc] [2c]
TurnOnTuneInDropOut: checks
slotmachine: checks
MadMonkey: checks
*** RIVER *** [3s 6c Qc 2c] [Kc]
TurnOnTuneInDropOut: checks
slotmachine: checks
MadMonkey: checks
*** SHOW DOWN ***
slotmachine: mucks hand
MadMonkey: shows [Ks 7c 7d Kd]
MadMonkey collected $4224 from pot
*** SUMMARY ***
Total pot $4400 | Rake $176
Board [3s 6c Qc 2c Kc]
Seat 1: ag2703 folded before Flop (didn't bet)
Seat 2: MadMonkey (button) showed [Ks 7c 7d Kd] and won ($4224)
Seat 3: kimjongun (small blind) folded before Flop
Seat 4: TurnOnTuneInDropOut (big blind)
Seat 5: soundfsilenz folded before Flop (didn't bet)
Seat 6: slotmachine mucked

PokerStars Hand #1922877906: Omaha Pot Limit ($200/$400 USD) - 2020/10/23 14:26:23 ET
Table 'ADA179504417' 6-max Seat #4 is the button
Seat 1: ag2703 ($75132 in chips)
Seat 3: kimjongun ($65809 in chips)
Seat 4: TurnOnTuneInDropOut ($46400 in chips)
Seat 5: soundfsilenz ($34976 in chips)
Seat 6: slotmachine ($107925 in chips)
soundfsilenz: posts small blind $200
slotmachine: posts big blind $400
*** HOLE CARDS ***
Dealt to TurnOnTuneInDropOut [9s 9c Th Tc]
ag2703: raises $400 to $800
kimjongun: folds
TurnOnTuneInDropOut: raises $2200 to $3000
soundfsilenz: folds
slotmachine: folds
ag2703: calls $2200
*** FLOP *** [7h 2s Kh]
ag2703: checks
TurnOnTuneInDropOut: bets $3300
ag2703: calls $3300
*** TURN *** [7h 2s Kh] [Td]
ag2703: checks
TurnOnTuneInDropOut: bets $13200
ag2703: folds
Uncalled bet ($13200) returned to TurnOnTuneInDropOut
TurnOnTuneInDropOut collected $12671 from pot
TurnOnTuneInDropOut: doesn't show hand
*** SUMMARY ***
Total pot $13200 | Rake $529
Board [7h 2s Kh Td]
Seat 1: ag2703 folded on the Turn
Seat 3: kimjongun folded before Flop (didn't bet)
Seat 4: TurnOnTuneInDropOut (button) collected ($12671)
Seat 5: soundfsilenz (small blind) folded before Flop
Seat 6: slotmachine (big blind) folded before Flop

PokerStars Hand #1922877907: Omaha Pot Limit ($200/$400 USD) - 2020/10/23 14:27:24 ET
Table 'ADA179504417' 6-max Seat #5 is the button
Seat 1: ag2703 ($68832 in chips)
Seat 4: TurnOnTuneInDropOut ($52771 in chips)
Seat 5: soundfsilenz ($34776 in chips)
Seat 6: slotmachine ($107525 in chips)
slotmachine: posts small blind $200
ag2703: posts big blind $400
*** HOLE CARDS ***
Dealt to TurnOnTuneInDropOut [8c 4d 8s Tc]
TurnOnTuneInDropOut: folds
soundfsilenz: folds
slotmachine: raises $800 to $1200
ag2703: calls $800
*** FLOP *** [8d 6c 7h]
slotmachine: checks
ag2703: bets $2400
slotmachine: folds
Uncalled bet ($2400) returned to ag2703
ag2703 collected $2304 from pot
ag2703: doesn't show hand
*** SUMMARY ***
Total pot $2400 | Rake $96
Board [8d 6c 7h]
Seat 1: ag2703 (big blind) collected ($2304)
Seat 4: TurnOnTuneInDropOut folded before Flop (didn't bet)
Seat 5: soundfsilenz (button) folded before Flop (didn't bet)
Seat 6: slotmachine (small blind) folded on the Flop

PokerStars Hand #1922877908: Omaha Pot Limit ($200/$400 USD) - 2020/10/23 14:28:02 ET
Table 'ADA179504417' 6-max Seat #6 is the button
Seat 1: ag2703 ($69936 in chips)
Seat 2: CarlJung ($12000 in chips)
Seat 4: TurnOnTuneInDropOut ($52771 in chips)
Seat 5: soundfsilenz ($34776 in chips)
Seat 6: slotmachine ($106325 in chips)
ag2703: posts small blind $200
CarlJung: posts big blind $400
*** HOLE CARDS ***
Dealt to TurnOnTuneInDropOut [8h 9c 3c 3s]
TurnOnTuneInDropOut: folds
soundfsilenz: folds
slotmachine: raises $1000 to $1400
ag2703: folds
CarlJung: calls $1000
*** FLOP *** [8d 6h 9s]
CarlJung: checks
slotmachine: bets $1980
CarlJung: folds
Uncalled bet ($1980) returned to slotmachine
slotmachine collected $2880 from pot
slotmachine: doesn't show hand
*** SUMMARY ***
Total pot $3000 | Rake $120
Board [8d 6h 9s]
Seat 1: ag2703 (small blind) folded before Flop
Seat 2: CarlJung (big blind) folded on the Flop
Seat 4: TurnOnTuneInDropOut folded before Flop (didn't bet)
Seat 5: soundfsilenz folded before Flop (didn't bet)
Seat 6: slotmachine (button) collected ($2880)

PokerStars Hand #1922877909: Omaha Pot Limit ($200/$400 USD) - 2020/10/23 14:28:45 ET
Table 'ADA179504417' 6-max Seat #1 is the button
Seat 1: ag2703 ($69736 in chips)
Seat 2: CarlJung ($10600 in chips)
Seat 3: kimjongun ($65809 in chips)
Seat 4: TurnOnTuneInDropOut ($52771 in chips)
Seat 5: soundfsilenz ($34776 in chips)
Seat 6: slotmachine ($107805 in chips)
CarlJung: posts small blind $200
kimjongun: posts big blind $400
*** HOLE CARDS ***
Dealt to TurnOnTuneInDropOut [As 9s Kh Ah]
TurnOnTuneInDropOut: raises $1000 to $1400
soundfsilenz: folds
slotmachine: folds
ag2703: calls $1400
CarlJung: folds
kimjongun: folds
*** FLOP *** [Jc Ad 3h]
TurnOnTuneInDropOut: bets $2550
ag2703: folds
Uncalled bet ($2550) returned to TurnOnTuneInDropOut
TurnOnTuneInDropOut collected $3264 from pot
TurnOnTuneInDropOut: doesn't show hand
*** SUMMARY ***
Total pot $3400 | Rake $136
Board [Jc Ad 3h]
Seat 1: ag2703 (button) folded on the Flop
Seat 2: CarlJung (small blind) folded before Flop
Seat 3: kimjongun (big blind) folded before Flop
Seat 4: TurnOnTuneInDropOut collected ($3264)
Seat 5: soundfsilenz folded before Flop (didn't bet)
Seat 6: slotmachine folded before Flop (didn't bet)

PokerStars Hand #1922877910: Omaha Pot Limit ($200/$400 USD) - 2020/10/23 14:29:30 ET
Table 'ADA179504417' 6-max Seat #2 is the button
Seat 1: ag2703 ($68336 in chips)
Seat 2: CarlJung ($10400 in chips)
Seat 3: kimjongun ($65409 in chips)
Seat 4: TurnOnTuneInDropOut ($54635 in chips)
Seat 5: soundfsilenz ($34776 in chips)
Seat 6: slotmachine ($107805 in chips)
kimjongun: posts small blind $200
TurnOnTuneInDropOut: posts big blind $400
*** HOLE CARDS ***
Dealt to TurnOnTuneInDropOut [2d Ts 9h Td]
soundfsilenz: folds
slotmachine: raises $1000 to $1400
ag2703: folds
CarlJung: folds
kimjongun: folds
TurnOnTuneInDropOut: folds
Uncalled bet ($1000) returned to slotmachine
slotmachine collected $1000 from pot
slotmachine: doesn't show hand
*** SUMMARY ***
Total pot $1000 | Rake $0
Seat 1: ag2703 folded before Flop (didn't bet)
Seat 2: CarlJung (button) folded before Flop (didn't bet)
Seat 3: kimjongun (small blind) folded before Flop
Seat 4: TurnOnTuneInDropOut (big blind) folded before Flop
Seat 5: soundfsilenz folded before Flop (didn't bet)
Seat 6: slotmachine collected ($1000)

PokerStars Hand #1922877911: Omaha Pot Limit ($200/$400 USD) - 2020/10/23 14:30:03 ET
Table 'ADA179504417' 6-max Seat #3 is the button
Seat 1: ag2703 ($68336 in chips)
Seat 2: CarlJung ($10400 in chips)
Seat 3: kimjongun ($65209 in chips)
Seat 4: TurnOnTuneInDropOut ($54235 in chips)
Seat 5: soundfsilenz ($34776 in chips)
Seat 6: slotmachine ($108405 in chips)
TurnOnTuneInDropOut: posts small blind $200
soundfsilenz: posts big blind $400
*** HOLE CARDS ***
Dealt to TurnOnTuneInDropOut [2h 2d 4d 8s]
slotmachine: raises $1000 to $1400
ag2703: folds
CarlJung: folds
kimjongun: folds
TurnOnTuneInDropOut: folds
soundfsilenz: folds
Uncalled bet ($1000) returned to slotmachine
slotmachine collected $1000 from pot
slotmachine: doesn't show hand
*** SUMMARY ***
Total pot $1000 | Rake $0
Seat 1: ag2703 folded before Flop (didn't bet)
Seat 2: CarlJung folded before Flop (didn't bet)
Seat 3: kimjongun (button) folded before Flop (didn't bet)
Seat 4: TurnOnTuneInDropOut (small blind) folded before Flop
Seat 5: soundfsilenz (big blind) folded before Flop
Seat 6: slotmachine collected ($1000)

PokerStars Hand #1922877913: Omaha Pot Limit ($200/$400 USD) - 2020/10/23 14:31:55 ET
Table 'ADA179504417' 6-max Seat #5 is the button
Seat 1: ag2703 ($66536 in chips)
Seat 2: CarlJung ($10400 in chips)
Seat 3: kimjongun ($65209 in chips)
Seat 4: TurnOnTuneInDropOut ($56267 in chips)
Seat 5: soundfsilenz ($34176 in chips)
Seat 6: slotmachine ($108605 in chips)
slotmachine: posts small blind $200
ag2703: posts big blind $400
*** HOLE CARDS ***
Dealt to TurnOnTuneInDropOut [7s 8d 6c 4d]
CarlJung: folds
kimjongun: folds
TurnOnTuneInDropOut: folds
soundfsilenz: raises $1000 to $1400
slotmachine: folds
ag2703: calls $1000
*** FLOP *** [Qs 7h 8h]
ag2703: checks
soundfsilenz: bets $2010
ag2703: calls $2010
*** TURN *** [Qs 7h 8h] [Qc]
ag2703: checks
soundfsilenz: checks
*** RIVER *** [Qs 7h 8h Qc] [9c]
ag2703: bets $7020
soundfsilenz: folds
Uncalled bet ($7020) returned to ag2703
ag2703 collected $6738 from pot
ag2703: doesn't show hand
*** SUMMARY ***
Total pot $7020 | Rake $282
Board [Qs 7h 8h Qc 9c]
Seat 1: ag2703 (big blind) collected ($6738)
Seat 2: CarlJung folded before Flop (didn't bet)
Seat 3: kimjongun folded before Flop (didn't bet)
Seat 4: TurnOnTuneInDropOut folded before Flop (didn't bet)
Seat 5: soundfsilenz (button) folded on the River
Seat 6: slotmachine (small blind) folded before Flop

PokerStars Hand #1922877914: Omaha Pot Limit ($200/$400 USD) - 2020/10/23 14:33:32 ET
Table 'ADA179504417' 6-max Seat #6 is the button
Seat 1: ag2703 ($69864 in chips)
Seat 2: CarlJung ($10400 in chips)
Seat 3: kimjongun ($65209 in chips)
Seat 4: TurnOnTuneInDropOut ($56267 in chips)
Seat 5: soundfsilenz ($30766 in chips)
Seat 6: slotmachine ($108405 in chips)
ag2703: posts small blind $200
CarlJung: posts big blind $400
*** HOLE CARDS ***
Dealt to TurnOnTuneInDropOut [5d 5s 8h Ad]
kimjongun: folds
TurnOnTuneInDropOut: folds
soundfsilenz: folds
slotmachine: raises $1000 to $1400
ag2703: folds
CarlJung: calls $1000
*** FLOP *** [Td 6h Ac]
CarlJung: checks
slotmachine: checks
*** TURN *** [Td 6h Ac] [Ah]
CarlJung: checks
slotmachine: checks
*** RIVER *** [Td 6h Ac Ah] [4h]
CarlJung: bets $1590
slotmachine: folds
Uncalled bet ($1590) returned to CarlJung
CarlJung collected $2880 from pot
CarlJung: doesn't show hand
*** SUMMARY ***
Total pot $3000 | Rake $120
Board [Td 6h Ac Ah 4h]
Seat 1: ag2703 (small blind) folded before Flop
Seat 2: CarlJung (big blind) collected ($2880)
Seat 3: kimjongun folded before Flop (didn't bet)
Seat 4: TurnOnTuneInDropOut folded before Flop (didn't bet)
Seat 5: soundfsilenz folded before Flop (didn't bet)
Seat 6: slotmachine (button) folded on the River

PokerStars Hand #1922877915: Omaha Pot Limit ($200/$400 USD) - 2020/10/23 14:34:49 ET
Table 'ADA179504417' 6-max Seat #1 is the button
Seat 1: ag2703 ($69664 in chips)
Seat 2: CarlJung ($11880 in chips)
Seat 3: kimjongun ($65209 in chips)
Seat 4: TurnOnTuneInDropOut ($56267 in chips)
Seat 5: soundfsilenz ($30766 in chips)
Seat 6: slotmachine ($107005 in chips)
CarlJung: posts small blind $200
kimjongun: posts big blind $400
*** HOLE CARDS ***
Dealt to TurnOnTuneInDropOut [Kc As Jh 3h]
TurnOnTuneInDropOut: folds
soundfsilenz: folds
slotmachine: folds
ag2703: raises $1000 to $1400
CarlJung: folds
kimjongun: folds
Uncalled bet ($1000) returned to ag2703
ag2703 collected $1000 from pot
ag2703: doesn't show hand
*** SUMMARY ***
Total pot $1000 | Rake $0
Seat 1: ag2703 (button) collected ($1000)
Seat 2: CarlJung (small blind) folded before Flop
Seat 3: kimjongun (big blind) folded before Flop
Seat 4: TurnOnTuneInDropOut folded before Flop (didn't bet)
Seat 5: soundfsilenz folded before Flop (didn't bet)
Seat 6: slotmachine folded before Flop (didn't bet)

PokerStars Hand #1922877916: Omaha Pot Limit ($200/$400 USD) - 2020/10/23 14:35:23 ET
Table 'ADA179504417' 6-max Seat #2 is the button
Seat 1: ag2703 ($70264 in chips)
Seat 2: CarlJung ($11680 in chips)
Seat 3: kimjongun ($64809 in chips)
Seat 4: TurnOnTuneInDropOut ($56267 in chips)
Seat 5: soundfsilenz ($30766 in chips)
Seat 6: slotmachine ($107005 in chips)
kimjongun: posts small blind $200
TurnOnTuneInDropOut: posts big blind $400
*** HOLE CARDS ***
Dealt to TurnOnTuneInDropOut [8h Ks Jc Th]
soundfsilenz: raises $1000 to $1400
slotmachine: calls $1400
ag2703: folds
CarlJung: folds
kimjongun: folds
TurnOnTuneInDropOut: folds
*** FLOP *** [Ts 6d 9d]
soundfsilenz: checks
slotmachine: bets $1700
soundfsilenz: folds
Uncalled bet ($1700) returned to slotmachine
slotmachine collected $3264 from pot
slotmachine: doesn't show hand
*** SUMMARY ***
Total pot $3400 | Rake $136
Board [Ts 6d 9d]
Seat 1: ag2703 folded before Flop (didn't bet)
Seat 2: CarlJung (button) folded before Flop (didn't bet)
Seat 3: kimjongun (small blind) folded before Flop
Seat 4: TurnOnTuneInDropOut (big blind) folded before Flop
Seat 5: soundfsilenz folded on the Flop
Seat 6: slotmachine collected ($3264)

PokerStars Hand #1922877918: Omaha Pot Limit ($200/$400 USD) - 2020/10/23 14:38:18 ET
Table 'ADA179504417' 6-max Seat #4 is the button
Seat 1: ag2703 ($69864 in chips)
Seat 2: CarlJung ($11680 in chips)
Seat 3: kimjongun ($64609 in chips)
Seat 4: TurnOnTuneInDropOut ($55667 in chips)
Seat 5: soundfsilenz ($29926 in chips)
Seat 6: slotmachine ($108869 in chips)
soundfsilenz: posts small blind $200
slotmachine: posts big blind $400
*** HOLE CARDS ***
Dealt to TurnOnTuneInDropOut [Ah 5c 5d 9h]
ag2703: raises $1000 to $1400
CarlJung: folds
kimjongun: folds
TurnOnTuneInDropOut: folds
soundfsilenz: calls $1200
slotmachine: folds
*** FLOP *** [Kh Qs Th]
soundfsilenz: checks
ag2703: checks
*** TURN *** [Kh Qs Th] [Qd]
soundfsilenz: bets $1728
ag2703: calls $1728
*** RIVER *** [Kh Qs Th Qd] [4h]
soundfsilenz: checks
ag2703: bets $6656
soundfsilenz: folds
Uncalled bet ($6656) returned to ag2703
ag2703 collected $6389 from pot
ag2703: doesn't show hand
*** SUMMARY ***
Total pot $6656 | Rake $267
Board [Kh Qs Th Qd 4h]
Seat 1: ag2703 collected ($6389)
Seat 2: CarlJung folded before Flop (didn't bet)
Seat 3: kimjongun folded before Flop (didn't bet)
Seat 4: TurnOnTuneInDropOut (button) folded before Flop (didn't bet)
Seat 5: soundfsilenz (small blind) folded on the River
Seat 6: slotmachine (big blind) folded before Flop

PokerStars Hand #1922877919: Omaha Pot Limit ($200/$400 USD) - 2020/10/23 14:39:56 ET
Table 'ADA179504417' 6-max Seat #5 is the button
Seat 1: ag2703 ($73125 in chips)
Seat 2: CarlJung ($11680 in chips)
Seat 3: kimjongun ($64609 in chips)
Seat 4: TurnOnTuneInDropOut ($55667 in chips)
Seat 5: soundfsilenz ($26798 in chips)
Seat 6: slotmachine ($108469 in chips)
slotmachine: posts small blind $200
ag2703: posts big blind $400
*** HOLE CARDS ***
Dealt to TurnOnTuneInDropOut [Th 2d 8c 7c]
CarlJung: raises $1000 to $1400
kimjongun: folds
TurnOnTuneInDropOut: folds
soundfsilenz: folds
slotmachine: folds
ag2703: folds
Uncalled bet ($1000) returned to CarlJung
CarlJung collected $1000 from pot
CarlJung: doesn't show hand
*** SUMMARY ***
Total pot $1000 | Rake $0
Seat 1: ag2703 (big blind) folded before Flop
Seat 2: CarlJung collected ($1000)
Seat 3: kimjongun folded before Flop (didn't bet)
Seat 4: TurnOnTuneInDropOut folded before Flop (didn't bet)
Seat 5: soundfsilenz (button) folded before Flop (didn't bet)
Seat 6: slotmachine (small blind) folded before Flop

PokerStars Hand #1922877920: Omaha Pot Limit ($200/$400 USD) - 2020/10/23 14:40:29 ET
Table 'ADA179504417' 6-max Seat #6 is the button
Seat 1: ag2703 ($72725 in chips)
Seat 2: CarlJung ($12280 in chips)
Seat 3: kimjongun ($64609 in chips)
Seat 4: TurnOnTuneInDropOut ($55667 in chips)
Seat 5: soundfsilenz ($26798 in chips)
Seat 6: slotmachine ($108269 in chips)
ag2703: posts small blind $200
CarlJung: posts big blind $400
*** HOLE CARDS ***
Dealt to TurnOnTuneInDropOut [9c 4h Ts 8c]
kimjongun: raises $600 to $1000
TurnOnTuneInDropOut: folds
soundfsilenz: folds
slotmachine: raises $2600 to $3600
ag2703: calls $3400
CarlJung: folds
kimjongun: calls $2600
*** FLOP *** [9s 7c 7d]
ag2703: checks
kimjongun: checks
slotmachine: bets $3696
ag2703: folds
kimjongun: raises $10015 to $13711
slotmachine: calls $10015
*** TURN *** [9s 7c 7d] [8s]
kimjongun: bets $13518
slotmachine: calls $13518
*** RIVER *** [9s 7c 7d 8s] [8h]
kimjongun: bets $33780 and is all-in
slotmachine: folds
Uncalled bet ($33780) returned to kimjongun
kimjongun collected $64858 from pot
kimjongun: doesn't show hand
*** SUMMARY ***
Total pot $65658 | Rake $800
Board [9s 7c 7d 8s 8h]
Seat 1: ag2703 (small blind) folded on the Flop
Seat 2: CarlJung (big blind) folded before Flop
Seat 3: kimjongun collected ($64858)
Seat 4: TurnOnTuneInDropOut folded before Flop (didn't bet)
Seat 5: soundfsilenz folded before Flop (didn't bet)
Seat 6: slotmachine (button) folded on the River

PokerStars Hand #1922877921: Omaha Pot Limit ($200/$400 USD) - 2020/10/23 14:43:01 ET
Table 'ADA179504417' 6-max Seat #1 is the button
Seat 1: ag2703 ($69125 in chips)
Seat 2: CarlJung ($11880 in chips)
Seat 3: kimjongun ($98638 in chips)
Seat 4: TurnOnTuneInDropOut ($55667 in chips)
Seat 5: soundfsilenz ($42000 in chips)
Seat 6: slotmachine ($77440 in chips)
CarlJung: posts small blind $200
kimjongun: posts big blind $400
*** HOLE CARDS ***
Dealt to TurnOnTuneInDropOut [Ks 3c 7s 5c]
TurnOnTuneInDropOut: folds
soundfsilenz: raises $1000 to $1400
slotmachine: folds
ag2703: folds
CarlJung: calls $1200
kimjongun: raises $4200 to $5600
soundfsilenz: calls $4200
CarlJung: calls $4200
*** FLOP *** [6h Jh Ad]
CarlJung: bets $6280 and is all-in
kimjongun: calls $6280
soundfsilenz: folds
*** TURN *** [6h Jh Ad] [9s]
*** RIVER *** [6h Jh Ad 9s] [2c]
*** SHOW DOWN ***
CarlJung: shows [Ah Jd Td 9c]
kimjongun: shows [Kh Qs As 2h]
CarlJung collected $28560 from pot
*** SUMMARY ***
Total pot $29360 | Rake $800
Board [6h Jh Ad 9s 2c]
Seat 1: ag2703 (button) folded before Flop (didn't bet)
Seat 2: CarlJung (small blind) showed [Ah Jd Td 9c] and won ($28560)
Seat 3: kimjongun (big blind) showed [Kh Qs As 2h] and lost
Seat 4: TurnOnTuneInDropOut folded before Flop (didn't bet)
Seat 5: soundfsilenz folded on the Flop
Seat 6: slotmachine folded before Flop (didn't bet)

PokerStars Hand #1922878042: Omaha Pot Limit ($200/$400 USD) - 2020/10/23 16:34:53 ET
Table 'ADA179504417' 6-max Seat #1 is the button
Seat 1: ag2703 ($24783 in chips)
Seat 2: singlajimitesh ($44087 in chips)
Seat 3: TurnOnTuneInDropOut ($30000 in chips)
Seat 4: craftplayer ($29172 in chips)
singlajimitesh: posts small blind $200
TurnOnTuneInDropOut: posts big blind $400
*** HOLE CARDS ***
Dealt to TurnOnTuneInDropOut [Th 3d Ac 4c]
craftplayer: raises $400 to $800
ag2703: folds
singlajimitesh: calls $600
TurnOnTuneInDropOut: calls $400
*** FLOP *** [Td 3s 3h]
singlajimitesh: checks
TurnOnTuneInDropOut: checks
craftplayer: checks
*** TURN *** [Td 3s 3h] [2h]
singlajimitesh: bets $1200
TurnOnTuneInDropOut: calls $1200
craftplayer: folds
*** RIVER *** [Td 3s 3h 2h] [5s]
singlajimitesh: checks
TurnOnTuneInDropOut: bets $4800
singlajimitesh: folds
Uncalled bet ($4800) returned to TurnOnTuneInDropOut
TurnOnTuneInDropOut collected $4608 from pot
TurnOnTuneInDropOut: doesn't show hand
*** SUMMARY ***
Total pot $4800 | Rake $192
Board [Td 3s 3h 2h 5s]
Seat 1: ag2703 (button) folded before Flop (didn't bet)
Seat 2: singlajimitesh (small blind) folded on the River
Seat 3: TurnOnTuneInDropOut (big blind) collected ($4608)
Seat 4: craftplayer folded on the Turn

PokerStars Hand #1922878048: Omaha Pot Limit ($200/$400 USD) - 2020/10/23 16:41:30 ET
Table 'ADA179504417' 6-max Seat #3 is the button
Seat 1: ag2703 ($9868 in chips)
Seat 2: singlajimitesh ($60469 in chips)
Seat 3: TurnOnTuneInDropOut ($48000 in chips)
Seat 4: craftplayer ($75784 in chips)
craftplayer: posts small blind $200
ag2703: posts big blind $400
*** HOLE CARDS ***
Dealt to TurnOnTuneInDropOut [5s Jc Kh Kc]
singlajimitesh: raises $400 to $800
TurnOnTuneInDropOut: raises $2200 to $3000
craftplayer: folds
ag2703: folds
singlajimitesh: calls $2200
*** FLOP *** [6d Jd 7s]
singlajimitesh: checks
TurnOnTuneInDropOut: checks
*** TURN *** [6d Jd 7s] [3d]
singlajimitesh: checks
TurnOnTuneInDropOut: checks
*** RIVER *** [6d Jd 7s 3d] [4d]
singlajimitesh: bets $3300
TurnOnTuneInDropOut: folds
Uncalled bet ($3300) returned to singlajimitesh
singlajimitesh collected $6335 from pot
singlajimitesh: doesn't show hand
*** SUMMARY ***
Total pot $6600 | Rake $265
Board [6d Jd 7s 3d 4d]
Seat 1: ag2703 (big blind) folded before Flop
Seat 2: singlajimitesh collected ($6335)
Seat 3: TurnOnTuneInDropOut (button) folded on the River
Seat 4: craftplayer (small blind) folded before Flop

PokerStars Hand #1922878049: Omaha Pot Limit ($200/$400 USD) - 2020/10/23 16:42:24 ET
Table 'ADA179504417' 6-max Seat #4 is the button
Seat 1: ag2703 ($9468 in chips)
Seat 2: singlajimitesh ($63804 in chips)
Seat 3: TurnOnTuneInDropOut ($45000 in chips)
Seat 4: craftplayer ($75584 in chips)
ag2703: posts small blind $200
singlajimitesh: posts big blind $400
*** HOLE CARDS ***
Dealt to TurnOnTuneInDropOut [Kc 5c Td 5h]
TurnOnTuneInDropOut: folds
craftplayer: raises $1000 to $1400
ag2703: folds
singlajimitesh: raises $3000 to $4400
craftplayer: calls $3000
*** FLOP *** [Qs Tc 9c]
singlajimitesh: checks
craftplayer: bets $4500
singlajimitesh: calls $4500
*** TURN *** [Qs Tc 9c] [9d]
singlajimitesh: checks
craftplayer: bets $9000
singlajimitesh: calls $9000
*** RIVER *** [Qs Tc 9c 9d] [7h]
singlajimitesh: checks
craftplayer: bets $27000
singlajimitesh: folds
Uncalled bet ($27000) returned to craftplayer
craftplayer collected $35200 from pot
craftplayer: doesn't show hand
*** SUMMARY ***
Total pot $36000 | Rake $800
Board [Qs Tc 9c 9d 7h]
Seat 1: ag2703 (small blind) folded before Flop
Seat 2: singlajimitesh (big blind) folded on the River
Seat 3: TurnOnTuneInDropOut folded before Flop (didn't bet)
Seat 4: craftplayer (button) collected ($35200)

PokerStars Hand #1922878050: Omaha Pot Limit ($200/$400 USD) - 2020/10/23 16:43:44 ET
Table 'ADA179504417' 6-max Seat #1 is the button
Seat 1: ag2703 ($9268 in chips)
Seat 2: singlajimitesh ($45904 in chips)
Seat 3: TurnOnTuneInDropOut ($48000 in chips)
Seat 4: craftplayer ($92884 in chips)
singlajimitesh: posts small blind $200
TurnOnTuneInDropOut: posts big blind $400
*** HOLE CARDS ***
Dealt to TurnOnTuneInDropOut [5s Qh Qd 2d]
craftplayer: raises $400 to $800
ag2703: calls $800
singlajimitesh: raises $2800 to $3600
TurnOnTuneInDropOut: folds
craftplayer: calls $2800
ag2703: folds
*** FLOP *** [4c 2h 7d]
singlajimitesh: checks
craftplayer: checks
*** TURN *** [4c 2h 7d] [Ts]
singlajimitesh: checks
craftplayer: checks
*** RIVER *** [4c 2h 7d Ts] [3d]
singlajimitesh: checks
craftplayer: checks
*** SHOW DOWN ***
singlajimitesh: shows [Ah Kd 9h Ks]
craftplayer: mucks hand
singlajimitesh collected $8063 from pot
*** SUMMARY ***
Total pot $8400 | Rake $337
Board [4c 2h 7d Ts 3d]
Seat 1: ag2703 (button) folded before Flop
Seat 2: singlajimitesh (small blind) showed [Ah Kd 9h Ks] and won ($8063)
Seat 3: TurnOnTuneInDropOut (big blind) folded before Flop
Seat 4: craftplayer mucked

PokerStars Hand #1922878052: Omaha Pot Limit ($200/$400 USD) - 2020/10/23 16:45:14 ET
Table 'ADA179504417' 6-max Seat #3 is the button
Seat 1: ag2703 ($8468 in chips)
Seat 2: singlajimitesh ($48967 in chips)
Seat 3: TurnOnTuneInDropOut ($47400 in chips)
Seat 4: craftplayer ($90764 in chips)
craftplayer: posts small blind $200
ag2703: posts big blind $400
*** HOLE CARDS ***
Dealt to TurnOnTuneInDropOut [2s 3h 9c 8h]
singlajimitesh: raises $1000 to $1400
TurnOnTuneInDropOut: folds
craftplayer: folds
ag2703: folds
Uncalled bet ($1000) returned to singlajimitesh
singlajimitesh collected $1000 from pot
singlajimitesh: doesn't show hand
*** SUMMARY ***
Total pot $1000 | Rake $0
Seat 1: ag2703 (big blind) folded before Flop
Seat 2: singlajimitesh collected ($1000)
Seat 3: TurnOnTuneInDropOut (button) folded before Flop (didn't bet)
Seat 4: craftplayer (small blind) folded before Flop

PokerStars Hand #1922878053: Omaha Pot Limit ($200/$400 USD) - 2020/10/23 16:45:30 ET
Table 'ADA179504417' 6-max Seat #4 is the button
Seat 1: ag2703 ($8068 in chips)
Seat 2: singlajimitesh ($49567 in chips)
Seat 3: TurnOnTuneInDropOut ($47400 in chips)
Seat 4: craftplayer ($90564 in chips)
ag2703: posts small blind $200
singlajimitesh: posts big blind $400
*** HOLE CARDS ***
Dealt to TurnOnTuneInDropOut [8c 2s 3c Jd]
TurnOnTuneInDropOut: folds
craftplayer: raises $1000 to $1400
ag2703: folds
singlajimitesh: calls $1000
*** FLOP *** [Js 5s Kc]
singlajimitesh: checks
craftplayer: bets $1500
singlajimitesh: folds
Uncalled bet ($1500) returned to craftplayer
craftplayer collected $2880 from pot
craftplayer: doesn't show hand
*** SUMMARY ***
Total pot $3000 | Rake $120
Board [Js 5s Kc]
Seat 1: ag2703 (small blind) folded before Flop
Seat 2: singlajimitesh (big blind) folded on the Flop
Seat 3: TurnOnTuneInDropOut folded before Flop (didn't bet)
Seat 4: craftplayer (button) collected ($2880)

PokerStars Hand #1922878054: Omaha Pot Limit ($200/$400 USD) - 2020/10/23 16:46:07 ET
Table 'ADA179504417' 6-max Seat #2 is the button
Seat 2: singlajimitesh ($48167 in chips)
Seat 3: TurnOnTuneInDropOut ($47400 in chips)
Seat 4: craftplayer ($92044 in chips)
TurnOnTuneInDropOut: posts small blind $200
craftplayer: posts big blind $400
*** HOLE CARDS ***
Dealt to TurnOnTuneInDropOut [7h Ks 6s 4h]
singlajimitesh: raises $1000 to $1400
TurnOnTuneInDropOut: folds
craftplayer: calls $1000
*** FLOP *** [4c 3c 5s]
craftplayer: checks
singlajimitesh: bets $3000
craftplayer: raises $9000 to $12000
singlajimitesh: folds
Uncalled bet ($9000) returned to craftplayer
craftplayer collected $8639 from pot
craftplayer: doesn't show hand
*** SUMMARY ***
Total pot $9000 | Rake $361
Board [4c 3c 5s]
Seat 2: singlajimitesh (button) folded on the Flop
Seat 3: TurnOnTuneInDropOut (small blind) folded before Flop
Seat 4: craftplayer (big blind) collected ($8639)

PokerStars Hand #1922878056: Omaha Pot Limit ($200/$400 USD) - 2020/10/23 16:47:59 ET
Table 'ADA179504417' 6-max Seat #4 is the button
Seat 2: singlajimitesh ($43367 in chips)
Seat 3: TurnOnTuneInDropOut ($54390 in chips)
Seat 4: craftplayer ($88883 in chips)
singlajimitesh: posts small blind $200
TurnOnTuneInDropOut: posts big blind $400
*** HOLE CARDS ***
Dealt to TurnOnTuneInDropOut [9s Js Kh 3d]
craftplayer: raises $1000 to $1400
singlajimitesh: calls $1200
TurnOnTuneInDropOut: folds
*** FLOP *** [Jd 6d Ts]
singlajimitesh: checks
craftplayer: checks
*** TURN *** [Jd 6d Ts] [4d]
singlajimitesh: checks
craftplayer: bets $2400
singlajimitesh: folds
Uncalled bet ($2400) returned to craftplayer
craftplayer collected $3072 from pot
craftplayer: doesn't show hand
*** SUMMARY ***
Total pot $3200 | Rake $128
Board [Jd 6d Ts 4d]
Seat 2: singlajimitesh (small blind) folded on the Turn
Seat 3: TurnOnTuneInDropOut (big blind) folded before Flop
Seat 4: craftplayer (button) collected ($3072)

PokerStars Hand #1922878057: Omaha Pot Limit ($200/$400 USD) - 2020/10/23 16:48:55 ET
Table 'ADA179504417' 6-max Seat #2 is the button
Seat 2: singlajimitesh ($41967 in chips)
Seat 3: TurnOnTuneInDropOut ($53990 in chips)
Seat 4: craftplayer ($90555 in chips)
TurnOnTuneInDropOut: posts small blind $200
craftplayer: posts big blind $400
*** HOLE CARDS ***
Dealt to TurnOnTuneInDropOut [2c 9s 5c Kc]
singlajimitesh: raises $1000 to $1400
TurnOnTuneInDropOut: folds
craftplayer: calls $1000
*** FLOP *** [Kd 7c 7h]
craftplayer: checks
singlajimitesh: bets $1500
craftplayer: folds
Uncalled bet ($1500) returned to singlajimitesh
singlajimitesh collected $2880 from pot
singlajimitesh: doesn't show hand
*** SUMMARY ***
Total pot $3000 | Rake $120
Board [Kd 7c 7h]
Seat 2: singlajimitesh (button) collected ($2880)
Seat 3: TurnOnTuneInDropOut (small blind) folded before Flop
Seat 4: craftplayer (big blind) folded on the Flop

PokerStars Hand #1922878058: Omaha Pot Limit ($200/$400 USD) - 2020/10/23 16:49:49 ET
Table 'ADA179504417' 6-max Seat #3 is the button
Seat 2: singlajimitesh ($43447 in chips)
Seat 3: TurnOnTuneInDropOut ($53790 in chips)
Seat 4: craftplayer ($89155 in chips)
craftplayer: posts small blind $200
singlajimitesh: posts big blind $400
*** HOLE CARDS ***
Dealt to TurnOnTuneInDropOut [3h Qd 8h Qs]
TurnOnTuneInDropOut: raises $1000 to $1400
craftplayer: folds
singlajimitesh: calls $1000
*** FLOP *** [2d 2s 5c]
singlajimitesh: checks
TurnOnTuneInDropOut: bets $990
singlajimitesh: calls $990
*** TURN *** [2d 2s 5c] [3c]
singlajimitesh: checks
TurnOnTuneInDropOut: checks
*** RIVER *** [2d 2s 5c 3c] [2h]
singlajimitesh: bets $2490
TurnOnTuneInDropOut: calls $2490
*** SHOW DOWN ***
singlajimitesh: shows [5h Kh Qh Kc]
singlajimitesh collected $9561 from pot
*** SUMMARY ***
Total pot $9960 | Rake $399
Board [2d 2s 5c 3c 2h]
Seat 2: singlajimitesh (big blind) showed [5h Kh Qh Kc] and won ($9561)
Seat 3: TurnOnTuneInDropOut (button)
Seat 4: craftplayer (small blind) folded before Flop

PokerStars Hand #1922878059: Omaha Pot Limit ($200/$400 USD) - 2020/10/23 16:50:39 ET
Table 'ADA179504417' 6-max Seat #4 is the button
Seat 2: singlajimitesh ($48128 in chips)
Seat 3: TurnOnTuneInDropOut ($48910 in chips)
Seat 4: craftplayer ($88955 in chips)
singlajimitesh: posts small blind $200
TurnOnTuneInDropOut: posts big blind $400
*** HOLE CARDS ***
Dealt to TurnOnTuneInDropOut [8h Kd 9s 4c]
craftplayer: raises $400 to $800
singlajimitesh: raises $2000 to $2800
TurnOnTuneInDropOut: folds
craftplayer: calls $2000
*** FLOP *** [Js Qc Qd]
singlajimitesh: checks
craftplayer: bets $3000
singlajimitesh: calls $3000
*** TURN *** [Js Qc Qd] [5s]
singlajimitesh: checks
craftplayer: bets $6800
singlajimitesh: calls $6800
*** RIVER *** [Js Qc Qd 5s] [2c]
singlajimitesh: checks
craftplayer: bets $19200
singlajimitesh: calls $19200
*** SHOW DOWN ***
singlajimitesh: mucks hand
craftplayer: shows [9h Jc Qh 2s]
craftplayer collected $63300 from pot
*** SUMMARY ***
Total pot $64000 | Rake $700
Board [Js Qc Qd 5s 2c]
Seat 2: singlajimitesh (small blind) mucked
Seat 3: TurnOnTuneInDropOut (big blind) folded before Flop
Seat 4: craftplayer (button) showed [9h Jc Qh 2s] and won ($63300)

PokerStars Hand #1922878060: Omaha Pot Limit ($200/$400 USD) - 2020/10/23 16:51:33 ET
Table 'ADA179504417' 6-max Seat #2 is the button
Seat 2: singlajimitesh ($16328 in chips)
Seat 3: TurnOnTuneInDropOut ($48510 in chips)
Seat 4: craftplayer ($120455 in chips)
TurnOnTuneInDropOut: posts small blind $200
craftplayer: posts big blind $400
*** HOLE CARDS ***
Dealt to TurnOnTuneInDropOut [3h 2s Ah 5d]
singlajimitesh: raises $1000 to $1400
TurnOnTuneInDropOut: folds
craftplayer: calls $1000
*** FLOP *** [Ad 6h Th]
craftplayer: checks
singlajimitesh: checks
*** TURN *** [Ad 6h Th] [Kd]
craftplayer: bets $2250
singlajimitesh: calls $2250
*** RIVER *** [Ad 6h Th Kd] [Qd]
craftplayer: checks
singlajimitesh: checks
*** SHOW DOWN ***
craftplayer: shows [Qc 2c Kc Jd]
singlajimitesh: mucks hand
craftplayer collected $7199 from pot
*** SUMMARY ***
Total pot $7500 | Rake $301
Board [Ad 6h Th Kd Qd]
Seat 2: singlajimitesh (button) mucked
Seat 3: TurnOnTuneInDropOut (small blind) folded before Flop
Seat 4: craftplayer (big blind) showed [Qc 2c Kc Jd] and won ($7199)

PokerStars Hand #1922878061: Omaha Pot Limit ($200/$400 USD) - 2020/10/23 16:52:08 ET
Table 'ADA179504417' 6-max Seat #3 is the button
Seat 2: singlajimitesh ($12678 in chips)
Seat 3: TurnOnTuneInDropOut ($48310 in chips)
Seat 4: craftplayer ($124004 in chips)
craftplayer: posts small blind $200
singlajimitesh: posts big blind $400
*** HOLE CARDS ***
Dealt to TurnOnTuneInDropOut [7d 4c As Qc]
TurnOnTuneInDropOut: raises $1000 to $1400
craftplayer: calls $1200
singlajimitesh: raises $4200 to $5600
TurnOnTuneInDropOut: folds
craftplayer: calls $4200
*** FLOP *** [Th 8d Jc]
craftplayer: checks
singlajimitesh: bets $7078 and is all-in
craftplayer: calls $7078
*** TURN *** [Th 8d Jc] [7h]
*** RIVER *** [Th 8d Jc 7h] [Js]
*** SHOW DOWN ***
craftplayer: shows [Ts Td 7c 9d]
singlajimitesh: shows [Ac 3h Kh Tc]
craftplayer collected $26056 from pot
*** SUMMARY ***
Total pot $26756 | Rake $700
Board [Th 8d Jc 7h Js]
Seat 2: singlajimitesh (big blind) showed [Ac 3h Kh Tc] and lost
Seat 3: TurnOnTuneInDropOut (button) folded before Flop
Seat 4: craftplayer (small blind) showed [Ts Td 7c 9d] and won ($26056)

PokerStars Hand #1740871411: Omaha Pot Limit ($200/$400 USD) - 2020/10/23 12:35:57 ET
Table 'ADA409467368' 6-max Seat #5 is the button
Seat 2: Sam565 ($9168 in chips)
Seat 3: TurnOnTuneInDropOut ($30000 in chips)
Seat 4: ag2703 ($27020 in chips)
Seat 5: slotmachine ($56542 in chips)
Sam565: posts small blind $200
TurnOnTuneInDropOut: posts big blind $400
*** HOLE CARDS ***
Dealt to TurnOnTuneInDropOut [Jc 3d Qh Jd]
ag2703: raises $400 to $800
slotmachine: folds
Sam565: raises $2000 to $2800
TurnOnTuneInDropOut: folds
ag2703: calls $2000
*** FLOP *** [Kd 7h Kh]
Sam565: bets $6000
ag2703: folds
Uncalled bet ($6000) returned to Sam565
Sam565 collected $5759 from pot
Sam565: doesn't show hand
*** SUMMARY ***
Total pot $6000 | Rake $241
Board [Kd 7h Kh]
Seat 2: Sam565 (small blind) collected ($5759)
Seat 3: TurnOnTuneInDropOut (big blind) folded before Flop
Seat 4: ag2703 folded on the Flop
Seat 5: slotmachine (button) folded before Flop (didn't bet)

PokerStars Hand #1740871412: Omaha Pot Limit ($200/$400 USD) - 2020/10/23 12:36:48 ET
Table 'ADA409467368' 6-max Seat #2 is the button
Seat 2: Sam565 ($12127 in chips)
Seat 3: TurnOnTuneInDropOut ($29600 in chips)
Seat 4: ag2703 ($24220 in chips)
Seat 5: slotmachine ($56542 in chips)
TurnOnTuneInDropOut: posts small blind $200
ag2703: posts big blind $400
*** HOLE CARDS ***
Dealt to TurnOnTuneInDropOut [2h Qd Qc 9h]
slotmachine: raises $1000 to $1400
Sam565: calls $1400
TurnOnTuneInDropOut: folds
ag2703: folds
*** FLOP *** [4s 7c 8h]
slotmachine: checks
Sam565: bets $3400
slotmachine: folds
Uncalled bet ($3400) returned to Sam565
Sam565 collected $3264 from pot
Sam565: doesn't show hand
*** SUMMARY ***
Total pot $3400 | Rake $136
Board [4s 7c 8h]
Seat 2: Sam565 (button) collected ($3264)
Seat 3: TurnOnTuneInDropOut (small blind) folded before Flop
Seat 4: ag2703 (big blind) folded before Flop
Seat 5: slotmachine folded on the Flop

PokerStars Hand #1740871414: Omaha Pot Limit ($200/$400 USD) - 2020/10/23 12:39:05 ET
Table 'ADA409467368' 6-max Seat #4 is the button
Seat 2: Sam565 ($16607 in chips)
Seat 3: TurnOnTuneInDropOut ($46200 in chips)
Seat 4: ag2703 ($23620 in chips)
Seat 5: slotmachine ($54742 in chips)
Seat 6: Shr181 ($34327 in chips)
slotmachine: posts small blind $200
Shr181: posts big blind $400
*** HOLE CARDS ***
Dealt to TurnOnTuneInDropOut [Tc 7h Kd 7d]
Sam565: folds
TurnOnTuneInDropOut: folds
ag2703: folds
slotmachine: folds
Uncalled bet ($200) returned to Shr181
Shr181 collected $400 from pot
Shr181: doesn't show hand
*** SUMMARY ***
Total pot $400 | Rake $0
Seat 2: Sam565 folded before Flop (didn't bet)
Seat 3: TurnOnTuneInDropOut folded before Flop (didn't bet)
Seat 4: ag2703 (button) folded before Flop (didn't bet)
Seat 5: slotmachine (small blind) folded before Flop
Seat 6: Shr181 (big blind) collected ($400)

PokerStars Hand #1740871415: Omaha Pot Limit ($200/$400 USD) - 2020/10/23 12:39:30 ET
Table 'ADA409467368' 6-max Seat #5 is the button
Seat 2: Sam565 ($16607 in chips)
Seat 3: TurnOnTuneInDropOut ($46200 in chips)
Seat 4: ag2703 ($23620 in chips)
Seat 5: slotmachine ($54542 in chips)
Seat 6: Shr181 ($34527 in chips)
Shr181: posts small blind $200
Sam565: posts big blind $400
*** HOLE CARDS ***
Dealt to TurnOnTuneInDropOut [Qd 9h 9s 2h]
TurnOnTuneInDropOut: folds
ag2703: folds
slotmachine: raises $1000 to $1400
Shr181: calls $1200
Sam565: calls $1000
*** FLOP *** [5s 5h 4s]
Shr181: checks
Sam565: checks
slotmachine: bets $1386
Shr181: calls $1386
Sam565: folds
*** TURN *** [5s 5h 4s] [2c]
Shr181: bets $1200
slotmachine: calls $1200
*** RIVER *** [5s 5h 4s 2c] [Jd]
Shr181: checks
slotmachine: checks
*** SHOW DOWN ***
Shr181: mucks hand
slotmachine: shows [2s Ah Ad 4d]
slotmachine collected $8996 from pot
*** SUMMARY ***
Total pot $9372 | Rake $376
Board [5s 5h 4s 2c Jd]
Seat 2: Sam565 (big blind) folded on the Flop
Seat 3: TurnOnTuneInDropOut folded before Flop (didn't bet)
Seat 4: ag2703 folded before Flop (didn't bet)
Seat 5: slotmachine (button) showed [2s Ah Ad 4d] and won ($8996)
Seat 6: Shr181 (small blind) mucked

PokerStars Hand #228844228: Omaha Pot Limit ($200/$400 USD) - 2020/10/23 13:31:41 ET
Table 'ADA409467368' 6-max Seat #5 is the button
Seat 1: soundfsilenz ($47568 in chips)
Seat 2: Aksxone ($8924 in chips)
Seat 3: kimjongun ($32488 in chips)
Seat 4: ag2703 ($55841 in chips)
Seat 5: slotmachine ($62066 in chips)
Seat 6: TurnOnTuneInDropOut ($29600 in chips)
TurnOnTuneInDropOut: posts small blind $200
soundfsilenz: posts big blind $400
*** HOLE CARDS ***
Dealt to TurnOnTuneInDropOut [3s 6c Ks Jd]
Aksxone: raises $800 to $1200
kimjongun: folds
ag2703: folds
slotmachine: raises $3000 to $4200
TurnOnTuneInDropOut: folds
soundfsilenz: folds
Aksxone: calls $3000
*** FLOP *** [Js 7s 8c]
Aksxone: bets $4724 and is all-in
slotmachine: calls $4724
*** TURN *** [Js 7s 8c] [9h]
*** RIVER *** [Js 7s 8c 9h] [9d]
*** SHOW DOWN ***
Aksxone: shows [2s 5d 7h 7d]
slotmachine: shows [Qd 2c Qc As]
Aksxone collected $17708 from pot
*** SUMMARY ***
Total pot $18448 | Rake $740
Board [Js 7s 8c 9h 9d]
Seat 1: soundfsilenz (big blind) folded before Flop
Seat 2: Aksxone showed [2s 5d 7h 7d] and won ($17708)
Seat 3: kimjongun folded before Flop (didn't bet)
Seat 4: ag2703 folded before Flop (didn't bet)
Seat 5: slotmachine (button) showed [Qd 2c Qc As] and lost
Seat 6: TurnOnTuneInDropOut (small blind) folded before Flop

PokerStars Hand #228844229: Omaha Pot Limit ($200/$400 USD) - 2020/10/23 13:32:26 ET
Table 'ADA409467368' 6-max Seat #6 is the button
Seat 1: soundfsilenz ($47168 in chips)
Seat 2: Aksxone ($17708 in chips)
Seat 3: kimjongun ($32488 in chips)
Seat 4: ag2703 ($55841 in chips)
Seat 5: slotmachine ($53142 in chips)
Seat 6: TurnOnTuneInDropOut ($29400 in chips)
soundfsilenz: posts small blind $200
Aksxone: posts big blind $400
*** HOLE CARDS ***
Dealt to TurnOnTuneInDropOut [Qs 4c Ad 7h]
kimjongun: raises $600 to $1000
ag2703: folds
slotmachine: raises $2600 to $3600
TurnOnTuneInDropOut: folds
soundfsilenz: folds
Aksxone: folds
kimjongun: calls $2600
*** FLOP *** [7s Tc 8s]
kimjongun: checks
slotmachine: checks
*** TURN *** [7s Tc 8s] [Kd]
kimjongun: bets $5148
slotmachine: calls $5148
*** RIVER *** [7s Tc 8s Kd] [8d]
kimjongun: bets $18096
slotmachine: calls $18096
*** SHOW DOWN ***
kimjongun: mucks hand
slotmachine: shows [9h 5c Kh 7c]
slotmachine collected $53488 from pot
*** SUMMARY ***
Total pot $54288 | Rake $800
Board [7s Tc 8s Kd 8d]
Seat 1: soundfsilenz (small blind) folded before Flop
Seat 2: Aksxone (big blind) folded before Flop
Seat 3: kimjongun mucked
Seat 4: ag2703 folded before Flop (didn't bet)
Seat 5: slotmachine showed [9h 5c Kh 7c] and won ($53488)
Seat 6: TurnOnTuneInDropOut (button) folded before Flop (didn't bet)

PokerStars Hand #228844230: Omaha Pot Limit ($200/$400 USD) - 2020/10/23 13:34:03 ET
Table 'ADA409467368' 6-max Seat #1 is the button
Seat 1: soundfsilenz ($46968 in chips)
Seat 2: Aksxone ($17308 in chips)
Seat 3: kimjongun ($30000 in chips)
Seat 4: ag2703 ($55841 in chips)
Seat 5: slotmachine ($79786 in chips)
Seat 6: TurnOnTuneInDropOut ($29400 in chips)
Aksxone: posts small blind $200
kimjongun: posts big blind $400
*** HOLE CARDS ***
Dealt to TurnOnTuneInDropOut [6h Ts Ks Ad]
ag2703: folds
slotmachine: folds
TurnOnTuneInDropOut: raises $1000 to $1400
soundfsilenz: raises $3400 to $4800
Aksxone: folds
kimjongun: calls $4400
TurnOnTuneInDropOut: folds
*** FLOP *** [7d 8c 3c]
kimjongun: checks
soundfsilenz: bets $7504
kimjongun: calls $7504
*** TURN *** [7d 8c 3c] [3d]
kimjongun: bets $17696 and is all-in
soundfsilenz: calls $17696
*** RIVER *** [7d 8c 3c 3d] [8d]
*** SHOW DOWN ***
kimjongun: shows [7h Th Qd Kd]
soundfsilenz: shows [Qc Jh Ac Td]
kimjongun collected $60800 from pot
*** SUMMARY ***
Total pot $61600 | Rake $800
Board [7d 8c 3c 3d 8d]
Seat 1: soundfsilenz (button) showed [Qc Jh Ac Td] and lost
Seat 2: Aksxone (small blind) folded before Flop
Seat 3: kimjongun (big blind) showed [7h Th Qd Kd] and won ($60800)
Seat 4: ag2703 folded before Flop (didn't bet)
Seat 5: slotmachine folded before Flop (didn't bet)
Seat 6: TurnOnTuneInDropOut folded before Flop

PokerStars Hand #228844231: Omaha Pot Limit ($200/$400 USD) - 2020/10/23 13:35:24 ET
Table 'ADA409467368' 6-max Seat #2 is the button
Seat 1: soundfsilenz ($16968 in chips)
Seat 2: Aksxone ($17108 in chips)
Seat 3: kimjongun ($60800 in chips)
Seat 4: ag2703 ($55841 in chips)
Seat 5: slotmachine ($79786 in chips)
Seat 6: TurnOnTuneInDropOut ($28000 in chips)
kimjongun: posts small blind $200
ag2703: posts big blind $400
*** HOLE CARDS ***
Dealt to TurnOnTuneInDropOut [Kd 3s 8h 7c]
slotmachine: folds
TurnOnTuneInDropOut: folds
soundfsilenz: folds
Aksxone: folds
kimjongun: folds
Uncalled bet ($200) returned to ag2703
ag2703 collected $400 from pot
ag2703: doesn't show hand
*** SUMMARY ***
Total pot $400 | Rake $0
Seat 1: soundfsilenz folded before Flop (didn't bet)
Seat 2: Aksxone (button) folded before Flop (didn't bet)
Seat 3: kimjongun (small blind) folded before Flop
Seat 4: ag2703 (big blind) collected ($400)
Seat 5: slotmachine folded before Flop (didn't bet)
Seat 6: TurnOnTuneInDropOut folded before Flop (didn't bet)

PokerStars Hand #228844232: Omaha Pot Limit ($200/$400 USD) - 2020/10/23 13:35:43 ET
Table 'ADA409467368' 6-max Seat #3 is the button
Seat 1: soundfsilenz ($28969 in chips)
Seat 2: Aksxone ($17108 in chips)
Seat 3: kimjongun ($60600 in chips)
Seat 4: ag2703 ($56041 in chips)
Seat 5: slotmachine ($79786 in chips)
Seat 6: TurnOnTuneInDropOut ($28000 in chips)
ag2703: posts small blind $200
slotmachine: posts big blind $400
*** HOLE CARDS ***
Dealt to TurnOnTuneInDropOut [9h 4d 2d 7c]
TurnOnTuneInDropOut: folds
soundfsilenz: raises $1000 to $1400
Aksxone: calls $1400
kimjongun: folds
ag2703: folds
slotmachine: folds
*** FLOP *** [Tc Qc 2s]
soundfsilenz: bets $2278
Aksxone: folds
Uncalled bet ($2278) returned to soundfsilenz
soundfsilenz collected $3264 from pot
soundfsilenz: doesn't show hand
*** SUMMARY ***
Total pot $3400 | Rake $136
Board [Tc Qc 2s]
Seat 1: soundfsilenz collected ($3264)
Seat 2: Aksxone folded on the Flop
Seat 3: kimjongun (button) folded before Flop (didn't bet)
Seat 4: ag2703 (small blind) folded before Flop
Seat 5: slotmachine (big blind) folded before Flop
Seat 6: TurnOnTuneInDropOut folded before Flop (didn't bet)

PokerStars Hand #228844233: Omaha Pot Limit ($200/$400 USD) - 2020/10/23 13:36:22 ET
Table 'ADA409467368' 6-max Seat #4 is the button
Seat 1: soundfsilenz ($30833 in chips)
Seat 2: Aksxone ($15708 in chips)
Seat 3: kimjongun ($60600 in chips)
Seat 4: ag2703 ($55841 in chips)
Seat 5: slotmachine ($79386 in chips)
Seat 6: TurnOnTuneInDropOut ($28000 in chips)
slotmachine: posts small blind $200
TurnOnTuneInDropOut: posts big blind $400
*** HOLE CARDS ***
Dealt to TurnOnTuneInDropOut [Qs Jc 3d Ad]
soundfsilenz: folds
Aksxone: raises $1000 to $1400
kimjongun: folds
ag2703: folds
slotmachine: folds
TurnOnTuneInDropOut: calls $1000
*** FLOP *** [7h 7s Kd]
TurnOnTuneInDropOut: checks
Aksxone: checks
*** TURN *** [7h 7s Kd] [3c]
TurnOnTuneInDropOut: checks
Aksxone: checks
*** RIVER *** [7h 7s Kd 3c] [Qc]
TurnOnTuneInDropOut: checks
Aksxone: bets $3000
TurnOnTuneInDropOut: calls $3000
*** SHOW DOWN ***
TurnOnTuneInDropOut: shows [Qs Jc 3d Ad]
Aksxone: mucks hand
TurnOnTuneInDropOut collected $8639 from pot
*** SUMMARY ***
Total pot $9000 | Rake $361
Board [7h 7s Kd 3c Qc]
Seat 1: soundfsilenz folded before Flop (didn't bet)
Seat 2: Aksxone mucked
Seat 3: kimjongun folded before Flop (didn't bet)
Seat 4: ag2703 (button) folded before Flop (didn't bet)
Seat 5: slotmachine (small blind) folded before Flop
Seat 6: TurnOnTuneInDropOut (big blind) showed [Qs Jc 3d Ad] and won ($8639)

PokerStars Hand #228844235: Omaha Pot Limit ($200/$400 USD) - 2020/10/23 13:38:20 ET
Table 'ADA409467368' 6-max Seat #6 is the button
Seat 1: soundfsilenz ($42434 in chips)
Seat 2: Aksxone ($10908 in chips)
Seat 3: kimjongun ($60600 in chips)
Seat 4: ag2703 ($55841 in chips)
Seat 5: slotmachine ($80186 in chips)
Seat 6: TurnOnTuneInDropOut ($32039 in chips)
soundfsilenz: posts small blind $200
Aksxone: posts big blind $400
*** HOLE CARDS ***
Dealt to TurnOnTuneInDropOut [Qh 6h 2c Jh]
kimjongun: folds
ag2703: raises $400 to $800
slotmachine: raises $2200 to $3000
TurnOnTuneInDropOut: folds
soundfsilenz: folds
Aksxone: calls $2600
ag2703: calls $2200
*** FLOP *** [Qs Qc As]
Aksxone: checks
ag2703: checks
slotmachine: checks
*** TURN *** [Qs Qc As] [Jd]
Aksxone: bets $4600
ag2703: folds
slotmachine: folds
Uncalled bet ($4600) returned to Aksxone
Aksxone collected $8831 from pot
Aksxone: doesn't show hand
*** SUMMARY ***
Total pot $9200 | Rake $369
Board [Qs Qc As Jd]
Seat 1: soundfsilenz (small blind) folded before Flop
Seat 2: Aksxone (big blind) collected ($8831)
Seat 3: kimjongun folded before Flop (didn't bet)
Seat 4: ag2703 folded on the Turn
Seat 5: slotmachine folded on the Turn
Seat 6: TurnOnTuneInDropOut (button) folded before Flop (didn't bet)

PokerStars Hand #228844236: Omaha Pot Limit ($200/$400 USD) - 2020/10/23 13:39:53 ET
Table 'ADA409467368' 6-max Seat #1 is the button
Seat 1: soundfsilenz ($42234 in chips)
Seat 2: Aksxone ($16739 in chips)
Seat 3: kimjongun ($60600 in chips)
Seat 4: ag2703 ($52841 in chips)
Seat 5: slotmachine ($77186 in chips)
Seat 6: TurnOnTuneInDropOut ($32039 in chips)
Aksxone: posts small blind $200
kimjongun: posts big blind $400
*** HOLE CARDS ***
Dealt to TurnOnTuneInDropOut [3d 7c 2c 7h]
ag2703: folds
slotmachine: raises $1000 to $1400
TurnOnTuneInDropOut: folds
soundfsilenz: calls $1400
Aksxone: raises $4600 to $6000
kimjongun: folds
slotmachine: raises $13800 to $19800
soundfsilenz: folds
Aksxone: calls $10739 and is all-in
Uncalled bet ($3061) returned to slotmachine
*** FLOP *** [3h Js 2d]
*** TURN *** [3h Js 2d] [5c]
*** RIVER *** [3h Js 2d 5c] [Ts]
*** SHOW DOWN ***
Aksxone: shows [Kh Qc As Kd]
slotmachine: shows [Ah 5d 6s 9h]
Aksxone collected $34478 from pot
*** SUMMARY ***
Total pot $35278 | Rake $800
Board [3h Js 2d 5c Ts]
Seat 1: soundfsilenz (button) folded before Flop
Seat 2: Aksxone (small blind) showed [Kh Qc As Kd] and won ($34478)
Seat 3: kimjongun (big blind) folded before Flop
Seat 4: ag2703 folded before Flop (didn't bet)
Seat 5: slotmachine showed [Ah 5d 6s 9h] and lost
Seat 6: TurnOnTuneInDropOut folded before Flop (didn't bet)

PokerStars Hand #228844237: Omaha Pot Limit ($200/$400 USD) - 2020/10/23 13:40:39 ET
Table 'ADA409467368' 6-max Seat #2 is the button
Seat 1: soundfsilenz ($40834 in chips)
Seat 2: Aksxone ($34478 in chips)
Seat 3: kimjongun ($60200 in chips)
Seat 4: ag2703 ($52841 in chips)
Seat 5: slotmachine ($60447 in chips)
Seat 6: TurnOnTuneInDropOut ($32039 in chips)
kimjongun: posts small blind $200
ag2703: posts big blind $400
*** HOLE CARDS ***
Dealt to TurnOnTuneInDropOut [6d Kc 8s 4h]
slotmachine: folds
TurnOnTuneInDropOut: folds
soundfsilenz: raises $1000 to $1400
Aksxone: calls $1400
kimjongun: folds
ag2703: calls $1000
*** FLOP *** [4s 3s Qh]
ag2703: checks
soundfsilenz: checks
Aksxone: checks
*** TURN *** [4s 3s Qh] [5d]
ag2703: checks
soundfsilenz: bets $2948
Aksxone: calls $2948
ag2703: folds
*** RIVER *** [4s 3s Qh 5d] [Jd]
soundfsilenz: bets $6899
Aksxone: calls $6899
*** SHOW DOWN ***
soundfsilenz: mucks hand
Aksxone: shows [2d 2h Ah Jh]
Aksxone collected $23294 from pot
*** SUMMARY ***
Total pot $24094 | Rake $800
Board [4s 3s Qh 5d Jd]
Seat 1: soundfsilenz mucked
Seat 2: Aksxone (button) showed [2d 2h Ah Jh] and won ($23294)
Seat 3: kimjongun (small blind) folded before Flop
Seat 4: ag2703 (big blind) folded on the Turn
Seat 5: slotmachine folded before Flop (didn't bet)
Seat 6: TurnOnTuneInDropOut folded before Flop (didn't bet)

PokerStars Hand #228844238: Omaha Pot Limit ($200/$400 USD) - 2020/10/23 13:42:02 ET
Table 'ADA409467368' 6-max Seat #3 is the button
Seat 1: soundfsilenz ($29587 in chips)
Seat 2: Aksxone ($46525 in chips)
Seat 3: kimjongun ($60000 in chips)
Seat 4: ag2703 ($51441 in chips)
Seat 5: slotmachine ($60447 in chips)
Seat 6: TurnOnTuneInDropOut ($32039 in chips)
ag2703: posts small blind $200
slotmachine: posts big blind $400
*** HOLE CARDS ***
Dealt to TurnOnTuneInDropOut [2h Jh 4s 5h]
TurnOnTuneInDropOut: folds
soundfsilenz: folds
Aksxone: calls $400
kimjongun: folds
ag2703: folds
slotmachine: checks
*** FLOP *** [Ah 5d 7h]
slotmachine: checks
Aksxone: bets $750
slotmachine: folds
Uncalled bet ($750) returned to Aksxone
Aksxone collected $960 from pot
Aksxone: doesn't show hand
*** SUMMARY ***
Total pot $1000 | Rake $40
Board [Ah 5d 7h]
Seat 1: soundfsilenz folded before Flop (didn't bet)
Seat 2: Aksxone collected ($960)
Seat 3: kimjongun (button) folded before Flop (didn't bet)
Seat 4: ag2703 (small blind) folded before Flop
Seat 5: slotmachine (big blind) folded on the Flop
Seat 6: TurnOnTuneInDropOut folded before Flop (didn't bet)

PokerStars Hand #228844241: Omaha Pot Limit ($200/$400 USD) - 2020/10/23 13:45:38 ET
Table 'ADA409467368' 6-max Seat #6 is the button
Seat 1: soundfsilenz ($41188 in chips)
Seat 2: Aksxone ($37535 in chips)
Seat 3: kimjongun ($59600 in chips)
Seat 4: ag2703 ($61561 in chips)
Seat 5: slotmachine ($59847 in chips)
Seat 6: TurnOnTuneInDropOut ($31439 in chips)
soundfsilenz: posts small blind $200
Aksxone: posts big blind $400
*** HOLE CARDS ***
Dealt to TurnOnTuneInDropOut [Jh 5d 6s 4c]
kimjongun: folds
ag2703: raises $400 to $800
slotmachine: folds
TurnOnTuneInDropOut: folds
soundfsilenz: folds
Aksxone: raises $800 to $1600
ag2703: calls $800
*** FLOP *** [9c 8c 6h]
Aksxone: checks
ag2703: bets $3400
Aksxone: folds
Uncalled bet ($3400) returned to ag2703
ag2703 collected $3264 from pot
ag2703: doesn't show hand
*** SUMMARY ***
Total pot $3400 | Rake $136
Board [9c 8c 6h]
Seat 1: soundfsilenz (small blind) folded before Flop
Seat 2: Aksxone (big blind) folded on the Flop
Seat 3: kimjongun folded before Flop (didn't bet)
Seat 4: ag2703 collected ($3264)
Seat 5: slotmachine folded before Flop (didn't bet)
Seat 6: TurnOnTuneInDropOut (button) folded before Flop (didn't bet)

PokerStars Hand #228844242: Omaha Pot Limit ($200/$400 USD) - 2020/10/23 13:47:02 ET
Table 'ADA409467368' 6-max Seat #1 is the button
Seat 1: soundfsilenz ($40988 in chips)
Seat 2: Aksxone ($35935 in chips)
Seat 3: kimjongun ($59600 in chips)
Seat 4: ag2703 ($63225 in chips)
Seat 5: slotmachine ($59847 in chips)
Seat 6: TurnOnTuneInDropOut ($31439 in chips)
Aksxone: posts small blind $200
kimjongun: posts big blind $400
*** HOLE CARDS ***
Dealt to TurnOnTuneInDropOut [Qh 9h 8h 5c]
ag2703: folds
slotmachine: folds
TurnOnTuneInDropOut: folds
soundfsilenz: folds
Aksxone: calls $200
kimjongun: checks
*** FLOP *** [2c Kd Ks]
Aksxone: checks
kimjongun: checks
*** TURN *** [2c Kd Ks] [Kc]
Aksxone: bets $800
kimjongun: folds
Uncalled bet ($800) returned to Aksxone
Aksxone collected $768 from pot
Aksxone: doesn't show hand
*** SUMMARY ***
Total pot $800 | Rake $32
Board [2c Kd Ks Kc]
Seat 1: soundfsilenz (button) folded before Flop (didn't bet)
Seat 2: Aksxone (small blind) collected ($768)
Seat 3: kimjongun (big blind) folded on the Turn
Seat 4: ag2703 folded before Flop (didn't bet)
Seat 5: slotmachine folded before Flop (didn't bet)
Seat 6: TurnOnTuneInDropOut folded before Flop (didn't bet)

PokerStars Hand #228844243: Omaha Pot Limit ($200/$400 USD) - 2020/10/23 13:47:47 ET
Table 'ADA409467368' 6-max Seat #2 is the button
Seat 1: soundfsilenz ($40988 in chips)
Seat 2: Aksxone ($36303 in chips)
Seat 3: kimjongun ($59200 in chips)
Seat 4: ag2703 ($63225 in chips)
Seat 5: slotmachine ($59847 in chips)
Seat 6: TurnOnTuneInDropOut ($31439 in chips)
kimjongun: posts small blind $200
ag2703: posts big blind $400
*** HOLE CARDS ***
Dealt to TurnOnTuneInDropOut [3s 2d 7c Qs]
slotmachine: raises $1000 to $1400
TurnOnTuneInDropOut: folds
soundfsilenz: folds
Aksxone: calls $1400
kimjongun: folds
ag2703: calls $1000
*** FLOP *** [Js 5d Th]
ag2703: bets $4400
slotmachine: folds
Aksxone: raises $13200 to $17600
ag2703: raises $39600 to $57200
Aksxone: calls $17303 and is all-in
Uncalled bet ($22297) returned to ag2703
*** TURN *** [Js 5d Th] [4c]
*** RIVER *** [Js 5d Th 4c] [8s]
*** SHOW DOWN ***
ag2703: shows [7s Qd Jd Jc]
Aksxone: shows [4s 9s Jh Ts]
ag2703 collected $73406 from pot
*** SUMMARY ***
Total pot $74206 | Rake $800
Board [Js 5d Th 4c 8s]
Seat 1: soundfsilenz folded before Flop (didn't bet)
Seat 2: Aksxone (button) showed [4s 9s Jh Ts] and lost
Seat 3: kimjongun (small blind) folded before Flop
Seat 4: ag2703 (big blind) showed [7s Qd Jd Jc] and won ($73406)
Seat 5: slotmachine folded on the Flop
Seat 6: TurnOnTuneInDropOut folded before Flop (didn't bet)

PokerStars Hand #228844244: Omaha Pot Limit ($200/$400 USD) - 2020/10/23 13:49:13 ET
Table 'ADA409467368' 6-max Seat #3 is the button
Seat 1: soundfsilenz ($40988 in chips)
Seat 3: kimjongun ($59000 in chips)
Seat 4: ag2703 ($100328 in chips)
Seat 5: slotmachine ($58447 in chips)
Seat 6: TurnOnTuneInDropOut ($31439 in chips)
ag2703: posts small blind $200
slotmachine: posts big blind $400
*** HOLE CARDS ***
Dealt to TurnOnTuneInDropOut [9h Th 7s Ts]
TurnOnTuneInDropOut: raises $1000 to $1400
soundfsilenz: folds
kimjongun: folds
ag2703: folds
slotmachine: folds
Uncalled bet ($1000) returned to TurnOnTuneInDropOut
TurnOnTuneInDropOut collected $1000 from pot
TurnOnTuneInDropOut: doesn't show hand
*** SUMMARY ***
Total pot $1000 | Rake $0
Seat 1: soundfsilenz folded before Flop (didn't bet)
Seat 3: kimjongun (button) folded before Flop (didn't bet)
Seat 4: ag2703 (small blind) folded before Flop
Seat 5: slotmachine (big blind) folded before Flop
Seat 6: TurnOnTuneInDropOut collected ($1000)

PokerStars Hand #228844245: Omaha Pot Limit ($200/$400 USD) - 2020/10/23 13:49:39 ET
Table 'ADA409467368' 6-max Seat #4 is the button
Seat 1: soundfsilenz ($40988 in chips)
Seat 3: kimjongun ($59000 in chips)
Seat 4: ag2703 ($100128 in chips)
Seat 5: slotmachine ($58047 in chips)
Seat 6: TurnOnTuneInDropOut ($32039 in chips)
slotmachine: posts small blind $200
TurnOnTuneInDropOut: posts big blind $400
*** HOLE CARDS ***
Dealt to TurnOnTuneInDropOut [9d Qh Js 7h]
soundfsilenz: folds
kimjongun: folds
ag2703: raises $1000 to $1400
slotmachine: folds
TurnOnTuneInDropOut: calls $1000
*** FLOP *** [8d Kc 9s]
TurnOnTuneInDropOut: checks
ag2703: bets $3000
TurnOnTuneInDropOut: calls $3000
*** TURN *** [8d Kc 9s] [Kh]
TurnOnTuneInDropOut: checks
ag2703: checks
*** RIVER *** [8d Kc 9s Kh] [Ac]
TurnOnTuneInDropOut: checks
ag2703: bets $9000
TurnOnTuneInDropOut: folds
Uncalled bet ($9000) returned to ag2703
ag2703 collected $8639 from pot
ag2703: doesn't show hand
*** SUMMARY ***
Total pot $9000 | Rake $361
Board [8d Kc 9s Kh Ac]
Seat 1: soundfsilenz folded before Flop (didn't bet)
Seat 3: kimjongun folded before Flop (didn't bet)
Seat 4: ag2703 (button) collected ($8639)
Seat 5: slotmachine (small blind) folded before Flop
Seat 6: TurnOnTuneInDropOut (big blind) folded on the River

PokerStars Hand #228844248: Omaha Pot Limit ($200/$400 USD) - 2020/10/23 13:52:54 ET
Table 'ADA409467368' 6-max Seat #1 is the button
Seat 1: soundfsilenz ($41348 in chips)
Seat 2: Aksxone ($18426 in chips)
Seat 3: kimjongun ($64015 in chips)
Seat 4: ag2703 ($100167 in chips)
Seat 5: slotmachine ($57847 in chips)
Seat 6: TurnOnTuneInDropOut ($27439 in chips)
Aksxone: posts small blind $200
kimjongun: posts big blind $400
*** HOLE CARDS ***
Dealt to TurnOnTuneInDropOut [3c 7d 8d Ah]
ag2703: raises $400 to $800
slotmachine: folds
TurnOnTuneInDropOut: folds
soundfsilenz: folds
Aksxone: raises $2000 to $2800
kimjongun: folds
ag2703: calls $2000
*** FLOP *** [3h Td 6c]
Aksxone: bets $6000
ag2703: folds
Uncalled bet ($6000) returned to Aksxone
Aksxone collected $5759 from pot
Aksxone: doesn't show hand
*** SUMMARY ***
Total pot $6000 | Rake $241
Board [3h Td 6c]
Seat 1: soundfsilenz (button) folded before Flop (didn't bet)
Seat 2: Aksxone (small blind) collected ($5759)
Seat 3: kimjongun (big blind) folded before Flop
Seat 4: ag2703 folded on the Flop
Seat 5: slotmachine folded before Flop (didn't bet)
Seat 6: TurnOnTuneInDropOut folded before Flop (didn't bet)

PokerStars Hand #228844249: Omaha Pot Limit ($200/$400 USD) - 2020/10/23 13:53:34 ET
Table 'ADA409467368' 6-max Seat #2 is the button
Seat 1: soundfsilenz ($41348 in chips)
Seat 2: Aksxone ($21385 in chips)
Seat 3: kimjongun ($63615 in chips)
Seat 4: ag2703 ($97367 in chips)
Seat 5: slotmachine ($57847 in chips)
Seat 6: TurnOnTuneInDropOut ($27439 in chips)
kimjongun: posts small blind $200
ag2703: posts big blind $400
*** HOLE CARDS ***
Dealt to TurnOnTuneInDropOut [4c 5d 3d 2d]
slotmachine: folds
TurnOnTuneInDropOut: folds
soundfsilenz: folds
Aksxone: raises $1000 to $1400
kimjongun: folds
ag2703: calls $1000
*** FLOP *** [7c 6d 5h]
ag2703: checks
Aksxone: checks
*** TURN *** [7c 6d 5h] [Qc]
ag2703: checks
Aksxone: bets $3000
ag2703: folds
Uncalled bet ($3000) returned to Aksxone
Aksxone collected $2880 from pot
Aksxone: doesn't show hand
*** SUMMARY ***
Total pot $3000 | Rake $120
Board [7c 6d 5h Qc]
Seat 1: soundfsilenz folded before Flop (didn't bet)
Seat 2: Aksxone (button) collected ($2880)
Seat 3: kimjongun (small blind) folded before Flop
Seat 4: ag2703 (big blind) folded on the Turn
Seat 5: slotmachine folded before Flop (didn't bet)
Seat 6: TurnOnTuneInDropOut folded before Flop (didn't bet)

PokerStars Hand #228844250: Omaha Pot Limit ($200/$400 USD) - 2020/10/23 13:54:55 ET
Table 'ADA409467368' 6-max Seat #3 is the button
Seat 1: soundfsilenz ($41348 in chips)
Seat 2: Aksxone ($22865 in chips)
Seat 3: kimjongun ($63415 in chips)
Seat 4: ag2703 ($95967 in chips)
Seat 5: slotmachine ($57847 in chips)
Seat 6: TurnOnTuneInDropOut ($27439 in chips)
ag2703: posts small blind $200
slotmachine: posts big blind $400
*** HOLE CARDS ***
Dealt to TurnOnTuneInDropOut [5d 5s 8d 2h]
TurnOnTuneInDropOut: folds
soundfsilenz: folds
Aksxone: calls $400
kimjongun: raises $1400 to $1800
ag2703: calls $1600
slotmachine: calls $1400
Aksxone: calls $1400
*** FLOP *** [Td Jh 4s]
ag2703: bets $7200
slotmachine: folds
Aksxone: raises $13865 to $21065 and is all-in
kimjongun: folds
ag2703: calls $13865
*** TURN *** [Td Jh 4s] [Qc]
*** RIVER *** [Td Jh 4s Qc] [Ks]
*** SHOW DOWN ***
ag2703: shows [9c Ac Ts Js]
Aksxone: shows [Qh 8h 4d Tc]
ag2703 collected $48530 from pot
*** SUMMARY ***
Total pot $49330 | Rake $800
Board [Td Jh 4s Qc Ks]
Seat 1: soundfsilenz folded before Flop (didn't bet)
Seat 2: Aksxone showed [Qh 8h 4d Tc] and lost
Seat 3: kimjongun (button) folded on the Flop
Seat 4: ag2703 (small blind) showed [9c Ac Ts Js] and won ($48530)
Seat 5: slotmachine (big blind) folded on the Flop
Seat 6: TurnOnTuneInDropOut folded before Flop (didn't bet)

PokerStars Hand #228844251: Omaha Pot Limit ($200/$400 USD) - 2020/10/23 13:56:14 ET
Table 'ADA409467368' 6-max Seat #4 is the button
Seat 1: soundfsilenz ($41348 in chips)
Seat 3: kimjongun ($61615 in chips)
Seat 4: ag2703 ($121632 in chips)
Seat 5: slotmachine ($56047 in chips)
Seat 6: TurnOnTuneInDropOut ($27439 in chips)
slotmachine: posts small blind $200
TurnOnTuneInDropOut: posts big blind $400
*** HOLE CARDS ***
Dealt to TurnOnTuneInDropOut [Ad Td 7d 8s]
soundfsilenz: folds
kimjongun: folds
ag2703: raises $1000 to $1400
slotmachine: folds
TurnOnTuneInDropOut: calls $1000
*** FLOP *** [4s 5s Kh]
TurnOnTuneInDropOut: checks
ag2703: bets $3000
TurnOnTuneInDropOut: folds
Uncalled bet ($3000) returned to ag2703
ag2703 collected $2880 from pot
ag2703: doesn't show hand
*** SUMMARY ***
Total pot $3000 | Rake $120
Board [4s 5s Kh]
Seat 1: soundfsilenz folded before Flop (didn't bet)
Seat 3: kimjongun folded before Flop (didn't bet)
Seat 4: ag2703 (button) collected ($2880)
Seat 5: slotmachine (small blind) folded before Flop
Seat 6: TurnOnTuneInDropOut (big blind) folded on the Flop

PokerStars Hand #228844252: Omaha Pot Limit ($200/$400 USD) - 2020/10/23 13:56:51 ET
Table 'ADA409467368' 6-max Seat #5 is the button
Seat 1: soundfsilenz ($41348 in chips)
Seat 3: kimjongun ($61615 in chips)
Seat 4: ag2703 ($123112 in chips)
Seat 5: slotmachine ($55847 in chips)
Seat 6: TurnOnTuneInDropOut ($26039 in chips)
TurnOnTuneInDropOut: posts small blind $200
soundfsilenz: posts big blind $400
*** HOLE CARDS ***
Dealt to TurnOnTuneInDropOut [8d Kd 9s Kc]
kimjongun: folds
ag2703: folds
slotmachine: folds
TurnOnTuneInDropOut: raises $800 to $1200
soundfsilenz: calls $800
*** FLOP *** [Tc 2h 6h]
TurnOnTuneInDropOut: checks
soundfsilenz: checks
*** TURN *** [Tc 2h 6h] [9c]
TurnOnTuneInDropOut: checks
soundfsilenz: checks
*** RIVER *** [Tc 2h 6h 9c] [Qd]
TurnOnTuneInDropOut: checks
soundfsilenz: checks
*** SHOW DOWN ***
TurnOnTuneInDropOut: shows [8d Kd 9s Kc]
soundfsilenz: mucks hand
TurnOnTuneInDropOut collected $2304 from pot
*** SUMMARY ***
Total pot $2400 | Rake $96
Board [Tc 2h 6h 9c Qd]
Seat 1: soundfsilenz (big blind) mucked
Seat 3: kimjongun folded before Flop (didn't bet)
Seat 4: ag2703 folded before Flop (didn't bet)
Seat 5: slotmachine (button) folded before Flop (didn't bet)
Seat 6: TurnOnTuneInDropOut (small blind) showed [8d Kd 9s Kc] and won ($2304)

PokerStars Hand #228844255: Omaha Pot Limit ($200/$400 USD) - 2020/10/23 13:59:56 ET
Table 'ADA409467368' 6-max Seat #2 is the button
Seat 1: soundfsilenz ($35948 in chips)
Seat 2: Aksxone ($24612 in chips)
Seat 3: kimjongun ($61215 in chips)
Seat 4: ag2703 ($122312 in chips)
Seat 5: slotmachine ($55847 in chips)
Seat 6: TurnOnTuneInDropOut ($27143 in chips)
kimjongun: posts small blind $200
ag2703: posts big blind $400
*** HOLE CARDS ***
Dealt to TurnOnTuneInDropOut [Jd Js Kd 9h]
slotmachine: folds
TurnOnTuneInDropOut: raises $1000 to $1400
soundfsilenz: folds
Aksxone: calls $1400
kimjongun: folds
ag2703: folds
*** FLOP *** [Ks 8h Th]
TurnOnTuneInDropOut: checks
Aksxone: bets $3400
TurnOnTuneInDropOut: calls $3400
*** TURN *** [Ks 8h Th] [3s]
TurnOnTuneInDropOut: checks
Aksxone: checks
*** RIVER *** [Ks 8h Th 3s] [6h]
TurnOnTuneInDropOut: checks
Aksxone: bets $3200
TurnOnTuneInDropOut: folds
Uncalled bet ($3200) returned to Aksxone
Aksxone collected $9791 from pot
Aksxone: doesn't show hand
*** SUMMARY ***
Total pot $10200 | Rake $409
Board [Ks 8h Th 3s 6h]
Seat 1: soundfsilenz folded before Flop (didn't bet)
Seat 2: Aksxone (button) collected ($9791)
Seat 3: kimjongun (small blind) folded before Flop
Seat 4: ag2703 (big blind) folded before Flop
Seat 5: slotmachine folded before Flop (didn't bet)
Seat 6: TurnOnTuneInDropOut folded on the River

PokerStars Hand #228844256: Omaha Pot Limit ($200/$400 USD) - 2020/10/23 14:01:56 ET
Table 'ADA409467368' 6-max Seat #3 is the button
Seat 1: soundfsilenz ($35948 in chips)
Seat 2: Aksxone ($29603 in chips)
Seat 3: kimjongun ($61015 in chips)
Seat 4: ag2703 ($121912 in chips)
Seat 5: slotmachine ($55847 in chips)
Seat 6: TurnOnTuneInDropOut ($22343 in chips)
ag2703: posts small blind $200
slotmachine: posts big blind $400
*** HOLE CARDS ***
Dealt to TurnOnTuneInDropOut [9h Js Ts 8d]
TurnOnTuneInDropOut: raises $1000 to $1400
soundfsilenz: folds
Aksxone: calls $1400
kimjongun: folds
ag2703: folds
slotmachine: folds
*** FLOP *** [Tc As 4c]
TurnOnTuneInDropOut: checks
Aksxone: bets $3400
TurnOnTuneInDropOut: folds
Uncalled bet ($3400) returned to Aksxone
Aksxone collected $3264 from pot
Aksxone: doesn't show hand
*** SUMMARY ***
Total pot $3400 | Rake $136
Board [Tc As 4c]
Seat 1: soundfsilenz folded before Flop (didn't bet)
Seat 2: Aksxone collected ($3264)
Seat 3: kimjongun (button) folded before Flop (didn't bet)
Seat 4: ag2703 (small blind) folded before Flop
Seat 5: slotmachine (big blind) folded before Flop
Seat 6: TurnOnTuneInDropOut folded on the Flop

PokerStars Hand #228844259: Omaha Pot Limit ($200/$400 USD) - 2020/10/23 14:05:02 ET
Table 'ADA409467368' 6-max Seat #6 is the button
Seat 1: soundfsilenz ($35548 in chips)
Seat 2: Aksxone ($35626 in chips)
Seat 3: kimjongun ($59215 in chips)
Seat 4: ag2703 ($119912 in chips)
Seat 5: slotmachine ($55247 in chips)
Seat 6: TurnOnTuneInDropOut ($33163 in chips)
soundfsilenz: posts small blind $200
Aksxone: posts big blind $400
*** HOLE CARDS ***
Dealt to TurnOnTuneInDropOut [6d Jd 7c 3h]
kimjongun: folds
ag2703: raises $1000 to $1400
slotmachine: folds
TurnOnTuneInDropOut: folds
soundfsilenz: folds
Aksxone: calls $1000
*** FLOP *** [5d 2s Kc]
Aksxone: checks
ag2703: bets $3000
Aksxone: calls $3000
*** TURN *** [5d 2s Kc] [7d]
Aksxone: checks
ag2703: checks
*** RIVER *** [5d 2s Kc 7d] [4c]
Aksxone: checks
ag2703: checks
*** SHOW DOWN ***
Aksxone: mucks hand
ag2703: shows [Ah Td Ac 9h]
ag2703 collected $8639 from pot
*** SUMMARY ***
Total pot $9000 | Rake $361
Board [5d 2s Kc 7d 4c]
Seat 1: soundfsilenz (small blind) folded before Flop
Seat 2: Aksxone (big blind) mucked
Seat 3: kimjongun folded before Flop (didn't bet)
Seat 4: ag2703 showed [Ah Td Ac 9h] and won ($8639)
Seat 5: slotmachine folded before Flop (didn't bet)
Seat 6: TurnOnTuneInDropOut (button) folded before Flop (didn't bet)

PokerStars Hand #228844261: Omaha Pot Limit ($200/$400 USD) - 2020/10/23 14:06:43 ET
Table 'ADA409467368' 6-max Seat #2 is the button
Seat 1: soundfsilenz ($35948 in chips)
Seat 2: Aksxone ($31026 in chips)
Seat 3: kimjongun ($58815 in chips)
Seat 4: ag2703 ($124151 in chips)
Seat 5: slotmachine ($55247 in chips)
Seat 6: TurnOnTuneInDropOut ($33163 in chips)
kimjongun: posts small blind $200
ag2703: posts big blind $400
*** HOLE CARDS ***
Dealt to TurnOnTuneInDropOut [As 5d 8h 3h]
slotmachine: folds
TurnOnTuneInDropOut: folds
soundfsilenz: raises $1000 to $1400
Aksxone: folds
kimjongun: folds
ag2703: folds
Uncalled bet ($1000) returned to soundfsilenz
soundfsilenz collected $1000 from pot
soundfsilenz: doesn't show hand
*** SUMMARY ***
Total pot $1000 | Rake $0
Seat 1: soundfsilenz collected ($1000)
Seat 2: Aksxone (button) folded before Flop (didn't bet)
Seat 3: kimjongun (small blind) folded before Flop
Seat 4: ag2703 (big blind) folded before Flop
Seat 5: slotmachine folded before Flop (didn't bet)
Seat 6: TurnOnTuneInDropOut folded before Flop (didn't bet)

PokerStars Hand #228844262: Omaha Pot Limit ($200/$400 USD) - 2020/10/23 14:07:30 ET
Table 'ADA409467368' 6-max Seat #3 is the button
Seat 1: soundfsilenz ($36548 in chips)
Seat 2: Aksxone ($31026 in chips)
Seat 3: kimjongun ($58615 in chips)
Seat 4: ag2703 ($123751 in chips)
Seat 5: slotmachine ($55247 in chips)
Seat 6: TurnOnTuneInDropOut ($33163 in chips)
ag2703: posts small blind $200
slotmachine: posts big blind $400
*** HOLE CARDS ***
Dealt to TurnOnTuneInDropOut [4d Kc 7h 8s]
TurnOnTuneInDropOut: folds
soundfsilenz: folds
Aksxone: folds
kimjongun: raises $1000 to $1400
ag2703: calls $1200
slotmachine: folds
*** FLOP *** [Jh Td 3s]
ag2703: checks
kimjongun: checks
*** TURN *** [Jh Td 3s] [Jc]
ag2703: checks
kimjongun: checks
*** RIVER *** [Jh Td 3s Jc] [6d]
ag2703: checks
kimjongun: bets $2112
ag2703: calls $2112
*** SHOW DOWN ***
ag2703: shows [Qh Qs 5h 2s]
kimjongun: shows [Ac 9d 2h As]
kimjongun collected $7126 from pot
*** SUMMARY ***
Total pot $7424 | Rake $298
Board [Jh Td 3s Jc 6d]
Seat 1: soundfsilenz folded before Flop (didn't bet)
Seat 2: Aksxone folded before Flop (didn't bet)
Seat 3: kimjongun (button) showed [Ac 9d 2h As] and won ($7126)
Seat 4: ag2703 (small blind) showed [Qh Qs 5h 2s] and lost
Seat 5: slotmachine (big blind) folded before Flop
Seat 6: TurnOnTuneInDropOut folded before Flop (didn't bet)

PokerStars Hand #228844265: Omaha Pot Limit ($200/$400 USD) - 2020/10/23 14:10:19 ET
Table 'ADA409467368' 6-max Seat #6 is the button
Seat 1: soundfsilenz ($36148 in chips)
Seat 2: Aksxone ($31186 in chips)
Seat 3: kimjongun ($62229 in chips)
Seat 4: ag2703 ($121375 in chips)
Seat 5: slotmachine ($54447 in chips)
Seat 6: TurnOnTuneInDropOut ($32563 in chips)
soundfsilenz: posts small blind $200
Aksxone: posts big blind $400
*** HOLE CARDS ***
Dealt to TurnOnTuneInDropOut [2s Tc Ks 3h]
kimjongun: folds
ag2703: folds
slotmachine: raises $1000 to $1400
TurnOnTuneInDropOut: folds
soundfsilenz: folds
Aksxone: calls $1000
*** FLOP *** [Qh Jc Th]
Aksxone: bets $3000
slotmachine: calls $3000
*** TURN *** [Qh Jc Th] [7s]
Aksxone: bets $9000
slotmachine: folds
Uncalled bet ($9000) returned to Aksxone
Aksxone collected $8639 from pot
Aksxone: doesn't show hand
*** SUMMARY ***
Total pot $9000 | Rake $361
Board [Qh Jc Th 7s]
Seat 1: soundfsilenz (small blind) folded before Flop
Seat 2: Aksxone (big blind) collected ($8639)
Seat 3: kimjongun folded before Flop (didn't bet)
Seat 4: ag2703 folded before Flop (didn't bet)
Seat 5: slotmachine folded on the Turn
Seat 6: TurnOnTuneInDropOut (button) folded before Flop (didn't bet)

PokerStars Hand #228844266: Omaha Pot Limit ($200/$400 USD) - 2020/10/23 14:11:09 ET
Table 'ADA409467368' 6-max Seat #1 is the button
Seat 1: soundfsilenz ($35948 in chips)
Seat 2: Aksxone ($35425 in chips)
Seat 3: kimjongun ($62229 in chips)
Seat 4: ag2703 ($121375 in chips)
Seat 5: slotmachine ($50047 in chips)
Seat 6: TurnOnTuneInDropOut ($32563 in chips)
Aksxone: posts small blind $200
kimjongun: posts big blind $400
*** HOLE CARDS ***
Dealt to TurnOnTuneInDropOut [8s Th 2s Qd]
ag2703: folds
slotmachine: raises $1000 to $1400
TurnOnTuneInDropOut: folds
soundfsilenz: folds
Aksxone: calls $1200
kimjongun: raises $4200 to $5600
slotmachine: folds
Aksxone: calls $4200
*** FLOP *** [Qh Jc 8h]
Aksxone: checks
kimjongun: bets $9450
Aksxone: folds
Uncalled bet ($9450) returned to kimjongun
kimjongun collected $12095 from pot
kimjongun: doesn't show hand
*** SUMMARY ***
Total pot $12600 | Rake $505
Board [Qh Jc 8h]
Seat 1: soundfsilenz (button) folded before Flop (didn't bet)
Seat 2: Aksxone (small blind) folded on the Flop
Seat 3: kimjongun (big blind) collected ($12095)
Seat 4: ag2703 folded before Flop (didn't bet)
Seat 5: slotmachine folded before Flop
Seat 6: TurnOnTuneInDropOut folded before Flop (didn't bet)

PokerStars Hand #228844267: Omaha Pot Limit ($200/$400 USD) - 2020/10/23 14:12:32 ET
Table 'ADA409467368' 6-max Seat #2 is the button
Seat 1: soundfsilenz ($35948 in chips)
Seat 2: Aksxone ($29825 in chips)
Seat 3: kimjongun ($68724 in chips)
Seat 4: ag2703 ($121375 in chips)
Seat 5: slotmachine ($48647 in chips)
Seat 6: TurnOnTuneInDropOut ($32563 in chips)
kimjongun: posts small blind $200
ag2703: posts big blind $400
*** HOLE CARDS ***
Dealt to TurnOnTuneInDropOut [6d 8s 2h 8c]
slotmachine: folds
TurnOnTuneInDropOut: folds
soundfsilenz: raises $400 to $800
Aksxone: raises $2200 to $3000
kimjongun: folds
ag2703: calls $2600
soundfsilenz: folds
*** FLOP *** [Kd 2d 5d]
ag2703: checks
Aksxone: bets $7000
ag2703: folds
Uncalled bet ($7000) returned to Aksxone
Aksxone collected $6719 from pot
Aksxone: doesn't show hand
*** SUMMARY ***
Total pot $7000 | Rake $281
Board [Kd 2d 5d]
Seat 1: soundfsilenz folded before Flop
Seat 2: Aksxone (button) collected ($6719)
Seat 3: kimjongun (small blind) folded before Flop
Seat 4: ag2703 (big blind) folded on the Flop
Seat 5: slotmachine folded before Flop (didn't bet)
Seat 6: TurnOnTuneInDropOut folded before Flop (didn't bet)

PokerStars Hand #228844268: Omaha Pot Limit ($200/$400 USD) - 2020/10/23 14:13:37 ET
Table 'ADA409467368' 6-max Seat #3 is the button
Seat 1: soundfsilenz ($35148 in chips)
Seat 2: Aksxone ($33544 in chips)
Seat 3: kimjongun ($68524 in chips)
Seat 4: ag2703 ($118375 in chips)
Seat 5: slotmachine ($48647 in chips)
Seat 6: TurnOnTuneInDropOut ($32563 in chips)
ag2703: posts small blind $200
slotmachine: posts big blind $400
*** HOLE CARDS ***
Dealt to TurnOnTuneInDropOut [9d 4c 6h 9h]
TurnOnTuneInDropOut: folds
soundfsilenz: folds
Aksxone: calls $400
kimjongun: raises $1400 to $1800
ag2703: folds
slotmachine: folds
Aksxone: calls $1400
*** FLOP *** [3c Kh 8d]
Aksxone: checks
kimjongun: checks
*** TURN *** [3c Kh 8d] [Jc]
Aksxone: bets $4200
kimjongun: calls $4200
*** RIVER *** [3c Kh 8d Jc] [7c]
Aksxone: checks
kimjongun: bets $12600
Aksxone: calls $12600
*** SHOW DOWN ***
Aksxone: mucks hand
kimjongun: shows [Ac 4d Tc Qs]
kimjongun collected $37000 from pot
*** SUMMARY ***
Total pot $37800 | Rake $800
Board [3c Kh 8d Jc 7c]
Seat 1: soundfsilenz folded before Flop (didn't bet)
Seat 2: Aksxone mucked
Seat 3: kimjongun (button) showed [Ac 4d Tc Qs] and won ($37000)
Seat 4: ag2703 (small blind) folded before Flop
Seat 5: slotmachine (big blind) folded before Flop
Seat 6: TurnOnTuneInDropOut folded before Flop (didn't bet)

PokerStars Hand #228844269: Omaha Pot Limit ($200/$400 USD) - 2020/10/23 14:15:14 ET
Table 'ADA409467368' 6-max Seat #4 is the button
Seat 1: soundfsilenz ($35148 in chips)
Seat 2: Aksxone ($14944 in chips)
Seat 3: kimjongun ($86924 in chips)
Seat 4: ag2703 ($118175 in chips)
Seat 5: slotmachine ($48247 in chips)
Seat 6: TurnOnTuneInDropOut ($32563 in chips)
slotmachine: posts small blind $200
TurnOnTuneInDropOut: posts big blind $400
*** HOLE CARDS ***
Dealt to TurnOnTuneInDropOut [8d Ks 2s Jh]
soundfsilenz: folds
Aksxone: folds
kimjongun: folds
ag2703: raises $1000 to $1400
slotmachine: folds
TurnOnTuneInDropOut: folds
Uncalled bet ($1000) returned to ag2703
ag2703 collected $1000 from pot
ag2703: doesn't show hand
*** SUMMARY ***
Total pot $1000 | Rake $0
Seat 1: soundfsilenz folded before Flop (didn't bet)
Seat 2: Aksxone folded before Flop (didn't bet)
Seat 3: kimjongun folded before Flop (didn't bet)
Seat 4: ag2703 (button) collected ($1000)
Seat 5: slotmachine (small blind) folded before Flop
Seat 6: TurnOnTuneInDropOut (big blind) folded before Flop

PokerStars Hand #228844270: Omaha Pot Limit ($200/$400 USD) - 2020/10/23 14:15:35 ET
Table 'ADA409467368' 6-max Seat #5 is the button
Seat 1: soundfsilenz ($35148 in chips)
Seat 2: Aksxone ($14944 in chips)
Seat 3: kimjongun ($86924 in chips)
Seat 4: ag2703 ($118775 in chips)
Seat 5: slotmachine ($48047 in chips)
Seat 6: TurnOnTuneInDropOut ($32163 in chips)
TurnOnTuneInDropOut: posts small blind $200
soundfsilenz: posts big blind $400
*** HOLE CARDS ***
Dealt to TurnOnTuneInDropOut [4h 9c Ad Qs]
Aksxone: folds
kimjongun: raises $600 to $1000
ag2703: folds
slotmachine: folds
TurnOnTuneInDropOut: folds
soundfsilenz: folds
Uncalled bet ($600) returned to kimjongun
kimjongun collected $1000 from pot
kimjongun: doesn't show hand
*** SUMMARY ***
Total pot $1000 | Rake $0
Seat 1: soundfsilenz (big blind) folded before Flop
Seat 2: Aksxone folded before Flop (didn't bet)
Seat 3: kimjongun collected ($1000)
Seat 4: ag2703 folded before Flop (didn't bet)
Seat 5: slotmachine (button) folded before Flop (didn't bet)
Seat 6: TurnOnTuneInDropOut (small blind) folded before Flop

PokerStars Hand #228844272: Omaha Pot Limit ($200/$400 USD) - 2020/10/23 14:17:24 ET
Table 'ADA409467368' 6-max Seat #1 is the button
Seat 1: soundfsilenz ($34548 in chips)
Seat 2: Aksxone ($15872 in chips)
Seat 3: kimjongun ($87524 in chips)
Seat 4: ag2703 ($117975 in chips)
Seat 5: slotmachine ($48047 in chips)
Seat 6: TurnOnTuneInDropOut ($48000 in chips)
Aksxone: posts small blind $200
kimjongun: posts big blind $400
*** HOLE CARDS ***
Dealt to TurnOnTuneInDropOut [5d 7c Ks Jc]
ag2703: folds
slotmachine: folds
TurnOnTuneInDropOut: folds
soundfsilenz: raises $1000 to $1400
Aksxone: calls $1200
kimjongun: folds
*** FLOP *** [As Ad 9h]
Aksxone: checks
soundfsilenz: checks
*** TURN *** [As Ad 9h] [7d]
Aksxone: bets $3200
soundfsilenz: calls $3200
*** RIVER *** [As Ad 9h 7d] [Qs]
Aksxone: bets $9600
soundfsilenz: calls $9600
*** SHOW DOWN ***
Aksxone: shows [Tc 2c Ac 3d]
soundfsilenz: mucks hand
Aksxone collected $28000 from pot
*** SUMMARY ***
Total pot $28800 | Rake $800
Board [As Ad 9h 7d Qs]
Seat 1: soundfsilenz (button) mucked
Seat 2: Aksxone (small blind) showed [Tc 2c Ac 3d] and won ($28000)
Seat 3: kimjongun (big blind) folded before Flop
Seat 4: ag2703 folded before Flop (didn't bet)
Seat 5: slotmachine folded before Flop (didn't bet)
Seat 6: TurnOnTuneInDropOut folded before Flop (didn't bet)

PokerStars Hand #228844273: Omaha Pot Limit ($200/$400 USD) - 2020/10/23 14:19:10 ET
Table 'ADA409467368' 6-max Seat #2 is the button
Seat 1: soundfsilenz ($20348 in chips)
Seat 2: Aksxone ($29672 in chips)
Seat 3: kimjongun ($87124 in chips)
Seat 4: ag2703 ($117975 in chips)
Seat 5: slotmachine ($48047 in chips)
Seat 6: TurnOnTuneInDropOut ($48000 in chips)
kimjongun: posts small blind $200
ag2703: posts big blind $400
*** HOLE CARDS ***
Dealt to TurnOnTuneInDropOut [Qc 6d 2c 3s]
slotmachine: folds
TurnOnTuneInDropOut: folds
soundfsilenz: folds
Aksxone: calls $400
kimjongun: calls $200
ag2703: raises $400 to $800
Aksxone: calls $400
kimjongun: folds
*** FLOP *** [Jc 9h Kd]
ag2703: checks
Aksxone: checks
*** TURN *** [Jc 9h Kd] [9d]
ag2703: checks
Aksxone: checks
*** RIVER *** [Jc 9h Kd 9d] [Qs]
ag2703: checks
Aksxone: bets $2000
ag2703: folds
Uncalled bet ($2000) returned to Aksxone
Aksxone collected $1920 from pot
Aksxone: doesn't show hand
*** SUMMARY ***
Total pot $2000 | Rake $80
Board [Jc 9h Kd 9d Qs]
Seat 1: soundfsilenz folded before Flop (didn't bet)
Seat 2: Aksxone (button) collected ($1920)
Seat 3: kimjongun (small blind) folded before Flop
Seat 4: ag2703 (big blind) folded on the River
Seat 5: slotmachine folded before Flop (didn't bet)
Seat 6: TurnOnTuneInDropOut folded before Flop (didn't bet)

PokerStars Hand #228844274: Omaha Pot Limit ($200/$400 USD) - 2020/10/23 14:20:51 ET
Table 'ADA409467368' 6-max Seat #3 is the button
Seat 1: soundfsilenz ($44349 in chips)
Seat 2: Aksxone ($30792 in chips)
Seat 3: kimjongun ($86724 in chips)
Seat 4: ag2703 ($117175 in chips)
Seat 5: slotmachine ($48047 in chips)
Seat 6: TurnOnTuneInDropOut ($48000 in chips)
ag2703: posts small blind $200
slotmachine: posts big blind $400
*** HOLE CARDS ***
Dealt to TurnOnTuneInDropOut [6h 4d 6c 3s]
TurnOnTuneInDropOut: folds
soundfsilenz: raises $1000 to $1400
Aksxone: calls $1400
kimjongun: folds
ag2703: folds
slotmachine: folds
*** FLOP *** [Kc 9h Ad]
soundfsilenz: bets $2278
Aksxone: folds
Uncalled bet ($2278) returned to soundfsilenz
soundfsilenz collected $3264 from pot
soundfsilenz: doesn't show hand
*** SUMMARY ***
Total pot $3400 | Rake $136
Board [Kc 9h Ad]
Seat 1: soundfsilenz collected ($3264)
Seat 2: Aksxone folded on the Flop
Seat 3: kimjongun (button) folded before Flop (didn't bet)
Seat 4: ag2703 (small blind) folded before Flop
Seat 5: slotmachine (big blind) folded before Flop
Seat 6: TurnOnTuneInDropOut folded before Flop (didn't bet)

PokerStars Hand #228844277: Omaha Pot Limit ($200/$400 USD) - 2020/10/23 14:24:55 ET
Table 'ADA409467368' 6-max Seat #6 is the button
Seat 1: soundfsilenz ($45813 in chips)
Seat 2: Aksxone ($28992 in chips)
Seat 3: kimjongun ($86724 in chips)
Seat 4: ag2703 ($120823 in chips)
Seat 5: slotmachine ($47447 in chips)
Seat 6: TurnOnTuneInDropOut ($44852 in chips)
soundfsilenz: posts small blind $200
Aksxone: posts big blind $400
*** HOLE CARDS ***
Dealt to TurnOnTuneInDropOut [Jc As 4s Ah]
kimjongun: folds
ag2703: folds
slotmachine: folds
TurnOnTuneInDropOut: raises $1000 to $1400
soundfsilenz: folds
Aksxone: folds
Uncalled bet ($1000) returned to TurnOnTuneInDropOut
TurnOnTuneInDropOut collected $1000 from pot
TurnOnTuneInDropOut: doesn't show hand
*** SUMMARY ***
Total pot $1000 | Rake $0
Seat 1: soundfsilenz (small blind) folded before Flop
Seat 2: Aksxone (big blind) folded before Flop
Seat 3: kimjongun folded before Flop (didn't bet)
Seat 4: ag2703 folded before Flop (didn't bet)
Seat 5: slotmachine folded before Flop (didn't bet)
Seat 6: TurnOnTuneInDropOut (button) collected ($1000)

PokerStars Hand #228844278: Omaha Pot Limit ($200/$400 USD) - 2020/10/23 14:25:36 ET
Table 'ADA409467368' 6-max Seat #1 is the button
Seat 1: soundfsilenz ($45613 in chips)
Seat 2: Aksxone ($28592 in chips)
Seat 3: kimjongun ($86724 in chips)
Seat 4: ag2703 ($120823 in chips)
Seat 5: slotmachine ($47447 in chips)
Seat 6: TurnOnTuneInDropOut ($45452 in chips)
Aksxone: posts small blind $200
kimjongun: posts big blind $400
*** HOLE CARDS ***
Dealt to TurnOnTuneInDropOut [Qc 2d 4d Jc]
ag2703: folds
slotmachine: folds
TurnOnTuneInDropOut: folds
soundfsilenz: folds
Aksxone: folds
Uncalled bet ($200) returned to kimjongun
kimjongun collected $400 from pot
kimjongun: doesn't show hand
*** SUMMARY ***
Total pot $400 | Rake $0
Seat 1: soundfsilenz (button) folded before Flop (didn't bet)
Seat 2: Aksxone (small blind) folded before Flop
Seat 3: kimjongun (big blind) collected ($400)
Seat 4: ag2703 folded before Flop (didn't bet)
Seat 5: slotmachine folded before Flop (didn't bet)
Seat 6: TurnOnTuneInDropOut folded before Flop (didn't bet)

PokerStars Hand #228844279: Omaha Pot Limit ($200/$400 USD) - 2020/10/23 14:26:22 ET
Table 'ADA409467368' 6-max Seat #2 is the button
Seat 1: soundfsilenz ($45613 in chips)
Seat 2: Aksxone ($28392 in chips)
Seat 3: kimjongun ($86924 in chips)
Seat 4: ag2703 ($120823 in chips)
Seat 5: slotmachine ($47447 in chips)
Seat 6: TurnOnTuneInDropOut ($45452 in chips)
kimjongun: posts small blind $200
ag2703: posts big blind $400
*** HOLE CARDS ***
Dealt to TurnOnTuneInDropOut [Js 8h Kd 9c]
slotmachine: raises $1000 to $1400
TurnOnTuneInDropOut: folds
soundfsilenz: folds
Aksxone: calls $1400
kimjongun: folds
ag2703: calls $1000
*** FLOP *** [Jd Kh 2h]
ag2703: checks
slotmachine: checks
Aksxone: bets $4400
ag2703: folds
slotmachine: folds
Uncalled bet ($4400) returned to Aksxone
Aksxone collected $4224 from pot
Aksxone: doesn't show hand
*** SUMMARY ***
Total pot $4400 | Rake $176
Board [Jd Kh 2h]
Seat 1: soundfsilenz folded before Flop (didn't bet)
Seat 2: Aksxone (button) collected ($4224)
Seat 3: kimjongun (small blind) folded before Flop
Seat 4: ag2703 (big blind) folded on the Flop
Seat 5: slotmachine folded on the Flop
Seat 6: TurnOnTuneInDropOut folded before Flop (didn't bet)

PokerStars Hand #228844281: Omaha Pot Limit ($200/$400 USD) - 2020/10/23 14:29:39 ET
Table 'ADA409467368' 6-max Seat #5 is the button
Seat 1: soundfsilenz ($45613 in chips)
Seat 2: Aksxone ($25588 in chips)
Seat 4: ag2703 ($130386 in chips)
Seat 5: slotmachine ($40419 in chips)
Seat 6: TurnOnTuneInDropOut ($45052 in chips)
TurnOnTuneInDropOut: posts small blind $200
soundfsilenz: posts big blind $400
*** HOLE CARDS ***
Dealt to TurnOnTuneInDropOut [7c 4h 9h 9s]
Aksxone: raises $1000 to $1400
ag2703: calls $1400
slotmachine: folds
TurnOnTuneInDropOut: folds
soundfsilenz: folds
*** FLOP *** [Kc 8h 7d]
Aksxone: bets $3400
ag2703: calls $3400
*** TURN *** [Kc 8h 7d] [6s]
Aksxone: bets $10200
ag2703: raises $10200 to $20400
Aksxone: raises $388 to $20788 and is all-in
ag2703: calls $388
*** RIVER *** [Kc 8h 7d 6s] [Th]
*** SHOW DOWN ***
Aksxone: shows [6d 5c Ac 8d]
ag2703: shows [7s 7h 9d 6h]
ag2703 collected $50976 from pot
*** SUMMARY ***
Total pot $51776 | Rake $800
Board [Kc 8h 7d 6s Th]
Seat 1: soundfsilenz (big blind) folded before Flop
Seat 2: Aksxone showed [6d 5c Ac 8d] and lost
Seat 4: ag2703 showed [7s 7h 9d 6h] and won ($50976)
Seat 5: slotmachine (button) folded before Flop (didn't bet)
Seat 6: TurnOnTuneInDropOut (small blind) folded before Flop

PokerStars Hand #228844282: Omaha Pot Limit ($200/$400 USD) - 2020/10/23 14:30:38 ET
Table 'ADA409467368' 6-max Seat #6 is the button
Seat 1: soundfsilenz ($45213 in chips)
Seat 3: kimjongun ($86724 in chips)
Seat 4: ag2703 ($155774 in chips)
Seat 5: slotmachine ($40419 in chips)
Seat 6: TurnOnTuneInDropOut ($44852 in chips)
soundfsilenz: posts small blind $200
kimjongun: posts big blind $400
*** HOLE CARDS ***
Dealt to TurnOnTuneInDropOut [5c Kc Kh 3h]
ag2703: folds
slotmachine: folds
TurnOnTuneInDropOut: raises $1000 to $1400
soundfsilenz: folds
kimjongun: folds
Uncalled bet ($1000) returned to TurnOnTuneInDropOut
TurnOnTuneInDropOut collected $1000 from pot
TurnOnTuneInDropOut: doesn't show hand
*** SUMMARY ***
Total pot $1000 | Rake $0
Seat 1: soundfsilenz (small blind) folded before Flop
Seat 3: kimjongun (big blind) folded before Flop
Seat 4: ag2703 folded before Flop (didn't bet)
Seat 5: slotmachine folded before Flop (didn't bet)
Seat 6: TurnOnTuneInDropOut (button) collected ($1000)

PokerStars Hand #228844283: Omaha Pot Limit ($200/$400 USD) - 2020/10/23 14:31:16 ET
Table 'ADA409467368' 6-max Seat #1 is the button
Seat 1: soundfsilenz ($45013 in chips)
Seat 3: kimjongun ($86324 in chips)
Seat 4: ag2703 ($155774 in chips)
Seat 5: slotmachine ($40419 in chips)
Seat 6: TurnOnTuneInDropOut ($45452 in chips)
kimjongun: posts small blind $200
ag2703: posts big blind $400
*** HOLE CARDS ***
Dealt to TurnOnTuneInDropOut [6c 4c 9s 3h]
slotmachine: raises $1000 to $1400
TurnOnTuneInDropOut: folds
soundfsilenz: folds
kimjongun: folds
ag2703: calls $1000
*** FLOP *** [6s 7h 8s]
ag2703: checks
slotmachine: checks
*** TURN *** [6s 7h 8s] [3c]
ag2703: bets $3000
slotmachine: calls $3000
*** RIVER *** [6s 7h 8s 3c] [Kd]
ag2703: bets $9000
slotmachine: folds
Uncalled bet ($9000) returned to ag2703
ag2703 collected $8639 from pot
ag2703: doesn't show hand
*** SUMMARY ***
Total pot $9000 | Rake $361
Board [6s 7h 8s 3c Kd]
Seat 1: soundfsilenz (button) folded before Flop (didn't bet)
Seat 3: kimjongun (small blind) folded before Flop
Seat 4: ag2703 (big blind) collected ($8639)
Seat 5: slotmachine folded on the River
Seat 6: TurnOnTuneInDropOut folded before Flop (didn't bet)

PokerStars Hand #228844284: Omaha Pot Limit ($200/$400 USD) - 2020/10/23 14:32:30 ET
Table 'ADA409467368' 6-max Seat #3 is the button
Seat 1: soundfsilenz ($45013 in chips)
Seat 3: kimjongun ($86124 in chips)
Seat 4: ag2703 ($160013 in chips)
Seat 5: slotmachine ($48000 in chips)
Seat 6: TurnOnTuneInDropOut ($45452 in chips)
ag2703: posts small blind $200
slotmachine: posts big blind $400
*** HOLE CARDS ***
Dealt to TurnOnTuneInDropOut [Kh 2c 7c 3h]
TurnOnTuneInDropOut: folds
soundfsilenz: folds
kimjongun: raises $1000 to $1400
ag2703: folds
slotmachine: calls $1000
*** FLOP *** [7h 3s 9d]
slotmachine: checks
kimjongun: checks
*** TURN *** [7h 3s 9d] [Qd]
slotmachine: checks
kimjongun: bets $3000
slotmachine: folds
Uncalled bet ($3000) returned to kimjongun
kimjongun collected $2880 from pot
kimjongun: doesn't show hand
*** SUMMARY ***
Total pot $3000 | Rake $120
Board [7h 3s 9d Qd]
Seat 1: soundfsilenz folded before Flop (didn't bet)
Seat 3: kimjongun (button) collected ($2880)
Seat 4: ag2703 (small blind) folded before Flop
Seat 5: slotmachine (big blind) folded on the Turn
Seat 6: TurnOnTuneInDropOut folded before Flop (didn't bet)

PokerStars Hand #228844285: Omaha Pot Limit ($200/$400 USD) - 2020/10/23 14:33:16 ET
Table 'ADA409467368' 6-max Seat #4 is the button
Seat 1: soundfsilenz ($45013 in chips)
Seat 3: kimjongun ($87604 in chips)
Seat 4: ag2703 ($159813 in chips)
Seat 5: slotmachine ($46600 in chips)
Seat 6: TurnOnTuneInDropOut ($45452 in chips)
slotmachine: posts small blind $200
TurnOnTuneInDropOut: posts big blind $400
*** HOLE CARDS ***
Dealt to TurnOnTuneInDropOut [5d 9h Qh 6d]
soundfsilenz: raises $1000 to $1400
kimjongun: raises $3400 to $4800
ag2703: folds
slotmachine: folds
TurnOnTuneInDropOut: folds
soundfsilenz: raises $10200 to $15000
kimjongun: calls $10200
*** FLOP *** [Qs Ac Ad]
soundfsilenz: bets $30013 and is all-in
kimjongun: folds
Uncalled bet ($30013) returned to soundfsilenz
soundfsilenz collected $29800 from pot
soundfsilenz: doesn't show hand
*** SUMMARY ***
Total pot $30600 | Rake $800
Board [Qs Ac Ad]
Seat 1: soundfsilenz collected ($29800)
Seat 3: kimjongun folded on the Flop
Seat 4: ag2703 (button) folded before Flop (didn't bet)
Seat 5: slotmachine (small blind) folded before Flop
Seat 6: TurnOnTuneInDropOut (big blind) folded before Flop

PokerStars Hand #228844286: Omaha Pot Limit ($200/$400 USD) - 2020/10/23 14:35:01 ET
Table 'ADA409467368' 6-max Seat #5 is the button
Seat 1: soundfsilenz ($59813 in chips)
Seat 3: kimjongun ($72604 in chips)
Seat 4: ag2703 ($159813 in chips)
Seat 5: slotmachine ($46400 in chips)
Seat 6: TurnOnTuneInDropOut ($45052 in chips)
TurnOnTuneInDropOut: posts small blind $200
soundfsilenz: posts big blind $400
*** HOLE CARDS ***
Dealt to TurnOnTuneInDropOut [Qh 9d Qs 6s]
kimjongun: folds
ag2703: folds
slotmachine: raises $1000 to $1400
TurnOnTuneInDropOut: folds
soundfsilenz: folds
Uncalled bet ($1000) returned to slotmachine
slotmachine collected $1000 from pot
slotmachine: doesn't show hand
*** SUMMARY ***
Total pot $1000 | Rake $0
Seat 1: soundfsilenz (big blind) folded before Flop
Seat 3: kimjongun folded before Flop (didn't bet)
Seat 4: ag2703 folded before Flop (didn't bet)
Seat 5: slotmachine (button) collected ($1000)
Seat 6: TurnOnTuneInDropOut (small blind) folded before Flop

PokerStars Hand #228844287: Omaha Pot Limit ($200/$400 USD) - 2020/10/23 14:35:30 ET
Table 'ADA409467368' 6-max Seat #6 is the button
Seat 1: soundfsilenz ($59413 in chips)
Seat 3: kimjongun ($72604 in chips)
Seat 4: ag2703 ($159813 in chips)
Seat 5: slotmachine ($47000 in chips)
Seat 6: TurnOnTuneInDropOut ($44852 in chips)
soundfsilenz: posts small blind $200
kimjongun: posts big blind $400
*** HOLE CARDS ***
Dealt to TurnOnTuneInDropOut [5s 2s As 6d]
ag2703: raises $1000 to $1400
slotmachine: folds
TurnOnTuneInDropOut: folds
soundfsilenz: folds
kimjongun: folds
Uncalled bet ($1000) returned to ag2703
ag2703 collected $1000 from pot
ag2703: doesn't show hand
*** SUMMARY ***
Total pot $1000 | Rake $0
Seat 1: soundfsilenz (small blind) folded before Flop
Seat 3: kimjongun (big blind) folded before Flop
Seat 4: ag2703 collected ($1000)
Seat 5: slotmachine folded before Flop (didn't bet)
Seat 6: TurnOnTuneInDropOut (button) folded before Flop (didn't bet)

PokerStars Hand #228844288: Omaha Pot Limit ($200/$400 USD) - 2020/10/23 14:36:00 ET
Table 'ADA409467368' 6-max Seat #1 is the button
Seat 1: soundfsilenz ($59213 in chips)
Seat 3: kimjongun ($72204 in chips)
Seat 4: ag2703 ($160413 in chips)
Seat 5: slotmachine ($47000 in chips)
Seat 6: TurnOnTuneInDropOut ($44852 in chips)
kimjongun: posts small blind $200
ag2703: posts big blind $400
*** HOLE CARDS ***
Dealt to TurnOnTuneInDropOut [Jd Qc 3h 7d]
slotmachine: folds
TurnOnTuneInDropOut: folds
soundfsilenz: folds
kimjongun: folds
Uncalled bet ($200) returned to ag2703
ag2703 collected $400 from pot
ag2703: doesn't show hand
*** SUMMARY ***
Total pot $400 | Rake $0
Seat 1: soundfsilenz (button) folded before Flop (didn't bet)
Seat 3: kimjongun (small blind) folded before Flop
Seat 4: ag2703 (big blind) collected ($400)
Seat 5: slotmachine folded before Flop (didn't bet)
Seat 6: TurnOnTuneInDropOut folded before Flop (didn't bet)

PokerStars Hand #228844289: Omaha Pot Limit ($200/$400 USD) - 2020/10/23 14:36:25 ET
Table 'ADA409467368' 6-max Seat #3 is the button
Seat 1: soundfsilenz ($59213 in chips)
Seat 3: kimjongun ($72004 in chips)
Seat 4: ag2703 ($160613 in chips)
Seat 5: slotmachine ($47000 in chips)
Seat 6: TurnOnTuneInDropOut ($44852 in chips)
ag2703: posts small blind $200
slotmachine: posts big blind $400
*** HOLE CARDS ***
Dealt to TurnOnTuneInDropOut [5c 6d 8h Qs]
TurnOnTuneInDropOut: folds
soundfsilenz: folds
kimjongun: folds
ag2703: calls $200
slotmachine: checks
*** FLOP *** [7c 5d Jh]
ag2703: bets $800
slotmachine: calls $800
*** TURN *** [7c 5d Jh] [3d]
ag2703: checks
slotmachine: checks
*** RIVER *** [7c 5d Jh 3d] [6s]
ag2703: checks
slotmachine: bets $1200
ag2703: folds
Uncalled bet ($1200) returned to slotmachine
slotmachine collected $2304 from pot
slotmachine: doesn't show hand
*** SUMMARY ***
Total pot $2400 | Rake $96
Board [7c 5d Jh 3d 6s]
Seat 1: soundfsilenz folded before Flop (didn't bet)
Seat 3: kimjongun (button) folded before Flop (didn't bet)
Seat 4: ag2703 (small blind) folded on the River
Seat 5: slotmachine (big blind) collected ($2304)
Seat 6: TurnOnTuneInDropOut folded before Flop (didn't bet)

PokerStars Hand #228844291: Omaha Pot Limit ($200/$400 USD) - 2020/10/23 14:39:00 ET
Table 'ADA409467368' 6-max Seat #5 is the button
Seat 1: soundfsilenz ($59213 in chips)
Seat 4: ag2703 ($158013 in chips)
Seat 5: slotmachine ($47904 in chips)
Seat 6: TurnOnTuneInDropOut ($46332 in chips)
TurnOnTuneInDropOut: posts small blind $200
soundfsilenz: posts big blind $400
*** HOLE CARDS ***
Dealt to TurnOnTuneInDropOut [8c Ah Qh 2h]
ag2703: folds
slotmachine: raises $1000 to $1400
TurnOnTuneInDropOut: folds
soundfsilenz: folds
Uncalled bet ($1000) returned to slotmachine
slotmachine collected $1000 from pot
slotmachine: doesn't show hand
*** SUMMARY ***
Total pot $1000 | Rake $0
Seat 1: soundfsilenz (big blind) folded before Flop
Seat 4: ag2703 folded before Flop (didn't bet)
Seat 5: slotmachine (button) collected ($1000)
Seat 6: TurnOnTuneInDropOut (small blind) folded before Flop

PokerStars Hand #228844293: Omaha Pot Limit ($200/$400 USD) - 2020/10/23 14:40:13 ET
Table 'ADA409467368' 6-max Seat #1 is the button
Seat 1: soundfsilenz ($58613 in chips)
Seat 3: kimjongun ($71604 in chips)
Seat 4: ag2703 ($157613 in chips)
Seat 5: slotmachine ($49504 in chips)
Seat 6: TurnOnTuneInDropOut ($46132 in chips)
kimjongun: posts small blind $200
ag2703: posts big blind $400
*** HOLE CARDS ***
Dealt to TurnOnTuneInDropOut [7d 5d 6h Kd]
slotmachine: raises $1000 to $1400
TurnOnTuneInDropOut: folds
soundfsilenz: folds
kimjongun: raises $3200 to $4600
ag2703: folds
slotmachine: calls $3200
*** FLOP *** [6d Qs 8d]
kimjongun: checks
slotmachine: checks
*** TURN *** [6d Qs 8d] [Qc]
kimjongun: bets $4800
slotmachine: raises $12240 to $17040
kimjongun: raises $43680 to $60720
slotmachine: folds
Uncalled bet ($43680) returned to kimjongun
kimjongun collected $42880 from pot
kimjongun: doesn't show hand
*** SUMMARY ***
Total pot $43680 | Rake $800
Board [6d Qs 8d Qc]
Seat 1: soundfsilenz (button) folded before Flop (didn't bet)
Seat 3: kimjongun (small blind) collected ($42880)
Seat 4: ag2703 (big blind) folded before Flop
Seat 5: slotmachine folded on the Turn
Seat 6: TurnOnTuneInDropOut folded before Flop (didn't bet)

PokerStars Hand #228844294: Omaha Pot Limit ($200/$400 USD) - 2020/10/23 14:41:22 ET
Table 'ADA409467368' 6-max Seat #3 is the button
Seat 1: soundfsilenz ($58613 in chips)
Seat 3: kimjongun ($92844 in chips)
Seat 4: ag2703 ($157213 in chips)
Seat 5: slotmachine ($48000 in chips)
Seat 6: TurnOnTuneInDropOut ($46132 in chips)
ag2703: posts small blind $200
slotmachine: posts big blind $400
*** HOLE CARDS ***
Dealt to TurnOnTuneInDropOut [2h Td 8h 3h]
TurnOnTuneInDropOut: folds
soundfsilenz: raises $1000 to $1400
kimjongun: folds
ag2703: calls $1200
slotmachine: calls $1000
*** FLOP *** [4s 3s 9c]
ag2703: checks
slotmachine: checks
soundfsilenz: checks
*** TURN *** [4s 3s 9c] [Qd]
ag2703: checks
slotmachine: checks
soundfsilenz: checks
*** RIVER *** [4s 3s 9c Qd] [5d]
ag2703: checks
slotmachine: bets $3150
soundfsilenz: folds
ag2703: folds
Uncalled bet ($3150) returned to slotmachine
slotmachine collected $4032 from pot
slotmachine: doesn't show hand
*** SUMMARY ***
Total pot $4200 | Rake $168
Board [4s 3s 9c Qd 5d]
Seat 1: soundfsilenz folded on the River
Seat 3: kimjongun (button) folded before Flop (didn't bet)
Seat 4: ag2703 (small blind) folded on the River
Seat 5: slotmachine (big blind) collected ($4032)
Seat 6: TurnOnTuneInDropOut folded before Flop (didn't bet)

PokerStars Hand #228844364: Omaha Pot Limit ($200/$400 USD) - 2020/10/23 16:39:31 ET
Table 'ADA409467368' 6-max Seat #3 is the button
Seat 3: yatin47 ($50911 in chips)
Seat 4: hashstack ($22515 in chips)
Seat 5: TurnOnTuneInDropOut ($30000 in chips)
hashstack: posts small blind $200
TurnOnTuneInDropOut: posts big blind $400
*** HOLE CARDS ***
Dealt to TurnOnTuneInDropOut [7c 6h Kd 6s]
yatin47: folds
hashstack: raises $800 to $1200
TurnOnTuneInDropOut: folds
Uncalled bet ($800) returned to hashstack
hashstack collected $800 from pot
hashstack: doesn't show hand
*** SUMMARY ***
Total pot $800 | Rake $0
Seat 3: yatin47 (button) folded before Flop (didn't bet)
Seat 4: hashstack (small blind) collected ($800)
Seat 5: TurnOnTuneInDropOut (big blind) folded before Flop

PokerStars Hand #228844365: Omaha Pot Limit ($200/$400 USD) - 2020/10/23 16:39:46 ET
Table 'ADA409467368' 6-max Seat #4 is the button
Seat 3: yatin47 ($50911 in chips)
Seat 4: hashstack ($22915 in chips)
Seat 5: TurnOnTuneInDropOut ($29600 in chips)
TurnOnTuneInDropOut: posts small blind $200
yatin47: posts big blind $400
*** HOLE CARDS ***
Dealt to TurnOnTuneInDropOut [Ad 9s 5d 2h]
hashstack: raises $650 to $1050
TurnOnTuneInDropOut: folds
yatin47: calls $650
*** FLOP *** [As 7c 6d]
yatin47: checks
hashstack: bets $1725
yatin47: folds
Uncalled bet ($1725) returned to hashstack
hashstack collected $2208 from pot
hashstack: doesn't show hand
*** SUMMARY ***
Total pot $2300 | Rake $92
Board [As 7c 6d]
Seat 3: yatin47 (big blind) folded on the Flop
Seat 4: hashstack (button) collected ($2208)
Seat 5: TurnOnTuneInDropOut (small blind) folded before Flop

PokerStars Hand #228844366: Omaha Pot Limit ($200/$400 USD) - 2020/10/23 16:40:03 ET
Table 'ADA409467368' 6-max Seat #5 is the button
Seat 3: yatin47 ($49861 in chips)
Seat 4: hashstack ($24073 in chips)
Seat 5: TurnOnTuneInDropOut ($29400 in chips)
yatin47: posts small blind $200
hashstack: posts big blind $400
*** HOLE CARDS ***
Dealt to TurnOnTuneInDropOut [2c 8s Kh 2d]
TurnOnTuneInDropOut: folds
yatin47: calls $200
hashstack: raises $800 to $1200
yatin47: calls $800
*** FLOP *** [Tc Kc 9c]
yatin47: checks
hashstack: checks
*** TURN *** [Tc Kc 9c] [6h]
yatin47: checks
hashstack: checks
*** RIVER *** [Tc Kc 9c 6h] [Td]
yatin47: checks
hashstack: checks
*** SHOW DOWN ***
yatin47: shows [Ks 6c 7s Qc]
hashstack: mucks hand
yatin47 collected $2304 from pot
*** SUMMARY ***
Total pot $2400 | Rake $96
Board [Tc Kc 9c 6h Td]
Seat 3: yatin47 (small blind) showed [Ks 6c 7s Qc] and won ($2304)
Seat 4: hashstack (big blind) mucked
Seat 5: TurnOnTuneInDropOut (button) folded before Flop (didn't bet)

PokerStars Hand #228844368: Omaha Pot Limit ($200/$400 USD) - 2020/10/23 16:41:01 ET
Table 'ADA409467368' 6-max Seat #4 is the button
Seat 1: Sam565 ($12000 in chips)
Seat 3: yatin47 ($50565 in chips)
Seat 4: hashstack ($22473 in chips)
Seat 5: TurnOnTuneInDropOut ($30152 in chips)
TurnOnTuneInDropOut: posts small blind $200
Sam565: posts big blind $400
*** HOLE CARDS ***
Dealt to TurnOnTuneInDropOut [9s 7c 4d 4s]
yatin47: folds
hashstack: raises $650 to $1050
TurnOnTuneInDropOut: folds
Sam565: calls $650
*** FLOP *** [3s 7d 2c]
Sam565: checks
hashstack: bets $1600
Sam565: calls $1600
*** TURN *** [3s 7d 2c] [6d]
Sam565: checks
hashstack: bets $4125
Sam565: raises $5225 to $9350 and is all-in
hashstack: calls $5225
*** RIVER *** [3s 7d 2c 6d] [Kd]
*** SHOW DOWN ***
Sam565: shows [8d As 7h 6c]
hashstack: shows [Kc 3d 3h Jh]
hashstack collected $23400 from pot
*** SUMMARY ***
Total pot $24200 | Rake $800
Board [3s 7d 2c 6d Kd]
Seat 1: Sam565 (big blind) showed [8d As 7h 6c] and lost
Seat 3: yatin47 folded before Flop (didn't bet)
Seat 4: hashstack (button) showed [Kc 3d 3h Jh] and won ($23400)
Seat 5: TurnOnTuneInDropOut (small blind) folded before Flop

PokerStars Hand #228844369: Omaha Pot Limit ($200/$400 USD) - 2020/10/23 16:41:32 ET
Table 'ADA409467368' 6-max Seat #5 is the button
Seat 3: yatin47 ($50565 in chips)
Seat 4: hashstack ($33873 in chips)
Seat 5: TurnOnTuneInDropOut ($29952 in chips)
yatin47: posts small blind $200
hashstack: posts big blind $400
*** HOLE CARDS ***
Dealt to TurnOnTuneInDropOut [Jd Ac 2d Jc]
TurnOnTuneInDropOut: raises $1000 to $1400
yatin47: folds
hashstack: calls $1000
*** FLOP *** [5s 7h 9h]
hashstack: bets $2250
TurnOnTuneInDropOut: folds
Uncalled bet ($2250) returned to hashstack
hashstack collected $2880 from pot
hashstack: doesn't show hand
*** SUMMARY ***
Total pot $3000 | Rake $120
Board [5s 7h 9h]
Seat 3: yatin47 (small blind) folded before Flop
Seat 4: hashstack (big blind) collected ($2880)
Seat 5: TurnOnTuneInDropOut (button) folded on the Flop

PokerStars Hand #228844371: Omaha Pot Limit ($200/$400 USD) - 2020/10/23 16:42:26 ET
Table 'ADA409467368' 6-max Seat #4 is the button
Seat 1: Sam565 ($11600 in chips)
Seat 3: yatin47 ($51501 in chips)
Seat 4: hashstack ($34953 in chips)
Seat 5: TurnOnTuneInDropOut ($28152 in chips)
TurnOnTuneInDropOut: posts small blind $200
Sam565: posts big blind $400
*** HOLE CARDS ***
Dealt to TurnOnTuneInDropOut [Th 7d Ks 4h]
yatin47: folds
hashstack: raises $800 to $1200
TurnOnTuneInDropOut: folds
Sam565: raises $2600 to $3800
hashstack: calls $2600
*** FLOP *** [Kh 8d Qh]
Sam565: bets $7800 and is all-in
hashstack: calls $7800
*** TURN *** [Kh 8d Qh] [2s]
*** RIVER *** [Kh 8d Qh 2s] [3c]
*** SHOW DOWN ***
Sam565: shows [6s As 5d Ac]
hashstack: shows [4c 8s 6d 5c]
Sam565 collected $22600 from pot
*** SUMMARY ***
Total pot $23400 | Rake $800
Board [Kh 8d Qh 2s 3c]
Seat 1: Sam565 (big blind) showed [6s As 5d Ac] and won ($22600)
Seat 3: yatin47 folded before Flop (didn't bet)
Seat 4: hashstack (button) showed [4c 8s 6d 5c] and lost
Seat 5: TurnOnTuneInDropOut (small blind) folded before Flop

PokerStars Hand #228844372: Omaha Pot Limit ($200/$400 USD) - 2020/10/23 16:42:49 ET
Table 'ADA409467368' 6-max Seat #5 is the button
Seat 1: Sam565 ($22600 in chips)
Seat 3: yatin47 ($51501 in chips)
Seat 4: hashstack ($23353 in chips)
Seat 5: TurnOnTuneInDropOut ($27952 in chips)
Sam565: posts small blind $200
yatin47: posts big blind $400
*** HOLE CARDS ***
Dealt to TurnOnTuneInDropOut [9h 4h As Qd]
hashstack: raises $650 to $1050
TurnOnTuneInDropOut: folds
Sam565: calls $850
yatin47: calls $650
*** FLOP *** [2s 5c 7s]
Sam565: checks
yatin47: checks
hashstack: checks
*** TURN *** [2s 5c 7s] [Jh]
Sam565: checks
yatin47: checks
hashstack: bets $1975
Sam565: folds
yatin47: calls $1975
*** RIVER *** [2s 5c 7s Jh] [Ad]
yatin47: checks
hashstack: checks
*** SHOW DOWN ***
yatin47: mucks hand
hashstack: shows [Js 8d 9c 4d]
hashstack collected $6815 from pot
*** SUMMARY ***
Total pot $7100 | Rake $285
Board [2s 5c 7s Jh Ad]
Seat 1: Sam565 (small blind) folded on the Turn
Seat 3: yatin47 (big blind) mucked
Seat 4: hashstack showed [Js 8d 9c 4d] and won ($6815)
Seat 5: TurnOnTuneInDropOut (button) folded before Flop (didn't bet)

PokerStars Hand #228844373: Omaha Pot Limit ($200/$400 USD) - 2020/10/23 16:43:33 ET
Table 'ADA409467368' 6-max Seat #1 is the button
Seat 1: Sam565 ($21550 in chips)
Seat 3: yatin47 ($48476 in chips)
Seat 4: hashstack ($27143 in chips)
Seat 5: TurnOnTuneInDropOut ($48000 in chips)
yatin47: posts small blind $200
hashstack: posts big blind $400
*** HOLE CARDS ***
Dealt to TurnOnTuneInDropOut [6c 3c 9s 3s]
TurnOnTuneInDropOut: folds
Sam565: folds
yatin47: calls $200
hashstack: raises $800 to $1200
yatin47: raises $2400 to $3600
hashstack: calls $2400
*** FLOP *** [Ac 2s 5d]
yatin47: bets $7200
hashstack: folds
Uncalled bet ($7200) returned to yatin47
yatin47 collected $6911 from pot
yatin47: doesn't show hand
*** SUMMARY ***
Total pot $7200 | Rake $289
Board [Ac 2s 5d]
Seat 1: Sam565 (button) folded before Flop (didn't bet)
Seat 3: yatin47 (small blind) collected ($6911)
Seat 4: hashstack (big blind) folded on the Flop
Seat 5: TurnOnTuneInDropOut folded before Flop (didn't bet)

PokerStars Hand #228844375: Omaha Pot Limit ($200/$400 USD) - 2020/10/23 16:45:03 ET
Table 'ADA409467368' 6-max Seat #4 is the button
Seat 1: Sam565 ($21550 in chips)
Seat 3: yatin47 ($50187 in chips)
Seat 4: hashstack ($23143 in chips)
Seat 5: TurnOnTuneInDropOut ($49856 in chips)
TurnOnTuneInDropOut: posts small blind $200
Sam565: posts big blind $400
*** HOLE CARDS ***
Dealt to TurnOnTuneInDropOut [5d Td Tc 6h]
yatin47: folds
hashstack: raises $1000 to $1400
TurnOnTuneInDropOut: folds
Sam565: calls $1000
*** FLOP *** [Kh 3s 8s]
Sam565: checks
hashstack: bets $1500
Sam565: folds
Uncalled bet ($1500) returned to hashstack
hashstack collected $2880 from pot
hashstack: doesn't show hand
*** SUMMARY ***
Total pot $3000 | Rake $120
Board [Kh 3s 8s]
Seat 1: Sam565 (big blind) folded on the Flop
Seat 3: yatin47 folded before Flop (didn't bet)
Seat 4: hashstack (button) collected ($2880)
Seat 5: TurnOnTuneInDropOut (small blind) folded before Flop

PokerStars Hand #228844376: Omaha Pot Limit ($200/$400 USD) - 2020/10/23 16:45:27 ET
Table 'ADA409467368' 6-max Seat #5 is the button
Seat 1: Sam565 ($20150 in chips)
Seat 3: yatin47 ($50187 in chips)
Seat 4: hashstack ($24623 in chips)
Seat 5: TurnOnTuneInDropOut ($49656 in chips)
Sam565: posts small blind $200
yatin47: posts big blind $400
*** HOLE CARDS ***
Dealt to TurnOnTuneInDropOut [9h Ad Kc 4d]
hashstack: raises $400 to $800
TurnOnTuneInDropOut: raises $2200 to $3000
Sam565: folds
yatin47: folds
hashstack: calls $2200
*** FLOP *** [8s Jd 7d]
hashstack: checks
TurnOnTuneInDropOut: checks
*** TURN *** [8s Jd 7d] [6c]
hashstack: bets $5350
TurnOnTuneInDropOut: folds
Uncalled bet ($5350) returned to hashstack
hashstack collected $6335 from pot
hashstack: doesn't show hand
*** SUMMARY ***
Total pot $6600 | Rake $265
Board [8s Jd 7d 6c]
Seat 1: Sam565 (small blind) folded before Flop
Seat 3: yatin47 (big blind) folded before Flop
Seat 4: hashstack collected ($6335)
Seat 5: TurnOnTuneInDropOut (button) folded on the Turn

PokerStars Hand #228844377: Omaha Pot Limit ($200/$400 USD) - 2020/10/23 16:46:22 ET
Table 'ADA409467368' 6-max Seat #1 is the button
Seat 1: Sam565 ($19950 in chips)
Seat 3: yatin47 ($49787 in chips)
Seat 4: hashstack ($27958 in chips)
Seat 5: TurnOnTuneInDropOut ($46656 in chips)
Seat 6: craftplayer ($30000 in chips)
yatin47: posts small blind $200
hashstack: posts big blind $400
craftplayer: posts big blind $400
*** HOLE CARDS ***
Dealt to TurnOnTuneInDropOut [Td 5s Kd 2s]
TurnOnTuneInDropOut: folds
craftplayer: raises $400 to $800
Sam565: calls $800
yatin47: folds
hashstack: calls $400
*** FLOP *** [Ks Js 3h]
hashstack: checks
craftplayer: checks
Sam565: checks
*** TURN *** [Ks Js 3h] [Ad]
hashstack: checks
craftplayer: checks
Sam565: checks
*** RIVER *** [Ks Js 3h Ad] [Jc]
hashstack: checks
craftplayer: bets $1950
Sam565: folds
hashstack: folds
Uncalled bet ($1950) returned to craftplayer
craftplayer collected $2496 from pot
craftplayer: doesn't show hand
*** SUMMARY ***
Total pot $2600 | Rake $104
Board [Ks Js 3h Ad Jc]
Seat 1: Sam565 (button) folded on the River
Seat 3: yatin47 (small blind) folded before Flop
Seat 4: hashstack (big blind) folded on the River
Seat 5: TurnOnTuneInDropOut folded before Flop (didn't bet)
Seat 6: craftplayer collected ($2496)

PokerStars Hand #228844378: Omaha Pot Limit ($200/$400 USD) - 2020/10/23 16:48:11 ET
Table 'ADA409467368' 6-max Seat #3 is the button
Seat 1: Sam565 ($19150 in chips)
Seat 3: yatin47 ($49587 in chips)
Seat 4: hashstack ($27158 in chips)
Seat 5: TurnOnTuneInDropOut ($46656 in chips)
Seat 6: craftplayer ($31696 in chips)
hashstack: posts small blind $200
TurnOnTuneInDropOut: posts big blind $400
*** HOLE CARDS ***
Dealt to TurnOnTuneInDropOut [3h 8c 6c Kh]
craftplayer: raises $400 to $800
Sam565: calls $800
yatin47: calls $800
hashstack: folds
TurnOnTuneInDropOut: folds
*** FLOP *** [3d Qh 7d]
craftplayer: bets $1500
Sam565: folds
yatin47: folds
Uncalled bet ($1500) returned to craftplayer
craftplayer collected $2880 from pot
craftplayer: doesn't show hand
*** SUMMARY ***
Total pot $3000 | Rake $120
Board [3d Qh 7d]
Seat 1: Sam565 folded on the Flop
Seat 3: yatin47 (button) folded on the Flop
Seat 4: hashstack (small blind) folded before Flop
Seat 5: TurnOnTuneInDropOut (big blind) folded before Flop
Seat 6: craftplayer collected ($2880)

PokerStars Hand #228844380: Omaha Pot Limit ($200/$400 USD) - 2020/10/23 16:50:37 ET
Table 'ADA409467368' 6-max Seat #5 is the button
Seat 1: Sam565 ($18350 in chips)
Seat 4: hashstack ($26958 in chips)
Seat 5: TurnOnTuneInDropOut ($12000 in chips)
Seat 6: craftplayer ($27376 in chips)
craftplayer: posts small blind $200
Sam565: posts big blind $400
*** HOLE CARDS ***
Dealt to TurnOnTuneInDropOut [7s Tc Td Qd]
hashstack: raises $800 to $1200
TurnOnTuneInDropOut: folds
craftplayer: calls $1000
Sam565: calls $800
*** FLOP *** [Kh 5h Th]
craftplayer: checks
Sam565: checks
hashstack: bets $800
craftplayer: calls $800
Sam565: folds
*** TURN *** [Kh 5h Th] [2h]
craftplayer: checks
hashstack: checks
*** RIVER *** [Kh 5h Th 2h] [2s]
craftplayer: checks
hashstack: checks
*** SHOW DOWN ***
craftplayer: shows [6h 8h 9h As]
hashstack: mucks hand
craftplayer collected $4991 from pot
*** SUMMARY ***
Total pot $5200 | Rake $209
Board [Kh 5h Th 2h 2s]
Seat 1: Sam565 (big blind) folded on the Flop
Seat 4: hashstack mucked
Seat 5: TurnOnTuneInDropOut (button) folded before Flop (didn't bet)
Seat 6: craftplayer (small blind) showed [6h 8h 9h As] and won ($4991)

PokerStars Hand #228844381: Omaha Pot Limit ($200/$400 USD) - 2020/10/23 16:52:28 ET
Table 'ADA409467368' 6-max Seat #6 is the button
Seat 1: Sam565 ($17150 in chips)
Seat 2: kimjongun ($30000 in chips)
Seat 4: hashstack ($24958 in chips)
Seat 5: TurnOnTuneInDropOut ($48000 in chips)
Seat 6: craftplayer ($30367 in chips)
Sam565: posts small blind $200
kimjongun: posts big blind $400
*** HOLE CARDS ***
Dealt to TurnOnTuneInDropOut [8d Th Ks Qc]
hashstack: raises $668 to $1068
TurnOnTuneInDropOut: folds
craftplayer: calls $1068
Sam565: calls $868
kimjongun: folds
*** FLOP *** [3c 6d 5h]
Sam565: checks
hashstack: checks
craftplayer: checks
*** TURN *** [3c 6d 5h] [3s]
Sam565: checks
hashstack: checks
craftplayer: checks
*** RIVER *** [3c 6d 5h 3s] [8h]
Sam565: checks
hashstack: checks
craftplayer: bets $2703
Sam565: folds
hashstack: calls $2703
*** SHOW DOWN ***
hashstack: mucks hand
craftplayer: shows [Tc 5s 7h 9c]
craftplayer collected $8649 from pot
*** SUMMARY ***
Total pot $9010 | Rake $361
Board [3c 6d 5h 3s 8h]
Seat 1: Sam565 (small blind) folded on the River
Seat 2: kimjongun (big blind) folded before Flop
Seat 4: hashstack mucked
Seat 5: TurnOnTuneInDropOut folded before Flop (didn't bet)
Seat 6: craftplayer (button) showed [Tc 5s 7h 9c] and won ($8649)

PokerStars Hand #228844382: Omaha Pot Limit ($200/$400 USD) - 2020/10/23 16:54:03 ET
Table 'ADA409467368' 6-max Seat #1 is the button
Seat 1: Sam565 ($16082 in chips)
Seat 2: kimjongun ($29600 in chips)
Seat 4: hashstack ($21187 in chips)
Seat 5: TurnOnTuneInDropOut ($48000 in chips)
Seat 6: craftplayer ($35245 in chips)
kimjongun: posts small blind $200
hashstack: posts big blind $400
*** HOLE CARDS ***
Dealt to TurnOnTuneInDropOut [5h 4d 8c 3c]
TurnOnTuneInDropOut: folds
craftplayer: folds
Sam565: raises $1000 to $1400
kimjongun: folds
hashstack: folds
Uncalled bet ($1000) returned to Sam565
Sam565 collected $1000 from pot
Sam565: doesn't show hand
*** SUMMARY ***
Total pot $1000 | Rake $0
Seat 1: Sam565 (button) collected ($1000)
Seat 2: kimjongun (small blind) folded before Flop
Seat 4: hashstack (big blind) folded before Flop
Seat 5: TurnOnTuneInDropOut folded before Flop (didn't bet)
Seat 6: craftplayer folded before Flop (didn't bet)

PokerStars Hand #228844383: Omaha Pot Limit ($200/$400 USD) - 2020/10/23 16:54:22 ET
Table 'ADA409467368' 6-max Seat #2 is the button
Seat 1: Sam565 ($16682 in chips)
Seat 2: kimjongun ($29400 in chips)
Seat 4: hashstack ($20787 in chips)
Seat 5: TurnOnTuneInDropOut ($48000 in chips)
Seat 6: craftplayer ($35245 in chips)
hashstack: posts small blind $200
TurnOnTuneInDropOut: posts big blind $400
*** HOLE CARDS ***
Dealt to TurnOnTuneInDropOut [Ac Ad 3s Kd]
craftplayer: raises $1000 to $1400
Sam565: folds
kimjongun: folds
hashstack: calls $1200
TurnOnTuneInDropOut: raises $4200 to $5600
craftplayer: calls $4200
hashstack: folds
*** FLOP *** [2d 2h Js]
TurnOnTuneInDropOut: bets $4158
craftplayer: calls $4158
*** TURN *** [2d 2h Js] [Td]
TurnOnTuneInDropOut: checks
craftplayer: checks
*** RIVER *** [2d 2h Js Td] [4d]
TurnOnTuneInDropOut: bets $15887
craftplayer: folds
Uncalled bet ($15887) returned to TurnOnTuneInDropOut
TurnOnTuneInDropOut collected $20116 from pot
TurnOnTuneInDropOut: doesn't show hand
*** SUMMARY ***
Total pot $20916 | Rake $800
Board [2d 2h Js Td 4d]
Seat 1: Sam565 folded before Flop (didn't bet)
Seat 2: kimjongun (button) folded before Flop (didn't bet)
Seat 4: hashstack (small blind) folded before Flop
Seat 5: TurnOnTuneInDropOut (big blind) collected ($20116)
Seat 6: craftplayer folded on the River

PokerStars Hand #228844384: Omaha Pot Limit ($200/$400 USD) - 2020/10/23 16:55:54 ET
Table 'ADA409467368' 6-max Seat #4 is the button
Seat 1: Sam565 ($16682 in chips)
Seat 2: kimjongun ($29400 in chips)
Seat 4: hashstack ($19387 in chips)
Seat 5: TurnOnTuneInDropOut ($58358 in chips)
Seat 6: craftplayer ($25487 in chips)
TurnOnTuneInDropOut: posts small blind $200
craftplayer: posts big blind $400
*** HOLE CARDS ***
Dealt to TurnOnTuneInDropOut [Ah 7h 6h 4s]
Sam565: folds
kimjongun: raises $1000 to $1400
hashstack: folds
TurnOnTuneInDropOut: folds
craftplayer: calls $1000
*** FLOP *** [8h 7d 2c]
craftplayer: checks
kimjongun: checks
*** TURN *** [8h 7d 2c] [6s]
craftplayer: checks
kimjongun: checks
*** RIVER *** [8h 7d 2c 6s] [Kd]
craftplayer: checks
kimjongun: bets $2250
craftplayer: folds
Uncalled bet ($2250) returned to kimjongun
kimjongun collected $2880 from pot
kimjongun: doesn't show hand
*** SUMMARY ***
Total pot $3000 | Rake $120
Board [8h 7d 2c 6s Kd]
Seat 1: Sam565 folded before Flop (didn't bet)
Seat 2: kimjongun collected ($2880)
Seat 4: hashstack (button) folded before Flop (didn't bet)
Seat 5: TurnOnTuneInDropOut (small blind) folded before Flop
Seat 6: craftplayer (big blind) folded on the River

PokerStars Hand #228844385: Omaha Pot Limit ($200/$400 USD) - 2020/10/23 16:56:52 ET
Table 'ADA409467368' 6-max Seat #5 is the button
Seat 1: Sam565 ($16682 in chips)
Seat 2: kimjongun ($30880 in chips)
Seat 4: hashstack ($19387 in chips)
Seat 5: TurnOnTuneInDropOut ($58158 in chips)
Seat 6: craftplayer ($24087 in chips)
craftplayer: posts small blind $200
Sam565: posts big blind $400
*** HOLE CARDS ***
Dealt to TurnOnTuneInDropOut [4h 3c Td Kh]
kimjongun: folds
hashstack: folds
TurnOnTuneInDropOut: folds
craftplayer: raises $800 to $1200
Sam565: calls $800
*** FLOP *** [9c Qh 7h]
craftplayer: bets $1800
Sam565: folds
Uncalled bet ($1800) returned to craftplayer
craftplayer collected $2304 from pot
craftplayer: doesn't show hand
*** SUMMARY ***
Total pot $2400 | Rake $96
Board [9c Qh 7h]
Seat 1: Sam565 (big blind) folded on the Flop
Seat 2: kimjongun folded before Flop (didn't bet)
Seat 4: hashstack folded before Flop (didn't bet)
Seat 5: TurnOnTuneInDropOut (button) folded before Flop (didn't bet)
Seat 6: craftplayer (small blind) collected ($2304)

PokerStars Hand #228844386: Omaha Pot Limit ($200/$400 USD) - 2020/10/23 16:57:45 ET
Table 'ADA409467368' 6-max Seat #6 is the button
Seat 1: Sam565 ($15482 in chips)
Seat 2: kimjongun ($30880 in chips)
Seat 4: hashstack ($19387 in chips)
Seat 5: TurnOnTuneInDropOut ($58158 in chips)
Seat 6: craftplayer ($25191 in chips)
Sam565: posts small blind $200
kimjongun: posts big blind $400
*** HOLE CARDS ***
Dealt to TurnOnTuneInDropOut [3d Th Jc 7h]
hashstack: folds
TurnOnTuneInDropOut: folds
craftplayer: raises $1000 to $1400
Sam565: folds
kimjongun: folds
Uncalled bet ($1000) returned to craftplayer
craftplayer collected $1000 from pot
craftplayer: doesn't show hand
*** SUMMARY ***
Total pot $1000 | Rake $0
Seat 1: Sam565 (small blind) folded before Flop
Seat 2: kimjongun (big blind) folded before Flop
Seat 4: hashstack folded before Flop (didn't bet)
Seat 5: TurnOnTuneInDropOut folded before Flop (didn't bet)
Seat 6: craftplayer (button) collected ($1000)

PokerStars Hand #228844387: Omaha Pot Limit ($200/$400 USD) - 2020/10/23 16:58:07 ET
Table 'ADA409467368' 6-max Seat #1 is the button
Seat 1: Sam565 ($15282 in chips)
Seat 2: kimjongun ($30480 in chips)
Seat 4: hashstack ($19387 in chips)
Seat 5: TurnOnTuneInDropOut ($58158 in chips)
Seat 6: craftplayer ($25791 in chips)
kimjongun: posts small blind $200
hashstack: posts big blind $400
*** HOLE CARDS ***
Dealt to TurnOnTuneInDropOut [5c 7h 9d 6s]
TurnOnTuneInDropOut: folds
craftplayer: raises $400 to $800
Sam565: calls $800
kimjongun: raises $2800 to $3600
hashstack: folds
craftplayer: calls $2800
Sam565: calls $2800
*** FLOP *** [6h 5s Qd]
kimjongun: checks
craftplayer: checks
Sam565: bets $11200
kimjongun: folds
craftplayer: folds
Uncalled bet ($11200) returned to Sam565
Sam565 collected $10751 from pot
Sam565: doesn't show hand
*** SUMMARY ***
Total pot $11200 | Rake $449
Board [6h 5s Qd]
Seat 1: Sam565 (button) collected ($10751)
Seat 2: kimjongun (small blind) folded on the Flop
Seat 4: hashstack (big blind) folded before Flop
Seat 5: TurnOnTuneInDropOut folded before Flop (didn't bet)
Seat 6: craftplayer folded on the Flop

PokerStars Hand #228844388: Omaha Pot Limit ($200/$400 USD) - 2020/10/23 16:59:52 ET
Table 'ADA409467368' 6-max Seat #2 is the button
Seat 1: Sam565 ($22433 in chips)
Seat 2: kimjongun ($26880 in chips)
Seat 4: hashstack ($18987 in chips)
Seat 5: TurnOnTuneInDropOut ($58158 in chips)
Seat 6: craftplayer ($22191 in chips)
hashstack: posts small blind $200
TurnOnTuneInDropOut: posts big blind $400
*** HOLE CARDS ***
Dealt to TurnOnTuneInDropOut [8d Ad 3h 7c]
craftplayer: raises $400 to $800
Sam565: raises $2200 to $3000
kimjongun: folds
hashstack: folds
TurnOnTuneInDropOut: folds
craftplayer: calls $2200
*** FLOP *** [Ac 4c 6h]
craftplayer: checks
Sam565: bets $6600
craftplayer: folds
Uncalled bet ($6600) returned to Sam565
Sam565 collected $6335 from pot
Sam565: doesn't show hand
*** SUMMARY ***
Total pot $6600 | Rake $265
Board [Ac 4c 6h]
Seat 1: Sam565 collected ($6335)
Seat 2: kimjongun (button) folded before Flop (didn't bet)
Seat 4: hashstack (small blind) folded before Flop
Seat 5: TurnOnTuneInDropOut (big blind) folded before Flop
Seat 6: craftplayer folded on the Flop

PokerStars Hand #228844390: Omaha Pot Limit ($200/$400 USD) - 2020/10/23 17:03:34 ET
Table 'ADA409467368' 6-max Seat #5 is the button
Seat 1: Sam565 ($28617 in chips)
Seat 2: kimjongun ($26880 in chips)
Seat 4: hashstack ($16837 in chips)
Seat 5: TurnOnTuneInDropOut ($57558 in chips)
Sam565: posts small blind $200
kimjongun: posts big blind $400
*** HOLE CARDS ***
Dealt to TurnOnTuneInDropOut [3d Qd 5h Qh]
hashstack: folds
TurnOnTuneInDropOut: raises $1000 to $1400
Sam565: folds
kimjongun: folds
Uncalled bet ($1000) returned to TurnOnTuneInDropOut
TurnOnTuneInDropOut collected $1000 from pot
TurnOnTuneInDropOut: doesn't show hand
*** SUMMARY ***
Total pot $1000 | Rake $0
Seat 1: Sam565 (small blind) folded before Flop
Seat 2: kimjongun (big blind) folded before Flop
Seat 4: hashstack folded before Flop (didn't bet)
Seat 5: TurnOnTuneInDropOut (button) collected ($1000)

PokerStars Hand #228844391: Omaha Pot Limit ($200/$400 USD) - 2020/10/23 17:03:53 ET
Table 'ADA409467368' 6-max Seat #1 is the button
Seat 1: Sam565 ($28417 in chips)
Seat 2: kimjongun ($26480 in chips)
Seat 4: hashstack ($16837 in chips)
Seat 5: TurnOnTuneInDropOut ($58158 in chips)
kimjongun: posts small blind $200
hashstack: posts big blind $400
*** HOLE CARDS ***
Dealt to TurnOnTuneInDropOut [Ah 4s 4c Kh]
TurnOnTuneInDropOut: folds
Sam565: folds
kimjongun: raises $800 to $1200
hashstack: calls $800
*** FLOP *** [3h 3c 7h]
kimjongun: checks
hashstack: bets $1800
kimjongun: calls $1800
*** TURN *** [3h 3c 7h] [2c]
kimjongun: bets $3000
hashstack: raises $10837 to $13837 and is all-in
kimjongun: calls $10837
*** RIVER *** [3h 3c 7h 2c] [8h]
*** SHOW DOWN ***
kimjongun: shows [Tc Jh Ac 5h]
hashstack: shows [6c 9s 3s 6h]
kimjongun collected $32874 from pot
*** SUMMARY ***
Total pot $33674 | Rake $800
Board [3h 3c 7h 2c 8h]
Seat 1: Sam565 (button) folded before Flop (didn't bet)
Seat 2: kimjongun (small blind) showed [Tc Jh Ac 5h] and won ($32874)
Seat 4: hashstack (big blind) showed [6c 9s 3s 6h] and lost
Seat 5: TurnOnTuneInDropOut folded before Flop (didn't bet)

PokerStars Hand #228844392: Omaha Pot Limit ($200/$400 USD) - 2020/10/23 17:04:34 ET
Table 'ADA409467368' 6-max Seat #2 is the button
Seat 1: Sam565 ($28417 in chips)
Seat 2: kimjongun ($42517 in chips)
Seat 5: TurnOnTuneInDropOut ($58158 in chips)
TurnOnTuneInDropOut: posts small blind $200
Sam565: posts big blind $400
*** HOLE CARDS ***
Dealt to TurnOnTuneInDropOut [Ks Ad Kc Ah]
kimjongun: raises $1000 to $1400
TurnOnTuneInDropOut: raises $3200 to $4600
Sam565: folds
kimjongun: folds
Uncalled bet ($3200) returned to TurnOnTuneInDropOut
TurnOnTuneInDropOut collected $3200 from pot
TurnOnTuneInDropOut: doesn't show hand
*** SUMMARY ***
Total pot $3200 | Rake $0
Seat 1: Sam565 (big blind) folded before Flop
Seat 2: kimjongun (button) folded before Flop
Seat 5: TurnOnTuneInDropOut (small blind) collected ($3200)

PokerStars Hand #1054739449: Omaha Pot Limit ($500/$1000 USD) - 2020/10/23 12:15:02 ET
Table 'ADA540885739' 6-max Seat #1 is the button
Seat 1: TurnOnTuneInDropOut ($81639 in chips)
Seat 2: vaibz16 ($31774 in chips)
Seat 3: slotmachine ($75000 in chips)
Seat 4: ag2703 ($71500 in chips)
Seat 5: bothras ($45910 in chips)
vaibz16: posts small blind $500
slotmachine: posts big blind $1000
*** HOLE CARDS ***
Dealt to TurnOnTuneInDropOut [3d 5c Td 2h]
ag2703: raises $1797 to $2797
bothras: folds
TurnOnTuneInDropOut: folds
vaibz16: folds
slotmachine: folds
Uncalled bet ($1797) returned to ag2703
ag2703 collected $2500 from pot
ag2703: doesn't show hand
*** SUMMARY ***
Total pot $2500 | Rake $0
Seat 1: TurnOnTuneInDropOut (button) folded before Flop (didn't bet)
Seat 2: vaibz16 (small blind) folded before Flop
Seat 3: slotmachine (big blind) folded before Flop
Seat 4: ag2703 collected ($2500)
Seat 5: bothras folded before Flop (didn't bet)

PokerStars Hand #1054739450: Omaha Pot Limit ($500/$1000 USD) - 2020/10/23 12:15:35 ET
Table 'ADA540885739' 6-max Seat #2 is the button
Seat 1: TurnOnTuneInDropOut ($81639 in chips)
Seat 2: vaibz16 ($31274 in chips)
Seat 3: slotmachine ($74000 in chips)
Seat 4: ag2703 ($73000 in chips)
Seat 5: bothras ($45910 in chips)
slotmachine: posts small blind $500
ag2703: posts big blind $1000
*** HOLE CARDS ***
Dealt to TurnOnTuneInDropOut [Ah 5s 7d 9h]
bothras: raises $2500 to $3500
TurnOnTuneInDropOut: folds
vaibz16: folds
slotmachine: folds
ag2703: calls $2500
*** FLOP *** [3c Ts 8d]
ag2703: checks
bothras: checks
*** TURN *** [3c Ts 8d] [Kh]
ag2703: bets $3750
bothras: raises $15000 to $18750
ag2703: folds
Uncalled bet ($15000) returned to bothras
bothras collected $14548 from pot
bothras: doesn't show hand
*** SUMMARY ***
Total pot $15000 | Rake $452
Board [3c Ts 8d Kh]
Seat 1: TurnOnTuneInDropOut folded before Flop (didn't bet)
Seat 2: vaibz16 (button) folded before Flop (didn't bet)
Seat 3: slotmachine (small blind) folded before Flop
Seat 4: ag2703 (big blind) folded on the Turn
Seat 5: bothras collected ($14548)

PokerStars Hand #1054739451: Omaha Pot Limit ($500/$1000 USD) - 2020/10/23 12:16:18 ET
Table 'ADA540885739' 6-max Seat #3 is the button
Seat 1: TurnOnTuneInDropOut ($81639 in chips)
Seat 2: vaibz16 ($31274 in chips)
Seat 3: slotmachine ($73500 in chips)
Seat 4: ag2703 ($65750 in chips)
Seat 5: bothras ($53208 in chips)
ag2703: posts small blind $500
bothras: posts big blind $1000
*** HOLE CARDS ***
Dealt to TurnOnTuneInDropOut [Kd 5d Jh Ac]
TurnOnTuneInDropOut: raises $2500 to $3500
vaibz16: folds
slotmachine: folds
ag2703: calls $3000
bothras: folds
*** FLOP *** [Qd Qs 6s]
ag2703: checks
TurnOnTuneInDropOut: bets $2640
ag2703: folds
Uncalled bet ($2640) returned to TurnOnTuneInDropOut
TurnOnTuneInDropOut collected $7759 from pot
TurnOnTuneInDropOut: doesn't show hand
*** SUMMARY ***
Total pot $8000 | Rake $241
Board [Qd Qs 6s]
Seat 1: TurnOnTuneInDropOut collected ($7759)
Seat 2: vaibz16 folded before Flop (didn't bet)
Seat 3: slotmachine (button) folded before Flop (didn't bet)
Seat 4: ag2703 (small blind) folded on the Flop
Seat 5: bothras (big blind) folded before Flop

PokerStars Hand #1054739452: Omaha Pot Limit ($500/$1000 USD) - 2020/10/23 12:17:19 ET
Table 'ADA540885739' 6-max Seat #4 is the button
Seat 1: TurnOnTuneInDropOut ($85898 in chips)
Seat 2: vaibz16 ($31274 in chips)
Seat 3: slotmachine ($73500 in chips)
Seat 4: ag2703 ($62250 in chips)
Seat 5: bothras ($52208 in chips)
bothras: posts small blind $500
TurnOnTuneInDropOut: posts big blind $1000
*** HOLE CARDS ***
Dealt to TurnOnTuneInDropOut [6c 2h 8h 6h]
vaibz16: folds
slotmachine: folds
ag2703: folds
bothras: raises $2000 to $3000
TurnOnTuneInDropOut: folds
Uncalled bet ($2000) returned to bothras
bothras collected $2000 from pot
bothras: doesn't show hand
*** SUMMARY ***
Total pot $2000 | Rake $0
Seat 1: TurnOnTuneInDropOut (big blind) folded before Flop
Seat 2: vaibz16 folded before Flop (didn't bet)
Seat 3: slotmachine folded before Flop (didn't bet)
Seat 4: ag2703 (button) folded before Flop (didn't bet)
Seat 5: bothras (small blind) collected ($2000)

PokerStars Hand #1054739453: Omaha Pot Limit ($500/$1000 USD) - 2020/10/23 12:17:39 ET
Table 'ADA540885739' 6-max Seat #5 is the button
Seat 1: TurnOnTuneInDropOut ($84898 in chips)
Seat 2: vaibz16 ($31274 in chips)
Seat 3: slotmachine ($73500 in chips)
Seat 4: ag2703 ($62250 in chips)
Seat 5: bothras ($53208 in chips)
TurnOnTuneInDropOut: posts small blind $500
vaibz16: posts big blind $1000
*** HOLE CARDS ***
Dealt to TurnOnTuneInDropOut [Ad 3h Qc Td]
slotmachine: folds
ag2703: folds
bothras: folds
TurnOnTuneInDropOut: raises $2000 to $3000
vaibz16: folds
Uncalled bet ($2000) returned to TurnOnTuneInDropOut
TurnOnTuneInDropOut collected $2000 from pot
TurnOnTuneInDropOut: doesn't show hand
*** SUMMARY ***
Total pot $2000 | Rake $0
Seat 1: TurnOnTuneInDropOut (small blind) collected ($2000)
Seat 2: vaibz16 (big blind) folded before Flop
Seat 3: slotmachine folded before Flop (didn't bet)
Seat 4: ag2703 folded before Flop (didn't bet)
Seat 5: bothras (button) folded before Flop (didn't bet)

PokerStars Hand #1054739454: Omaha Pot Limit ($500/$1000 USD) - 2020/10/23 12:18:03 ET
Table 'ADA540885739' 6-max Seat #1 is the button
Seat 1: TurnOnTuneInDropOut ($85898 in chips)
Seat 2: vaibz16 ($30274 in chips)
Seat 3: slotmachine ($73500 in chips)
Seat 4: ag2703 ($62250 in chips)
Seat 5: bothras ($53208 in chips)
vaibz16: posts small blind $500
slotmachine: posts big blind $1000
*** HOLE CARDS ***
Dealt to TurnOnTuneInDropOut [Js 5s Ks 6s]
ag2703: folds
bothras: folds
TurnOnTuneInDropOut: folds
vaibz16: folds
Uncalled bet ($500) returned to slotmachine
slotmachine collected $1000 from pot
slotmachine: doesn't show hand
*** SUMMARY ***
Total pot $1000 | Rake $0
Seat 1: TurnOnTuneInDropOut (button) folded before Flop (didn't bet)
Seat 2: vaibz16 (small blind) folded before Flop
Seat 3: slotmachine (big blind) collected ($1000)
Seat 4: ag2703 folded before Flop (didn't bet)
Seat 5: bothras folded before Flop (didn't bet)

PokerStars Hand #1054739455: Omaha Pot Limit ($500/$1000 USD) - 2020/10/23 12:18:26 ET
Table 'ADA540885739' 6-max Seat #2 is the button
Seat 1: TurnOnTuneInDropOut ($85898 in chips)
Seat 2: vaibz16 ($29774 in chips)
Seat 3: slotmachine ($74000 in chips)
Seat 4: ag2703 ($62250 in chips)
Seat 5: bothras ($53208 in chips)
slotmachine: posts small blind $500
ag2703: posts big blind $1000
*** HOLE CARDS ***
Dealt to TurnOnTuneInDropOut [8d 2d Th Qd]
bothras: folds
TurnOnTuneInDropOut: folds
vaibz16: raises $2500 to $3500
slotmachine: folds
ag2703: calls $2500
*** FLOP *** [6d 3s Ah]
ag2703: checks
vaibz16: bets $3750
ag2703: raises $15000 to $18750
vaibz16: folds
Uncalled bet ($15000) returned to ag2703
ag2703 collected $14548 from pot
ag2703: doesn't show hand
*** SUMMARY ***
Total pot $15000 | Rake $452
Board [6d 3s Ah]
Seat 1: TurnOnTuneInDropOut folded before Flop (didn't bet)
Seat 2: vaibz16 (button) folded on the Flop
Seat 3: slotmachine (small blind) folded before Flop
Seat 4: ag2703 (big blind) collected ($14548)
Seat 5: bothras folded before Flop (didn't bet)

PokerStars Hand #1054739456: Omaha Pot Limit ($500/$1000 USD) - 2020/10/23 12:19:12 ET
Table 'ADA540885739' 6-max Seat #3 is the button
Seat 1: TurnOnTuneInDropOut ($85898 in chips)
Seat 2: vaibz16 ($22524 in chips)
Seat 3: slotmachine ($73500 in chips)
Seat 4: ag2703 ($69548 in chips)
Seat 5: bothras ($53208 in chips)
ag2703: posts small blind $500
bothras: posts big blind $1000
*** HOLE CARDS ***
Dealt to TurnOnTuneInDropOut [Qd 3c 4h 2d]
TurnOnTuneInDropOut: folds
vaibz16: raises $2500 to $3500
slotmachine: folds
ag2703: folds
bothras: folds
Uncalled bet ($2500) returned to vaibz16
vaibz16 collected $2500 from pot
vaibz16: doesn't show hand
*** SUMMARY ***
Total pot $2500 | Rake $0
Seat 1: TurnOnTuneInDropOut folded before Flop (didn't bet)
Seat 2: vaibz16 collected ($2500)
Seat 3: slotmachine (button) folded before Flop (didn't bet)
Seat 4: ag2703 (small blind) folded before Flop
Seat 5: bothras (big blind) folded before Flop

PokerStars Hand #1054739462: Omaha Pot Limit ($500/$1000 USD) - 2020/10/23 12:24:06 ET
Table 'ADA540885739' 6-max Seat #4 is the button
Seat 1: TurnOnTuneInDropOut ($72898 in chips)
Seat 2: vaibz16 ($24949 in chips)
Seat 3: slotmachine ($86703 in chips)
Seat 4: ag2703 ($66973 in chips)
Seat 5: bothras ($53133 in chips)
Seat 6: nicholas93 ($36544 in chips)
bothras: posts small blind $500
nicholas93: posts big blind $1000
*** HOLE CARDS ***
Dealt to TurnOnTuneInDropOut [As 3d Jh Th]
TurnOnTuneInDropOut: folds
vaibz16: calls $1000
slotmachine: calls $1000
ag2703: calls $1000
bothras: folds
nicholas93: checks
*** FLOP *** [9d Kh 2c]
nicholas93: checks
vaibz16: checks
slotmachine: checks
ag2703: checks
*** TURN *** [9d Kh 2c] [8c]
nicholas93: checks
vaibz16: bets $3375
slotmachine: calls $3375
ag2703: folds
nicholas93: folds
*** RIVER *** [9d Kh 2c 8c] [7s]
vaibz16: bets $8438
slotmachine: calls $8438
*** SHOW DOWN ***
vaibz16: shows [8s Qc 6c Ts]
slotmachine: mucks hand
vaibz16 collected $27279 from pot
*** SUMMARY ***
Total pot $28126 | Rake $847
Board [9d Kh 2c 8c 7s]
Seat 1: TurnOnTuneInDropOut folded before Flop (didn't bet)
Seat 2: vaibz16 showed [8s Qc 6c Ts] and won ($27279)
Seat 3: slotmachine mucked
Seat 4: ag2703 (button) folded on the Turn
Seat 5: bothras (small blind) folded before Flop
Seat 6: nicholas93 (big blind) folded on the Turn

PokerStars Hand #1054739472: Omaha Pot Limit ($500/$1000 USD) - 2020/10/23 12:33:35 ET
Table 'ADA540885739' 6-max Seat #5 is the button
Seat 1: TurnOnTuneInDropOut ($71898 in chips)
Seat 3: slotmachine ($73390 in chips)
Seat 4: ag2703 ($63473 in chips)
Seat 5: bothras ($40268 in chips)
TurnOnTuneInDropOut: posts small blind $500
slotmachine: posts big blind $1000
*** HOLE CARDS ***
Dealt to TurnOnTuneInDropOut [7h Jd Kh 7s]
ag2703: folds
bothras: folds
TurnOnTuneInDropOut: raises $2000 to $3000
slotmachine: folds
Uncalled bet ($2000) returned to TurnOnTuneInDropOut
TurnOnTuneInDropOut collected $2000 from pot
TurnOnTuneInDropOut: doesn't show hand
*** SUMMARY ***
Total pot $2000 | Rake $0
Seat 1: TurnOnTuneInDropOut (small blind) collected ($2000)
Seat 3: slotmachine (big blind) folded before Flop
Seat 4: ag2703 folded before Flop (didn't bet)
Seat 5: bothras (button) folded before Flop (didn't bet)

PokerStars Hand #1054739473: Omaha Pot Limit ($500/$1000 USD) - 2020/10/23 12:34:06 ET
Table 'ADA540885739' 6-max Seat #1 is the button
Seat 1: TurnOnTuneInDropOut ($72898 in chips)
Seat 3: slotmachine ($72390 in chips)
Seat 4: ag2703 ($63473 in chips)
Seat 5: bothras ($40268 in chips)
slotmachine: posts small blind $500
ag2703: posts big blind $1000
*** HOLE CARDS ***
Dealt to TurnOnTuneInDropOut [6s 2h 4h 2d]
bothras: folds
TurnOnTuneInDropOut: folds
slotmachine: folds
Uncalled bet ($500) returned to ag2703
ag2703 collected $1000 from pot
ag2703: doesn't show hand
*** SUMMARY ***
Total pot $1000 | Rake $0
Seat 1: TurnOnTuneInDropOut (button) folded before Flop (didn't bet)
Seat 3: slotmachine (small blind) folded before Flop
Seat 4: ag2703 (big blind) collected ($1000)
Seat 5: bothras folded before Flop (didn't bet)

PokerStars Hand #1054739474: Omaha Pot Limit ($500/$1000 USD) - 2020/10/23 12:34:35 ET
Table 'ADA540885739' 6-max Seat #3 is the button
Seat 1: TurnOnTuneInDropOut ($72898 in chips)
Seat 3: slotmachine ($71890 in chips)
Seat 4: ag2703 ($63973 in chips)
Seat 5: bothras ($40268 in chips)
Seat 6: Prateek1986 ($49581 in chips)
ag2703: posts small blind $500
bothras: posts big blind $1000
Prateek1986: posts big blind $1000
*** HOLE CARDS ***
Dealt to TurnOnTuneInDropOut [6d 2h Qs 8d]
Prateek1986: raises $2500 to $3500
TurnOnTuneInDropOut: folds
slotmachine: folds
ag2703: folds
bothras: calls $2500
*** FLOP *** [9h Tc 9d]
bothras: checks
Prateek1986: checks
*** TURN *** [9h Tc 9d] [Qh]
bothras: bets $5625
Prateek1986: calls $5625
*** RIVER *** [9h Tc 9d Qh] [3d]
bothras: bets $12063
Prateek1986: folds
Uncalled bet ($12063) returned to bothras
bothras collected $18186 from pot
bothras: doesn't show hand
*** SUMMARY ***
Total pot $18750 | Rake $564
Board [9h Tc 9d Qh 3d]
Seat 1: TurnOnTuneInDropOut folded before Flop (didn't bet)
Seat 3: slotmachine (button) folded before Flop (didn't bet)
Seat 4: ag2703 (small blind) folded before Flop
Seat 5: bothras (big blind) collected ($18186)
Seat 6: Prateek1986 folded on the River

PokerStars Hand #1054739475: Omaha Pot Limit ($500/$1000 USD) - 2020/10/23 12:35:23 ET
Table 'ADA540885739' 6-max Seat #4 is the button
Seat 1: TurnOnTuneInDropOut ($72898 in chips)
Seat 3: slotmachine ($71890 in chips)
Seat 4: ag2703 ($63473 in chips)
Seat 5: bothras ($49329 in chips)
Seat 6: Prateek1986 ($40456 in chips)
bothras: posts small blind $500
Prateek1986: posts big blind $1000
*** HOLE CARDS ***
Dealt to TurnOnTuneInDropOut [Kc 8d 3d Kh]
TurnOnTuneInDropOut: folds
slotmachine: folds
ag2703: folds
bothras: folds
Uncalled bet ($500) returned to Prateek1986
Prateek1986 collected $1000 from pot
Prateek1986: doesn't show hand
*** SUMMARY ***
Total pot $1000 | Rake $0
Seat 1: TurnOnTuneInDropOut folded before Flop (didn't bet)
Seat 3: slotmachine folded before Flop (didn't bet)
Seat 4: ag2703 (button) folded before Flop (didn't bet)
Seat 5: bothras (small blind) folded before Flop
Seat 6: Prateek1986 (big blind) collected ($1000)

PokerStars Hand #1054739476: Omaha Pot Limit ($500/$1000 USD) - 2020/10/23 12:35:42 ET
Table 'ADA540885739' 6-max Seat #5 is the button
Seat 1: TurnOnTuneInDropOut ($72898 in chips)
Seat 3: slotmachine ($71890 in chips)
Seat 4: ag2703 ($63473 in chips)
Seat 5: bothras ($48829 in chips)
Seat 6: Prateek1986 ($40956 in chips)
Prateek1986: posts small blind $500
TurnOnTuneInDropOut: posts big blind $1000
*** HOLE CARDS ***
Dealt to TurnOnTuneInDropOut [9s Qs Kd 8d]
slotmachine: folds
ag2703: folds
bothras: folds
Prateek1986: folds
Uncalled bet ($500) returned to TurnOnTuneInDropOut
TurnOnTuneInDropOut collected $1000 from pot
TurnOnTuneInDropOut: doesn't show hand
*** SUMMARY ***
Total pot $1000 | Rake $0
Seat 1: TurnOnTuneInDropOut (big blind) collected ($1000)
Seat 3: slotmachine folded before Flop (didn't bet)
Seat 4: ag2703 folded before Flop (didn't bet)
Seat 5: bothras (button) folded before Flop (didn't bet)
Seat 6: Prateek1986 (small blind) folded before Flop

PokerStars Hand #1054739479: Omaha Pot Limit ($500/$1000 USD) - 2020/10/23 12:39:04 ET
Table 'ADA540885739' 6-max Seat #3 is the button
Seat 1: TurnOnTuneInDropOut ($72898 in chips)
Seat 3: slotmachine ($120000 in chips)
Seat 4: ag2703 ($47473 in chips)
Seat 5: bothras ($48829 in chips)
Seat 6: Prateek1986 ($83234 in chips)
ag2703: posts small blind $500
bothras: posts big blind $1000
*** HOLE CARDS ***
Dealt to TurnOnTuneInDropOut [3h 3c 7d 5c]
Prateek1986: folds
TurnOnTuneInDropOut: folds
slotmachine: folds
ag2703: calls $500
bothras: checks
*** FLOP *** [Tc Qd Td]
ag2703: checks
bothras: bets $1000
ag2703: folds
Uncalled bet ($1000) returned to bothras
bothras collected $1940 from pot
bothras: doesn't show hand
*** SUMMARY ***
Total pot $2000 | Rake $60
Board [Tc Qd Td]
Seat 1: TurnOnTuneInDropOut folded before Flop (didn't bet)
Seat 3: slotmachine (button) folded before Flop (didn't bet)
Seat 4: ag2703 (small blind) folded on the Flop
Seat 5: bothras (big blind) collected ($1940)
Seat 6: Prateek1986 folded before Flop (didn't bet)

PokerStars Hand #1957459583: Omaha Pot Limit ($500/$1000 USD) - 2020/10/23 13:27:18 ET
Table 'ADA540885739' 6-max Seat #4 is the button
Seat 1: vaibz16 ($149489 in chips)
Seat 2: vishnu2788 ($31579 in chips)
Seat 3: slotmachine ($140693 in chips)
Seat 4: TurnOnTuneInDropOut ($78774 in chips)
Seat 5: gaganhyd ($39129 in chips)
gaganhyd: posts small blind $500
vaibz16: posts big blind $1000
*** HOLE CARDS ***
Dealt to TurnOnTuneInDropOut [Tc 3d 5h Ad]
vishnu2788: folds
slotmachine: folds
TurnOnTuneInDropOut: raises $2500 to $3500
gaganhyd: calls $3000
vaibz16: folds
*** FLOP *** [Th 7d 3s]
gaganhyd: bets $8000
TurnOnTuneInDropOut: raises $24000 to $32000
gaganhyd: raises $3629 to $35629 and is all-in
TurnOnTuneInDropOut: calls $3629
*** TURN *** [Th 7d 3s] [2s]
*** RIVER *** [Th 7d 3s 2s] [9h]
*** SHOW DOWN ***
gaganhyd: shows [Qh 8d 9d Jd]
TurnOnTuneInDropOut: shows [Tc 3d 5h Ad]
gaganhyd collected $77859 from pot
*** SUMMARY ***
Total pot $79258 | Rake $1399
Board [Th 7d 3s 2s 9h]
Seat 1: vaibz16 (big blind) folded before Flop
Seat 2: vishnu2788 folded before Flop (didn't bet)
Seat 3: slotmachine folded before Flop (didn't bet)
Seat 4: TurnOnTuneInDropOut (button) showed [Tc 3d 5h Ad] and lost
Seat 5: gaganhyd (small blind) showed [Qh 8d 9d Jd] and won ($77859)

PokerStars Hand #1957459584: Omaha Pot Limit ($500/$1000 USD) - 2020/10/23 13:27:55 ET
Table 'ADA540885739' 6-max Seat #5 is the button
Seat 2: vishnu2788 ($31579 in chips)
Seat 3: slotmachine ($140693 in chips)
Seat 4: TurnOnTuneInDropOut ($39645 in chips)
Seat 5: gaganhyd ($77859 in chips)
vishnu2788: posts small blind $500
slotmachine: posts big blind $1000
*** HOLE CARDS ***
Dealt to TurnOnTuneInDropOut [6c Jc 9h Kd]
TurnOnTuneInDropOut: folds
gaganhyd: folds
vishnu2788: raises $2000 to $3000
slotmachine: calls $2000
*** FLOP *** [6s 7s 7h]
vishnu2788: checks
slotmachine: checks
*** TURN *** [6s 7s 7h] [Qc]
vishnu2788: bets $6000
slotmachine: folds
Uncalled bet ($6000) returned to vishnu2788
vishnu2788 collected $5819 from pot
vishnu2788: doesn't show hand
*** SUMMARY ***
Total pot $6000 | Rake $181
Board [6s 7s 7h Qc]
Seat 2: vishnu2788 (small blind) collected ($5819)
Seat 3: slotmachine (big blind) folded on the Turn
Seat 4: TurnOnTuneInDropOut folded before Flop (didn't bet)
Seat 5: gaganhyd (button) folded before Flop (didn't bet)

PokerStars Hand #1957459589: Omaha Pot Limit ($500/$1000 USD) - 2020/10/23 13:32:04 ET
Table 'ADA540885739' 6-max Seat #2 is the button
Seat 2: vishnu2788 ($29438 in chips)
Seat 3: slotmachine ($136193 in chips)
Seat 4: TurnOnTuneInDropOut ($78793 in chips)
Seat 5: gaganhyd ($76359 in chips)
Seat 6: Shr181 ($57134 in chips)
slotmachine: posts small blind $500
TurnOnTuneInDropOut: posts big blind $1000
*** HOLE CARDS ***
Dealt to TurnOnTuneInDropOut [4h 7c Ts Th]
gaganhyd: raises $1000 to $2000
Shr181: calls $2000
vishnu2788: calls $2000
slotmachine: folds
TurnOnTuneInDropOut: folds
*** FLOP *** [6s 3s 8d]
gaganhyd: checks
Shr181: checks
vishnu2788: checks
*** TURN *** [6s 3s 8d] [7h]
gaganhyd: bets $3750
Shr181: folds
vishnu2788: calls $3750
*** RIVER *** [6s 3s 8d 7h] [5c]
gaganhyd: bets $6603
vishnu2788: raises $17085 to $23688 and is all-in
gaganhyd: folds
Uncalled bet ($17085) returned to vishnu2788
vishnu2788 collected $27357 from pot
vishnu2788: doesn't show hand
*** SUMMARY ***
Total pot $28206 | Rake $849
Board [6s 3s 8d 7h 5c]
Seat 2: vishnu2788 (button) collected ($27357)
Seat 3: slotmachine (small blind) folded before Flop
Seat 4: TurnOnTuneInDropOut (big blind) folded before Flop
Seat 5: gaganhyd folded on the River
Seat 6: Shr181 folded on the Turn

PokerStars Hand #1957459592: Omaha Pot Limit ($500/$1000 USD) - 2020/10/23 13:35:58 ET
Table 'ADA540885739' 6-max Seat #5 is the button
Seat 2: bothras ($45000 in chips)
Seat 3: slotmachine ($143381 in chips)
Seat 4: TurnOnTuneInDropOut ($77293 in chips)
Seat 5: gaganhyd ($66105 in chips)
Seat 6: Shr181 ($45220 in chips)
Shr181: posts small blind $500
bothras: posts big blind $1000
*** HOLE CARDS ***
Dealt to TurnOnTuneInDropOut [4c 3c Qh 7d]
slotmachine: raises $2500 to $3500
TurnOnTuneInDropOut: folds
gaganhyd: folds
Shr181: folds
bothras: folds
Uncalled bet ($2500) returned to slotmachine
slotmachine collected $2500 from pot
slotmachine: doesn't show hand
*** SUMMARY ***
Total pot $2500 | Rake $0
Seat 2: bothras (big blind) folded before Flop
Seat 3: slotmachine collected ($2500)
Seat 4: TurnOnTuneInDropOut folded before Flop (didn't bet)
Seat 5: gaganhyd (button) folded before Flop (didn't bet)
Seat 6: Shr181 (small blind) folded before Flop

PokerStars Hand #1957459593: Omaha Pot Limit ($500/$1000 USD) - 2020/10/23 13:36:29 ET
Table 'ADA540885739' 6-max Seat #6 is the button
Seat 2: bothras ($44000 in chips)
Seat 3: slotmachine ($144881 in chips)
Seat 4: TurnOnTuneInDropOut ($77293 in chips)
Seat 5: gaganhyd ($66105 in chips)
Seat 6: Shr181 ($44720 in chips)
bothras: posts small blind $500
slotmachine: posts big blind $1000
*** HOLE CARDS ***
Dealt to TurnOnTuneInDropOut [7h Kc 8s Ts]
TurnOnTuneInDropOut: folds
gaganhyd: raises $1000 to $2000
Shr181: calls $2000
bothras: folds
slotmachine: folds
*** FLOP *** [Qh 2h Jc]
gaganhyd: checks
Shr181: checks
*** TURN *** [Qh 2h Jc] [9s]
gaganhyd: checks
Shr181: checks
*** RIVER *** [Qh 2h Jc 9s] [3c]
gaganhyd: checks
Shr181: checks
*** SHOW DOWN ***
gaganhyd: shows [8c 6h 9c 7c]
Shr181: mucks hand
gaganhyd collected $5334 from pot
*** SUMMARY ***
Total pot $5500 | Rake $166
Board [Qh 2h Jc 9s 3c]
Seat 2: bothras (small blind) folded before Flop
Seat 3: slotmachine (big blind) folded before Flop
Seat 4: TurnOnTuneInDropOut folded before Flop (didn't bet)
Seat 5: gaganhyd showed [8c 6h 9c 7c] and won ($5334)
Seat 6: Shr181 (button) mucked

PokerStars Hand #1957459594: Omaha Pot Limit ($500/$1000 USD) - 2020/10/23 13:37:28 ET
Table 'ADA540885739' 6-max Seat #2 is the button
Seat 2: bothras ($43500 in chips)
Seat 3: slotmachine ($143881 in chips)
Seat 4: TurnOnTuneInDropOut ($77293 in chips)
Seat 5: gaganhyd ($69439 in chips)
Seat 6: Shr181 ($42720 in chips)
slotmachine: posts small blind $500
TurnOnTuneInDropOut: posts big blind $1000
*** HOLE CARDS ***
Dealt to TurnOnTuneInDropOut [Ts 4d 9c Th]
gaganhyd: folds
Shr181: folds
bothras: folds
slotmachine: folds
Uncalled bet ($500) returned to TurnOnTuneInDropOut
TurnOnTuneInDropOut collected $1000 from pot
TurnOnTuneInDropOut: doesn't show hand
*** SUMMARY ***
Total pot $1000 | Rake $0
Seat 2: bothras (button) folded before Flop (didn't bet)
Seat 3: slotmachine (small blind) folded before Flop
Seat 4: TurnOnTuneInDropOut (big blind) collected ($1000)
Seat 5: gaganhyd folded before Flop (didn't bet)
Seat 6: Shr181 folded before Flop (didn't bet)

PokerStars Hand #1957459595: Omaha Pot Limit ($500/$1000 USD) - 2020/10/23 13:37:43 ET
Table 'ADA540885739' 6-max Seat #3 is the button
Seat 2: bothras ($43500 in chips)
Seat 3: slotmachine ($143381 in chips)
Seat 4: TurnOnTuneInDropOut ($77793 in chips)
Seat 5: gaganhyd ($69439 in chips)
Seat 6: Shr181 ($42720 in chips)
TurnOnTuneInDropOut: posts small blind $500
gaganhyd: posts big blind $1000
*** HOLE CARDS ***
Dealt to TurnOnTuneInDropOut [Jd 6s 7c 5s]
Shr181: folds
bothras: folds
slotmachine: raises $2500 to $3500
TurnOnTuneInDropOut: folds
gaganhyd: raises $7500 to $11000
slotmachine: calls $7500
*** FLOP *** [9c 4h 2d]
gaganhyd: bets $16875
slotmachine: raises $56250 to $73125
gaganhyd: calls $41564 and is all-in
Uncalled bet ($14686) returned to slotmachine
*** TURN *** [9c 4h 2d] [Kh]
*** RIVER *** [9c 4h 2d Kh] [Th]
*** SHOW DOWN ***
gaganhyd: shows [As Qc 8d Ad]
slotmachine: shows [8c Ah Js 9s]
gaganhyd collected $68989 from pot
*** SUMMARY ***
Total pot $139378 | Rake $70389
Board [9c 4h 2d Kh Th]
Seat 2: bothras folded before Flop (didn't bet)
Seat 3: slotmachine (button) showed [8c Ah Js 9s] and lost
Seat 4: TurnOnTuneInDropOut (small blind) folded before Flop
Seat 5: gaganhyd (big blind) showed [As Qc 8d Ad] and won ($68989)
Seat 6: Shr181 folded before Flop (didn't bet)

PokerStars Hand #1957459596: Omaha Pot Limit ($500/$1000 USD) - 2020/10/23 13:38:33 ET
Table 'ADA540885739' 6-max Seat #4 is the button
Seat 2: bothras ($43500 in chips)
Seat 3: slotmachine ($88850 in chips)
Seat 4: TurnOnTuneInDropOut ($77293 in chips)
Seat 5: gaganhyd ($137978 in chips)
Seat 6: Shr181 ($42720 in chips)
gaganhyd: posts small blind $500
Shr181: posts big blind $1000
*** HOLE CARDS ***
Dealt to TurnOnTuneInDropOut [Jh 5s 2d 2c]
bothras: raises $2500 to $3500
slotmachine: folds
TurnOnTuneInDropOut: folds
gaganhyd: folds
Shr181: calls $2500
*** FLOP *** [As 9c Qh]
Shr181: checks
bothras: bets $4500
Shr181: calls $4500
*** TURN *** [As 9c Qh] [Qd]
Shr181: bets $5573
bothras: folds
Uncalled bet ($5573) returned to Shr181
Shr181 collected $16003 from pot
Shr181: doesn't show hand
*** SUMMARY ***
Total pot $16500 | Rake $497
Board [As 9c Qh Qd]
Seat 2: bothras folded on the Turn
Seat 3: slotmachine folded before Flop (didn't bet)
Seat 4: TurnOnTuneInDropOut (button) folded before Flop (didn't bet)
Seat 5: gaganhyd (small blind) folded before Flop
Seat 6: Shr181 (big blind) collected ($16003)

PokerStars Hand #1957459597: Omaha Pot Limit ($500/$1000 USD) - 2020/10/23 13:39:14 ET
Table 'ADA540885739' 6-max Seat #5 is the button
Seat 2: bothras ($35500 in chips)
Seat 3: slotmachine ($88850 in chips)
Seat 4: TurnOnTuneInDropOut ($77293 in chips)
Seat 5: gaganhyd ($137478 in chips)
Seat 6: Shr181 ($50723 in chips)
Shr181: posts small blind $500
bothras: posts big blind $1000
*** HOLE CARDS ***
Dealt to TurnOnTuneInDropOut [5c Qd 6c Kh]
slotmachine: raises $2500 to $3500
TurnOnTuneInDropOut: folds
gaganhyd: folds
Shr181: calls $3000
bothras: folds
*** FLOP *** [4s 3s 4c]
Shr181: checks
slotmachine: bets $2640
Shr181: calls $2640
*** TURN *** [4s 3s 4c] [3d]
Shr181: checks
slotmachine: checks
*** RIVER *** [4s 3s 4c 3d] [Jd]
Shr181: bets $7175
slotmachine: calls $7175
*** SHOW DOWN ***
Shr181: shows [4h 3c 7h 8h]
slotmachine: mucks hand
Shr181 collected $26798 from pot
*** SUMMARY ***
Total pot $27630 | Rake $832
Board [4s 3s 4c 3d Jd]
Seat 2: bothras (big blind) folded before Flop
Seat 3: slotmachine mucked
Seat 4: TurnOnTuneInDropOut folded before Flop (didn't bet)
Seat 5: gaganhyd (button) folded before Flop (didn't bet)
Seat 6: Shr181 (small blind) showed [4h 3c 7h 8h] and won ($26798)

PokerStars Hand #1957459598: Omaha Pot Limit ($500/$1000 USD) - 2020/10/23 13:40:15 ET
Table 'ADA540885739' 6-max Seat #6 is the button
Seat 2: bothras ($34500 in chips)
Seat 3: slotmachine ($75535 in chips)
Seat 4: TurnOnTuneInDropOut ($77293 in chips)
Seat 6: Shr181 ($64206 in chips)
bothras: posts small blind $500
slotmachine: posts big blind $1000
*** HOLE CARDS ***
Dealt to TurnOnTuneInDropOut [Ad As 9s 8c]
TurnOnTuneInDropOut: raises $2500 to $3500
Shr181: calls $3500
bothras: folds
slotmachine: folds
*** FLOP *** [3c 2s 9h]
TurnOnTuneInDropOut: bets $8500
Shr181: calls $8500
*** TURN *** [3c 2s 9h] [8s]
TurnOnTuneInDropOut: bets $16830
Shr181: calls $16830
*** RIVER *** [3c 2s 9h 8s] [Td]
TurnOnTuneInDropOut: checks
Shr181: checks
*** SHOW DOWN ***
TurnOnTuneInDropOut: shows [Ad As 9s 8c]
Shr181: mucks hand
TurnOnTuneInDropOut collected $57761 from pot
*** SUMMARY ***
Total pot $59160 | Rake $1399
Board [3c 2s 9h 8s Td]
Seat 2: bothras (small blind) folded before Flop
Seat 3: slotmachine (big blind) folded before Flop
Seat 4: TurnOnTuneInDropOut showed [Ad As 9s 8c] and won ($57761)
Seat 6: Shr181 (button) mucked

PokerStars Hand #1957459600: Omaha Pot Limit ($500/$1000 USD) - 2020/10/23 13:43:36 ET
Table 'ADA540885739' 6-max Seat #3 is the button
Seat 1: Prateek1986 ($70250 in chips)
Seat 3: slotmachine ($73535 in chips)
Seat 4: TurnOnTuneInDropOut ($105224 in chips)
Seat 5: aggtarun ($120000 in chips)
Seat 6: Shr181 ($42750 in chips)
TurnOnTuneInDropOut: posts small blind $500
aggtarun: posts big blind $1000
*** HOLE CARDS ***
Dealt to TurnOnTuneInDropOut [9h Th 3h Ah]
Shr181: folds
Prateek1986: raises $1000 to $2000
slotmachine: folds
TurnOnTuneInDropOut: folds
aggtarun: calls $1000
*** FLOP *** [3c 4s 8s]
aggtarun: checks
Prateek1986: checks
*** TURN *** [3c 4s 8s] [3s]
aggtarun: checks
Prateek1986: bets $3375
aggtarun: calls $3375
*** RIVER *** [3c 4s 8s 3s] [4h]
aggtarun: checks
Prateek1986: checks
*** SHOW DOWN ***
aggtarun: mucks hand
Prateek1986: shows [5s Ad Js Ks]
Prateek1986 collected $10911 from pot
*** SUMMARY ***
Total pot $11250 | Rake $339
Board [3c 4s 8s 3s 4h]
Seat 1: Prateek1986 showed [5s Ad Js Ks] and won ($10911)
Seat 3: slotmachine (button) folded before Flop (didn't bet)
Seat 4: TurnOnTuneInDropOut (small blind) folded before Flop
Seat 5: aggtarun (big blind) mucked
Seat 6: Shr181 folded before Flop (didn't bet)

PokerStars Hand #1957459601: Omaha Pot Limit ($500/$1000 USD) - 2020/10/23 13:44:24 ET
Table 'ADA540885739' 6-max Seat #4 is the button
Seat 1: Prateek1986 ($75786 in chips)
Seat 3: slotmachine ($73535 in chips)
Seat 4: TurnOnTuneInDropOut ($104724 in chips)
Seat 5: aggtarun ($120000 in chips)
aggtarun: posts small blind $500
Prateek1986: posts big blind $1000
*** HOLE CARDS ***
Dealt to TurnOnTuneInDropOut [5h 6c 4s Qh]
slotmachine: folds
TurnOnTuneInDropOut: folds
aggtarun: raises $2000 to $3000
Prateek1986: calls $2000
*** FLOP *** [8c 7h 9s]
aggtarun: bets $4140
Prateek1986: calls $4140
*** TURN *** [8c 7h 9s] [3c]
aggtarun: bets $14280
Prateek1986: calls $14280
*** RIVER *** [8c 7h 9s 3c] [Ks]
aggtarun: bets $29560
Prateek1986: folds
Uncalled bet ($29560) returned to aggtarun
aggtarun collected $41551 from pot
aggtarun: doesn't show hand
*** SUMMARY ***
Total pot $42840 | Rake $1289
Board [8c 7h 9s 3c Ks]
Seat 1: Prateek1986 (big blind) folded on the River
Seat 3: slotmachine folded before Flop (didn't bet)
Seat 4: TurnOnTuneInDropOut (button) folded before Flop (didn't bet)
Seat 5: aggtarun (small blind) collected ($41551)

PokerStars Hand #1957459602: Omaha Pot Limit ($500/$1000 USD) - 2020/10/23 13:45:28 ET
Table 'ADA540885739' 6-max Seat #5 is the button
Seat 1: Prateek1986 ($54366 in chips)
Seat 3: slotmachine ($73535 in chips)
Seat 4: TurnOnTuneInDropOut ($104724 in chips)
Seat 5: aggtarun ($140131 in chips)
Prateek1986: posts small blind $500
slotmachine: posts big blind $1000
*** HOLE CARDS ***
Dealt to TurnOnTuneInDropOut [Th Jc Kc Ac]
TurnOnTuneInDropOut: raises $2500 to $3500
aggtarun: calls $3500
Prateek1986: calls $3000
slotmachine: folds
*** FLOP *** [Ks 4c 6c]
Prateek1986: checks
TurnOnTuneInDropOut: checks
aggtarun: checks
*** TURN *** [Ks 4c 6c] [9d]
Prateek1986: checks
TurnOnTuneInDropOut: checks
aggtarun: checks
*** RIVER *** [Ks 4c 6c 9d] [5h]
Prateek1986: checks
TurnOnTuneInDropOut: checks
aggtarun: bets $8970
Prateek1986: folds
TurnOnTuneInDropOut: folds
Uncalled bet ($8970) returned to aggtarun
aggtarun collected $11154 from pot
aggtarun: doesn't show hand
*** SUMMARY ***
Total pot $11500 | Rake $346
Board [Ks 4c 6c 9d 5h]
Seat 1: Prateek1986 (small blind) folded on the River
Seat 3: slotmachine (big blind) folded before Flop
Seat 4: TurnOnTuneInDropOut folded on the River
Seat 5: aggtarun (button) collected ($11154)

PokerStars Hand #1957459603: Omaha Pot Limit ($500/$1000 USD) - 2020/10/23 13:46:58 ET
Table 'ADA540885739' 6-max Seat #1 is the button
Seat 1: Prateek1986 ($50866 in chips)
Seat 3: slotmachine ($72535 in chips)
Seat 4: TurnOnTuneInDropOut ($101224 in chips)
Seat 5: aggtarun ($147785 in chips)
slotmachine: posts small blind $500
TurnOnTuneInDropOut: posts big blind $1000
*** HOLE CARDS ***
Dealt to TurnOnTuneInDropOut [Kd 4h 9d Tc]
aggtarun: folds
Prateek1986: folds
slotmachine: raises $2000 to $3000
TurnOnTuneInDropOut: calls $2000
*** FLOP *** [Jd 5h 2c]
slotmachine: bets $6000
TurnOnTuneInDropOut: folds
Uncalled bet ($6000) returned to slotmachine
slotmachine collected $5819 from pot
slotmachine: doesn't show hand
*** SUMMARY ***
Total pot $6000 | Rake $181
Board [Jd 5h 2c]
Seat 1: Prateek1986 (button) folded before Flop (didn't bet)
Seat 3: slotmachine (small blind) collected ($5819)
Seat 4: TurnOnTuneInDropOut (big blind) folded on the Flop
Seat 5: aggtarun folded before Flop (didn't bet)

PokerStars Hand #1957459604: Omaha Pot Limit ($500/$1000 USD) - 2020/10/23 13:47:29 ET
Table 'ADA540885739' 6-max Seat #3 is the button
Seat 1: Prateek1986 ($50866 in chips)
Seat 3: slotmachine ($75354 in chips)
Seat 4: TurnOnTuneInDropOut ($98224 in chips)
Seat 5: aggtarun ($147785 in chips)
TurnOnTuneInDropOut: posts small blind $500
aggtarun: posts big blind $1000
*** HOLE CARDS ***
Dealt to TurnOnTuneInDropOut [5h 4d Td 6h]
Prateek1986: folds
slotmachine: raises $2500 to $3500
TurnOnTuneInDropOut: folds
aggtarun: raises $7500 to $11000
slotmachine: calls $7500
*** FLOP *** [Jh 5c 9c]
aggtarun: bets $22500
slotmachine: raises $41854 to $64354 and is all-in
aggtarun: calls $41854
*** TURN *** [Jh 5c 9c] [2h]
*** RIVER *** [Jh 5c 9c 2h] [6d]
*** SHOW DOWN ***
aggtarun: shows [As 4c 6c Js]
slotmachine: shows [3c Kd 8d Jc]
aggtarun collected $149809 from pot
*** SUMMARY ***
Total pot $151208 | Rake $1399
Board [Jh 5c 9c 2h 6d]
Seat 1: Prateek1986 folded before Flop (didn't bet)
Seat 3: slotmachine (button) showed [3c Kd 8d Jc] and lost
Seat 4: TurnOnTuneInDropOut (small blind) folded before Flop
Seat 5: aggtarun (big blind) showed [As 4c 6c Js] and won ($149809)

PokerStars Hand #1957459605: Omaha Pot Limit ($500/$1000 USD) - 2020/10/23 13:48:15 ET
Table 'ADA540885739' 6-max Seat #4 is the button
Seat 1: Prateek1986 ($50866 in chips)
Seat 3: slotmachine ($90000 in chips)
Seat 4: TurnOnTuneInDropOut ($97724 in chips)
Seat 5: aggtarun ($222240 in chips)
aggtarun: posts small blind $500
Prateek1986: posts big blind $1000
*** HOLE CARDS ***
Dealt to TurnOnTuneInDropOut [5s Th 6d Ah]
slotmachine: folds
TurnOnTuneInDropOut: raises $2500 to $3500
aggtarun: folds
Prateek1986: folds
Uncalled bet ($2500) returned to TurnOnTuneInDropOut
TurnOnTuneInDropOut collected $2500 from pot
TurnOnTuneInDropOut: doesn't show hand
*** SUMMARY ***
Total pot $2500 | Rake $0
Seat 1: Prateek1986 (big blind) folded before Flop
Seat 3: slotmachine folded before Flop (didn't bet)
Seat 4: TurnOnTuneInDropOut (button) collected ($2500)
Seat 5: aggtarun (small blind) folded before Flop

PokerStars Hand #1957459606: Omaha Pot Limit ($500/$1000 USD) - 2020/10/23 13:48:30 ET
Table 'ADA540885739' 6-max Seat #5 is the button
Seat 1: Prateek1986 ($49866 in chips)
Seat 2: Lock2k16 ($92649 in chips)
Seat 3: slotmachine ($90000 in chips)
Seat 4: TurnOnTuneInDropOut ($99224 in chips)
Seat 5: aggtarun ($221740 in chips)
Prateek1986: posts small blind $500
Lock2k16: posts big blind $1000
*** HOLE CARDS ***
Dealt to TurnOnTuneInDropOut [8d 8s Ad 5s]
slotmachine: folds
TurnOnTuneInDropOut: raises $2500 to $3500
aggtarun: calls $3500
Prateek1986: folds
Lock2k16: calls $2500
*** FLOP *** [Tc Jc 7s]
Lock2k16: checks
TurnOnTuneInDropOut: checks
aggtarun: checks
*** TURN *** [Tc Jc 7s] [2c]
Lock2k16: bets $3000
TurnOnTuneInDropOut: folds
aggtarun: folds
Uncalled bet ($3000) returned to Lock2k16
Lock2k16 collected $10669 from pot
Lock2k16: doesn't show hand
*** SUMMARY ***
Total pot $11000 | Rake $331
Board [Tc Jc 7s 2c]
Seat 1: Prateek1986 (small blind) folded before Flop
Seat 2: Lock2k16 (big blind) collected ($10669)
Seat 3: slotmachine folded before Flop (didn't bet)
Seat 4: TurnOnTuneInDropOut folded on the Turn
Seat 5: aggtarun (button) folded on the Turn

PokerStars Hand #1957459607: Omaha Pot Limit ($500/$1000 USD) - 2020/10/23 13:49:15 ET
Table 'ADA540885739' 6-max Seat #1 is the button
Seat 1: Prateek1986 ($49366 in chips)
Seat 2: Lock2k16 ($99818 in chips)
Seat 3: slotmachine ($90000 in chips)
Seat 4: TurnOnTuneInDropOut ($95724 in chips)
Seat 5: aggtarun ($218240 in chips)
Seat 6: Shr181 ($42750 in chips)
Lock2k16: posts small blind $500
slotmachine: posts big blind $1000
Shr181: posts big blind $1000
*** HOLE CARDS ***
Dealt to TurnOnTuneInDropOut [6d As 4h 3h]
TurnOnTuneInDropOut: folds
aggtarun: calls $1000
Shr181: checks
Prateek1986: folds
Lock2k16: raises $1000 to $2000
slotmachine: folds
aggtarun: raises $6000 to $8000
Shr181: folds
Lock2k16: calls $6000
*** FLOP *** [3s 6h 2d]
Lock2k16: checks
aggtarun: checks
*** TURN *** [3s 6h 2d] [8c]
Lock2k16: bets $4000
aggtarun: raises $20400 to $24400
Lock2k16: folds
Uncalled bet ($20400) returned to aggtarun
aggtarun collected $25217 from pot
aggtarun: doesn't show hand
*** SUMMARY ***
Total pot $26000 | Rake $783
Board [3s 6h 2d 8c]
Seat 1: Prateek1986 (button) folded before Flop (didn't bet)
Seat 2: Lock2k16 (small blind) folded on the Turn
Seat 3: slotmachine (big blind) folded before Flop
Seat 4: TurnOnTuneInDropOut folded before Flop (didn't bet)
Seat 5: aggtarun collected ($25217)
Seat 6: Shr181 folded before Flop

PokerStars Hand #1957459617: Omaha Pot Limit ($500/$1000 USD) - 2020/10/23 13:59:52 ET
Table 'ADA540885739' 6-max Seat #6 is the button
Seat 1: Prateek1986 ($43366 in chips)
Seat 2: Lock2k16 ($74179 in chips)
Seat 3: slotmachine ($121684 in chips)
Seat 4: TurnOnTuneInDropOut ($86036 in chips)
Seat 5: aggtarun ($264852 in chips)
Seat 6: Shr181 ($32250 in chips)
Prateek1986: posts small blind $500
Lock2k16: posts big blind $1000
*** HOLE CARDS ***
Dealt to TurnOnTuneInDropOut [Qd 9c Ac Js]
slotmachine: folds
TurnOnTuneInDropOut: raises $2500 to $3500
aggtarun: folds
Shr181: calls $3500
Prateek1986: calls $3000
Lock2k16: calls $2500
*** FLOP *** [Jh 5c Ks]
Prateek1986: checks
Lock2k16: checks
TurnOnTuneInDropOut: checks
Shr181: checks
*** TURN *** [Jh 5c Ks] [2d]
Prateek1986: checks
Lock2k16: bets $4000
TurnOnTuneInDropOut: calls $4000
Shr181: calls $4000
Prateek1986: calls $4000
*** RIVER *** [Jh 5c Ks 2d] [4d]
Prateek1986: bets $22500
Lock2k16: folds
TurnOnTuneInDropOut: folds
Shr181: folds
Uncalled bet ($22500) returned to Prateek1986
Prateek1986 collected $29097 from pot
Prateek1986: doesn't show hand
*** SUMMARY ***
Total pot $30000 | Rake $903
Board [Jh 5c Ks 2d 4d]
Seat 1: Prateek1986 (small blind) collected ($29097)
Seat 2: Lock2k16 (big blind) folded on the River
Seat 3: slotmachine folded before Flop (didn't bet)
Seat 4: TurnOnTuneInDropOut folded on the River
Seat 5: aggtarun folded before Flop (didn't bet)
Seat 6: Shr181 (button) folded on the River

PokerStars Hand #1957459618: Omaha Pot Limit ($500/$1000 USD) - 2020/10/23 14:01:10 ET
Table 'ADA540885739' 6-max Seat #1 is the button
Seat 1: Prateek1986 ($64963 in chips)
Seat 2: Lock2k16 ($66679 in chips)
Seat 3: slotmachine ($121684 in chips)
Seat 4: TurnOnTuneInDropOut ($78536 in chips)
Seat 5: aggtarun ($264852 in chips)
Seat 6: Shr181 ($24750 in chips)
Lock2k16: posts small blind $500
slotmachine: posts big blind $1000
*** HOLE CARDS ***
Dealt to TurnOnTuneInDropOut [Ts 3c 6h 3d]
TurnOnTuneInDropOut: folds
aggtarun: raises $2500 to $3500
Shr181: raises $2500 to $6000
Prateek1986: calls $6000
Lock2k16: folds
slotmachine: folds
aggtarun: raises $19500 to $25500
Shr181: calls $18750 and is all-in
Prateek1986: calls $19500
*** FLOP *** [Th 9d 4c]
aggtarun: bets $77250
Prateek1986: calls $39463 and is all-in
Uncalled bet ($37787) returned to aggtarun
*** TURN *** [Th 9d 4c] [7d]
*** RIVER *** [Th 9d 4c 7d] [Kc]
*** SHOW DOWN ***
aggtarun: shows [Qc Qs Kd 8s]
Prateek1986: shows [Td Ah Qd 5h]
aggtarun collected $80426 from side pot
Shr181: shows [Jh 3s Jd 4h]
aggtarun collected $74351 from main pot
*** SUMMARY ***
Total pot $156176 Main pot $74351. Side pot $80426. | Rake $1399
Board [Th 9d 4c 7d Kc]
Seat 1: Prateek1986 (button) showed [Td Ah Qd 5h] and lost
Seat 2: Lock2k16 (small blind) folded before Flop
Seat 3: slotmachine (big blind) folded before Flop
Seat 4: TurnOnTuneInDropOut folded before Flop (didn't bet)
Seat 5: aggtarun showed [Qc Qs Kd 8s] and won ($154777)
Seat 6: Shr181 showed [Jh 3s Jd 4h] and lost

PokerStars Hand #1957459619: Omaha Pot Limit ($500/$1000 USD) - 2020/10/23 14:02:19 ET
Table 'ADA540885739' 6-max Seat #2 is the button
Seat 2: Lock2k16 ($66179 in chips)
Seat 3: slotmachine ($120684 in chips)
Seat 4: TurnOnTuneInDropOut ($78536 in chips)
Seat 5: aggtarun ($354666 in chips)
slotmachine: posts small blind $500
TurnOnTuneInDropOut: posts big blind $1000
*** HOLE CARDS ***
Dealt to TurnOnTuneInDropOut [6d 8d Jh 9s]
aggtarun: raises $2500 to $3500
Lock2k16: folds
slotmachine: folds
TurnOnTuneInDropOut: folds
Uncalled bet ($2500) returned to aggtarun
aggtarun collected $2500 from pot
aggtarun: doesn't show hand
*** SUMMARY ***
Total pot $2500 | Rake $0
Seat 2: Lock2k16 (button) folded before Flop (didn't bet)
Seat 3: slotmachine (small blind) folded before Flop
Seat 4: TurnOnTuneInDropOut (big blind) folded before Flop
Seat 5: aggtarun collected ($2500)

PokerStars Hand #1957459621: Omaha Pot Limit ($500/$1000 USD) - 2020/10/23 14:03:21 ET
Table 'ADA540885739' 6-max Seat #4 is the button
Seat 2: Lock2k16 ($70423 in chips)
Seat 3: slotmachine ($120184 in chips)
Seat 4: TurnOnTuneInDropOut ($77036 in chips)
Seat 5: aggtarun ($352166 in chips)
aggtarun: posts small blind $500
Lock2k16: posts big blind $1000
*** HOLE CARDS ***
Dealt to TurnOnTuneInDropOut [7c 8s 6s 3c]
slotmachine: folds
TurnOnTuneInDropOut: raises $2500 to $3500
aggtarun: folds
Lock2k16: folds
Uncalled bet ($2500) returned to TurnOnTuneInDropOut
TurnOnTuneInDropOut collected $2500 from pot
TurnOnTuneInDropOut: doesn't show hand
*** SUMMARY ***
Total pot $2500 | Rake $0
Seat 2: Lock2k16 (big blind) folded before Flop
Seat 3: slotmachine folded before Flop (didn't bet)
Seat 4: TurnOnTuneInDropOut (button) collected ($2500)
Seat 5: aggtarun (small blind) folded before Flop

PokerStars Hand #1957459622: Omaha Pot Limit ($500/$1000 USD) - 2020/10/23 14:03:48 ET
Table 'ADA540885739' 6-max Seat #5 is the button
Seat 2: Lock2k16 ($69423 in chips)
Seat 3: slotmachine ($120184 in chips)
Seat 4: TurnOnTuneInDropOut ($78536 in chips)
Seat 5: aggtarun ($351666 in chips)
Lock2k16: posts small blind $500
slotmachine: posts big blind $1000
*** HOLE CARDS ***
Dealt to TurnOnTuneInDropOut [6c 8d Qs 2c]
TurnOnTuneInDropOut: folds
aggtarun: folds
Lock2k16: calls $500
slotmachine: raises $2000 to $3000
Lock2k16: folds
Uncalled bet ($2000) returned to slotmachine
slotmachine collected $2000 from pot
slotmachine: doesn't show hand
*** SUMMARY ***
Total pot $2000 | Rake $0
Seat 2: Lock2k16 (small blind) folded before Flop
Seat 3: slotmachine (big blind) collected ($2000)
Seat 4: TurnOnTuneInDropOut folded before Flop (didn't bet)
Seat 5: aggtarun (button) folded before Flop (didn't bet)

PokerStars Hand #1957459627: Omaha Pot Limit ($500/$1000 USD) - 2020/10/23 14:06:38 ET
Table 'ADA540885739' 6-max Seat #2 is the button
Seat 2: Lock2k16 ($63995 in chips)
Seat 3: slotmachine ($132862 in chips)
Seat 4: TurnOnTuneInDropOut ($78536 in chips)
Seat 5: aggtarun ($346666 in chips)
Seat 6: gaganhyd ($36720 in chips)
slotmachine: posts small blind $500
TurnOnTuneInDropOut: posts big blind $1000
*** HOLE CARDS ***
Dealt to TurnOnTuneInDropOut [Ad 2d Td 6h]
aggtarun: folds
gaganhyd: folds
Lock2k16: raises $1000 to $2000
slotmachine: folds
TurnOnTuneInDropOut: calls $1000
*** FLOP *** [Tc 9h 3s]
TurnOnTuneInDropOut: checks
Lock2k16: bets $1000
TurnOnTuneInDropOut: calls $1000
*** TURN *** [Tc 9h 3s] [Js]
TurnOnTuneInDropOut: checks
Lock2k16: bets $6500
TurnOnTuneInDropOut: folds
Uncalled bet ($6500) returned to Lock2k16
Lock2k16 collected $6304 from pot
Lock2k16: doesn't show hand
*** SUMMARY ***
Total pot $6500 | Rake $196
Board [Tc 9h 3s Js]
Seat 2: Lock2k16 (button) collected ($6304)
Seat 3: slotmachine (small blind) folded before Flop
Seat 4: TurnOnTuneInDropOut (big blind) folded on the Turn
Seat 5: aggtarun folded before Flop (didn't bet)
Seat 6: gaganhyd folded before Flop (didn't bet)

PokerStars Hand #1957459628: Omaha Pot Limit ($500/$1000 USD) - 2020/10/23 14:07:13 ET
Table 'ADA540885739' 6-max Seat #3 is the button
Seat 2: Lock2k16 ($67299 in chips)
Seat 3: slotmachine ($132362 in chips)
Seat 4: TurnOnTuneInDropOut ($75536 in chips)
Seat 5: aggtarun ($346666 in chips)
Seat 6: gaganhyd ($36720 in chips)
TurnOnTuneInDropOut: posts small blind $500
aggtarun: posts big blind $1000
*** HOLE CARDS ***
Dealt to TurnOnTuneInDropOut [Ks 7d 2s Kd]
gaganhyd: folds
Lock2k16: raises $1000 to $2000
slotmachine: folds
TurnOnTuneInDropOut: raises $5000 to $7000
aggtarun: folds
Lock2k16: calls $5000
*** FLOP *** [3h 5h Kh]
TurnOnTuneInDropOut: bets $2950
Lock2k16: calls $2950
*** TURN *** [3h 5h Kh] [Qs]
TurnOnTuneInDropOut: checks
Lock2k16: bets $10450
TurnOnTuneInDropOut: calls $10450
*** RIVER *** [3h 5h Kh Qs] [Ts]
TurnOnTuneInDropOut: checks
Lock2k16: bets $20900
TurnOnTuneInDropOut: calls $20900
*** SHOW DOWN ***
TurnOnTuneInDropOut: shows [Ks 7d 2s Kd]
Lock2k16: mucks hand
TurnOnTuneInDropOut collected $82201 from pot
*** SUMMARY ***
Total pot $83600 | Rake $1399
Board [3h 5h Kh Qs Ts]
Seat 2: Lock2k16 mucked
Seat 3: slotmachine (button) folded before Flop (didn't bet)
Seat 4: TurnOnTuneInDropOut (small blind) showed [Ks 7d 2s Kd] and won ($82201)
Seat 5: aggtarun (big blind) folded before Flop
Seat 6: gaganhyd folded before Flop (didn't bet)

PokerStars Hand #1957459631: Omaha Pot Limit ($500/$1000 USD) - 2020/10/23 14:09:41 ET
Table 'ADA540885739' 6-max Seat #6 is the button
Seat 1: inveigle ($120000 in chips)
Seat 2: Lock2k16 ($23499 in chips)
Seat 3: slotmachine ($133862 in chips)
Seat 4: TurnOnTuneInDropOut ($116437 in chips)
Seat 5: aggtarun ($343166 in chips)
Seat 6: gaganhyd ($40994 in chips)
inveigle: posts small blind $500
Lock2k16: posts big blind $1000
*** HOLE CARDS ***
Dealt to TurnOnTuneInDropOut [8s 6d Kc 3d]
slotmachine: folds
TurnOnTuneInDropOut: folds
aggtarun: folds
gaganhyd: folds
inveigle: calls $500
Lock2k16: raises $2000 to $3000
inveigle: raises $6000 to $9000
Lock2k16: calls $6000
*** FLOP *** [8c Qc 2d]
inveigle: bets $18000
Lock2k16: calls $14499 and is all-in
Uncalled bet ($3501) returned to inveigle
*** TURN *** [8c Qc 2d] [Qh]
*** RIVER *** [8c Qc 2d Qh] [Th]
*** SHOW DOWN ***
inveigle: shows [7d Kd 4h Kh]
Lock2k16: shows [Ad 9h 2s 7h]
inveigle collected $45599 from pot
*** SUMMARY ***
Total pot $46998 | Rake $1399
Board [8c Qc 2d Qh Th]
Seat 1: inveigle (small blind) showed [7d Kd 4h Kh] and won ($45599)
Seat 2: Lock2k16 (big blind) showed [Ad 9h 2s 7h] and lost
Seat 3: slotmachine folded before Flop (didn't bet)
Seat 4: TurnOnTuneInDropOut folded before Flop (didn't bet)
Seat 5: aggtarun folded before Flop (didn't bet)
Seat 6: gaganhyd (button) folded before Flop (didn't bet)

PokerStars Hand #1957459647: Omaha Pot Limit ($500/$1000 USD) - 2020/10/23 14:18:34 ET
Table 'ADA540885739' 6-max Seat #3 is the button
Seat 1: inveigle ($119500 in chips)
Seat 3: slotmachine ($179828 in chips)
Seat 4: TurnOnTuneInDropOut ($107437 in chips)
Seat 5: prashantshah ($41500 in chips)
TurnOnTuneInDropOut: posts small blind $500
prashantshah: posts big blind $1000
*** HOLE CARDS ***
Dealt to TurnOnTuneInDropOut [Ad 4h Ah 6s]
inveigle: folds
slotmachine: folds
TurnOnTuneInDropOut: raises $2000 to $3000
prashantshah: calls $2000
*** FLOP *** [Kc 9h Jc]
TurnOnTuneInDropOut: checks
prashantshah: checks
*** TURN *** [Kc 9h Jc] [6c]
TurnOnTuneInDropOut: checks
prashantshah: checks
*** RIVER *** [Kc 9h Jc 6c] [5h]
TurnOnTuneInDropOut: checks
prashantshah: bets $1000
TurnOnTuneInDropOut: folds
Uncalled bet ($1000) returned to prashantshah
prashantshah collected $5819 from pot
prashantshah: doesn't show hand
*** SUMMARY ***
Total pot $6000 | Rake $181
Board [Kc 9h Jc 6c 5h]
Seat 1: inveigle folded before Flop (didn't bet)
Seat 3: slotmachine (button) folded before Flop (didn't bet)
Seat 4: TurnOnTuneInDropOut (small blind) folded on the River
Seat 5: prashantshah (big blind) collected ($5819)

PokerStars Hand #1957459648: Omaha Pot Limit ($500/$1000 USD) - 2020/10/23 14:19:37 ET
Table 'ADA540885739' 6-max Seat #4 is the button
Seat 1: inveigle ($119500 in chips)
Seat 3: slotmachine ($179828 in chips)
Seat 4: TurnOnTuneInDropOut ($104437 in chips)
Seat 5: prashantshah ($44319 in chips)
Seat 6: Prateek1986 ($41614 in chips)
prashantshah: posts small blind $500
Prateek1986: posts big blind $1000
*** HOLE CARDS ***
Dealt to TurnOnTuneInDropOut [Ks 2s 7c 3c]
inveigle: folds
slotmachine: folds
TurnOnTuneInDropOut: folds
prashantshah: calls $500
Prateek1986: checks
*** FLOP *** [Qc 6s 9c]
prashantshah: checks
Prateek1986: checks
*** TURN *** [Qc 6s 9c] [6c]
prashantshah: checks
Prateek1986: checks
*** RIVER *** [Qc 6s 9c 6c] [7d]
prashantshah: checks
Prateek1986: checks
*** SHOW DOWN ***
prashantshah: shows [Jd 7h Kc 4h]
Prateek1986: mucks hand
prashantshah collected $1940 from pot
*** SUMMARY ***
Total pot $2000 | Rake $60
Board [Qc 6s 9c 6c 7d]
Seat 1: inveigle folded before Flop (didn't bet)
Seat 3: slotmachine folded before Flop (didn't bet)
Seat 4: TurnOnTuneInDropOut (button) folded before Flop (didn't bet)
Seat 5: prashantshah (small blind) showed [Jd 7h Kc 4h] and won ($1940)
Seat 6: Prateek1986 (big blind) mucked

PokerStars Hand #1957459649: Omaha Pot Limit ($500/$1000 USD) - 2020/10/23 14:20:26 ET
Table 'ADA540885739' 6-max Seat #5 is the button
Seat 1: inveigle ($119500 in chips)
Seat 3: slotmachine ($179828 in chips)
Seat 4: TurnOnTuneInDropOut ($104437 in chips)
Seat 5: prashantshah ($45259 in chips)
Seat 6: Prateek1986 ($40614 in chips)
Prateek1986: posts small blind $500
inveigle: posts big blind $1000
*** HOLE CARDS ***
Dealt to TurnOnTuneInDropOut [7s Jd Kd Kh]
slotmachine: folds
TurnOnTuneInDropOut: raises $2500 to $3500
prashantshah: folds
Prateek1986: folds
inveigle: folds
Uncalled bet ($2500) returned to TurnOnTuneInDropOut
TurnOnTuneInDropOut collected $2500 from pot
TurnOnTuneInDropOut: doesn't show hand
*** SUMMARY ***
Total pot $2500 | Rake $0
Seat 1: inveigle (big blind) folded before Flop
Seat 3: slotmachine folded before Flop (didn't bet)
Seat 4: TurnOnTuneInDropOut collected ($2500)
Seat 5: prashantshah (button) folded before Flop (didn't bet)
Seat 6: Prateek1986 (small blind) folded before Flop

PokerStars Hand #1957459650: Omaha Pot Limit ($500/$1000 USD) - 2020/10/23 14:20:56 ET
Table 'ADA540885739' 6-max Seat #6 is the button
Seat 1: inveigle ($118500 in chips)
Seat 3: slotmachine ($179828 in chips)
Seat 4: TurnOnTuneInDropOut ($105937 in chips)
Seat 5: prashantshah ($45259 in chips)
Seat 6: Prateek1986 ($40114 in chips)
inveigle: posts small blind $500
slotmachine: posts big blind $1000
*** HOLE CARDS ***
Dealt to TurnOnTuneInDropOut [Kh 8s 4h Ac]
TurnOnTuneInDropOut: folds
prashantshah: folds
Prateek1986: calls $1000
inveigle: calls $500
slotmachine: checks
*** FLOP *** [6d 5s Kd]
inveigle: checks
slotmachine: checks
Prateek1986: checks
*** TURN *** [6d 5s Kd] [Js]
inveigle: checks
slotmachine: checks
Prateek1986: checks
*** RIVER *** [6d 5s Kd Js] [8h]
inveigle: bets $3000
slotmachine: folds
Prateek1986: folds
Uncalled bet ($3000) returned to inveigle
inveigle collected $2910 from pot
inveigle: doesn't show hand
*** SUMMARY ***
Total pot $3000 | Rake $90
Board [6d 5s Kd Js 8h]
Seat 1: inveigle (small blind) collected ($2910)
Seat 3: slotmachine (big blind) folded on the River
Seat 4: TurnOnTuneInDropOut folded before Flop (didn't bet)
Seat 5: prashantshah folded before Flop (didn't bet)
Seat 6: Prateek1986 (button) folded on the River

PokerStars Hand #1957459652: Omaha Pot Limit ($500/$1000 USD) - 2020/10/23 14:22:56 ET
Table 'ADA540885739' 6-max Seat #3 is the button
Seat 1: inveigle ($121910 in chips)
Seat 3: slotmachine ($178328 in chips)
Seat 4: TurnOnTuneInDropOut ($104937 in chips)
Seat 5: prashantshah ($45259 in chips)
Seat 6: Prateek1986 ($39114 in chips)
TurnOnTuneInDropOut: posts small blind $500
prashantshah: posts big blind $1000
*** HOLE CARDS ***
Dealt to TurnOnTuneInDropOut [6c Kd As 4h]
Prateek1986: folds
inveigle: folds
slotmachine: folds
TurnOnTuneInDropOut: folds
Uncalled bet ($500) returned to prashantshah
prashantshah collected $1000 from pot
prashantshah: doesn't show hand
*** SUMMARY ***
Total pot $1000 | Rake $0
Seat 1: inveigle folded before Flop (didn't bet)
Seat 3: slotmachine (button) folded before Flop (didn't bet)
Seat 4: TurnOnTuneInDropOut (small blind) folded before Flop
Seat 5: prashantshah (big blind) collected ($1000)
Seat 6: Prateek1986 folded before Flop (didn't bet)

PokerStars Hand #1957459653: Omaha Pot Limit ($500/$1000 USD) - 2020/10/23 14:23:23 ET
Table 'ADA540885739' 6-max Seat #4 is the button
Seat 3: slotmachine ($178328 in chips)
Seat 4: TurnOnTuneInDropOut ($104437 in chips)
Seat 5: prashantshah ($45759 in chips)
Seat 6: Prateek1986 ($39114 in chips)
prashantshah: posts small blind $500
Prateek1986: posts big blind $1000
*** HOLE CARDS ***
Dealt to TurnOnTuneInDropOut [6d Jc Qh 7s]
slotmachine: folds
TurnOnTuneInDropOut: folds
prashantshah: calls $500
Prateek1986: raises $2000 to $3000
prashantshah: folds
Uncalled bet ($2000) returned to Prateek1986
Prateek1986 collected $2000 from pot
Prateek1986: doesn't show hand
*** SUMMARY ***
Total pot $2000 | Rake $0
Seat 3: slotmachine folded before Flop (didn't bet)
Seat 4: TurnOnTuneInDropOut (button) folded before Flop (didn't bet)
Seat 5: prashantshah (small blind) folded before Flop
Seat 6: Prateek1986 (big blind) collected ($2000)

PokerStars Hand #1957459654: Omaha Pot Limit ($500/$1000 USD) - 2020/10/23 14:23:56 ET
Table 'ADA540885739' 6-max Seat #5 is the button
Seat 3: slotmachine ($178328 in chips)
Seat 4: TurnOnTuneInDropOut ($104437 in chips)
Seat 5: prashantshah ($44759 in chips)
Seat 6: Prateek1986 ($40114 in chips)
Prateek1986: posts small blind $500
slotmachine: posts big blind $1000
*** HOLE CARDS ***
Dealt to TurnOnTuneInDropOut [Kh 4d 7h 8h]
TurnOnTuneInDropOut: folds
prashantshah: folds
Prateek1986: folds
Uncalled bet ($500) returned to slotmachine
slotmachine collected $1000 from pot
slotmachine: doesn't show hand
*** SUMMARY ***
Total pot $1000 | Rake $0
Seat 3: slotmachine (big blind) collected ($1000)
Seat 4: TurnOnTuneInDropOut folded before Flop (didn't bet)
Seat 5: prashantshah (button) folded before Flop (didn't bet)
Seat 6: Prateek1986 (small blind) folded before Flop

PokerStars Hand #1957459657: Omaha Pot Limit ($500/$1000 USD) - 2020/10/23 14:26:21 ET
Table 'ADA540885739' 6-max Seat #4 is the button
Seat 3: slotmachine ($178328 in chips)
Seat 4: TurnOnTuneInDropOut ($105832 in chips)
Seat 5: prashantshah ($48488 in chips)
Seat 6: Prateek1986 ($34614 in chips)
prashantshah: posts small blind $500
Prateek1986: posts big blind $1000
*** HOLE CARDS ***
Dealt to TurnOnTuneInDropOut [Kd 8s Ac Kc]
slotmachine: folds
TurnOnTuneInDropOut: raises $2500 to $3500
prashantshah: folds
Prateek1986: folds
Uncalled bet ($2500) returned to TurnOnTuneInDropOut
TurnOnTuneInDropOut collected $2500 from pot
TurnOnTuneInDropOut: doesn't show hand
*** SUMMARY ***
Total pot $2500 | Rake $0
Seat 3: slotmachine folded before Flop (didn't bet)
Seat 4: TurnOnTuneInDropOut (button) collected ($2500)
Seat 5: prashantshah (small blind) folded before Flop
Seat 6: Prateek1986 (big blind) folded before Flop

PokerStars Hand #1957459658: Omaha Pot Limit ($500/$1000 USD) - 2020/10/23 14:26:39 ET
Table 'ADA540885739' 6-max Seat #5 is the button
Seat 3: slotmachine ($178328 in chips)
Seat 4: TurnOnTuneInDropOut ($107332 in chips)
Seat 5: prashantshah ($47988 in chips)
Seat 6: Prateek1986 ($33614 in chips)
Prateek1986: posts small blind $500
slotmachine: posts big blind $1000
*** HOLE CARDS ***
Dealt to TurnOnTuneInDropOut [As 5h 9h Js]
TurnOnTuneInDropOut: raises $2500 to $3500
prashantshah: folds
Prateek1986: calls $3000
slotmachine: folds
*** FLOP *** [Qs 3c 4c]
Prateek1986: checks
TurnOnTuneInDropOut: checks
*** TURN *** [Qs 3c 4c] [Ad]
Prateek1986: checks
TurnOnTuneInDropOut: bets $6000
Prateek1986: folds
Uncalled bet ($6000) returned to TurnOnTuneInDropOut
TurnOnTuneInDropOut collected $7759 from pot
TurnOnTuneInDropOut: doesn't show hand
*** SUMMARY ***
Total pot $8000 | Rake $241
Board [Qs 3c 4c Ad]
Seat 3: slotmachine (big blind) folded before Flop
Seat 4: TurnOnTuneInDropOut collected ($7759)
Seat 5: prashantshah (button) folded before Flop (didn't bet)
Seat 6: Prateek1986 (small blind) folded on the Turn

PokerStars Hand #1957459662: Omaha Pot Limit ($500/$1000 USD) - 2020/10/23 14:29:44 ET
Table 'ADA540885739' 6-max Seat #5 is the button
Seat 3: slotmachine ($178328 in chips)
Seat 4: TurnOnTuneInDropOut ($110091 in chips)
Seat 5: prashantshah ($45488 in chips)
Seat 6: Prateek1986 ($33039 in chips)
Prateek1986: posts small blind $500
slotmachine: posts big blind $1000
*** HOLE CARDS ***
Dealt to TurnOnTuneInDropOut [2s Tc 9c 5h]
TurnOnTuneInDropOut: folds
prashantshah: folds
Prateek1986: calls $500
slotmachine: raises $2000 to $3000
Prateek1986: calls $2000
*** FLOP *** [Qs 2h 7s]
Prateek1986: checks
slotmachine: bets $6000
Prateek1986: folds
Uncalled bet ($6000) returned to slotmachine
slotmachine collected $5819 from pot
slotmachine: doesn't show hand
*** SUMMARY ***
Total pot $6000 | Rake $181
Board [Qs 2h 7s]
Seat 3: slotmachine (big blind) collected ($5819)
Seat 4: TurnOnTuneInDropOut folded before Flop (didn't bet)
Seat 5: prashantshah (button) folded before Flop (didn't bet)
Seat 6: Prateek1986 (small blind) folded on the Flop

PokerStars Hand #1957459663: Omaha Pot Limit ($500/$1000 USD) - 2020/10/23 14:30:33 ET
Table 'ADA540885739' 6-max Seat #6 is the button
Seat 3: slotmachine ($181147 in chips)
Seat 4: TurnOnTuneInDropOut ($110091 in chips)
Seat 5: prashantshah ($45488 in chips)
Seat 6: Prateek1986 ($30039 in chips)
slotmachine: posts small blind $500
TurnOnTuneInDropOut: posts big blind $1000
*** HOLE CARDS ***
Dealt to TurnOnTuneInDropOut [7h Kc 2s Tc]
prashantshah: folds
Prateek1986: folds
slotmachine: raises $2000 to $3000
TurnOnTuneInDropOut: calls $2000
*** FLOP *** [4s 7d 4d]
slotmachine: bets $1980
TurnOnTuneInDropOut: raises $5401 to $7381
slotmachine: calls $5401
*** TURN *** [4s 7d 4d] [8c]
slotmachine: checks
TurnOnTuneInDropOut: checks
*** RIVER *** [4s 7d 4d 8c] [6c]
slotmachine: bets $10381
TurnOnTuneInDropOut: folds
Uncalled bet ($10381) returned to slotmachine
slotmachine collected $20137 from pot
slotmachine: doesn't show hand
*** SUMMARY ***
Total pot $20762 | Rake $625
Board [4s 7d 4d 8c 6c]
Seat 3: slotmachine (small blind) collected ($20137)
Seat 4: TurnOnTuneInDropOut (big blind) folded on the River
Seat 5: prashantshah folded before Flop (didn't bet)
Seat 6: Prateek1986 (button) folded before Flop (didn't bet)

PokerStars Hand #1957459666: Omaha Pot Limit ($500/$1000 USD) - 2020/10/23 14:32:40 ET
Table 'ADA540885739' 6-max Seat #5 is the button
Seat 3: slotmachine ($192403 in chips)
Seat 4: TurnOnTuneInDropOut ($99210 in chips)
Seat 5: prashantshah ($43988 in chips)
Seat 6: Prateek1986 ($30464 in chips)
Prateek1986: posts small blind $500
slotmachine: posts big blind $1000
*** HOLE CARDS ***
Dealt to TurnOnTuneInDropOut [Ks 8s 5h Kd]
TurnOnTuneInDropOut: raises $2500 to $3500
prashantshah: folds
Prateek1986: calls $3000
slotmachine: folds
*** FLOP *** [9h 2d Th]
Prateek1986: checks
TurnOnTuneInDropOut: checks
*** TURN *** [9h 2d Th] [Js]
Prateek1986: checks
TurnOnTuneInDropOut: bets $6000
Prateek1986: folds
Uncalled bet ($6000) returned to TurnOnTuneInDropOut
TurnOnTuneInDropOut collected $7759 from pot
TurnOnTuneInDropOut: doesn't show hand
*** SUMMARY ***
Total pot $8000 | Rake $241
Board [9h 2d Th Js]
Seat 3: slotmachine (big blind) folded before Flop
Seat 4: TurnOnTuneInDropOut collected ($7759)
Seat 5: prashantshah (button) folded before Flop (didn't bet)
Seat 6: Prateek1986 (small blind) folded on the Turn

PokerStars Hand #1957459667: Omaha Pot Limit ($500/$1000 USD) - 2020/10/23 14:33:41 ET
Table 'ADA540885739' 6-max Seat #6 is the button
Seat 3: slotmachine ($191403 in chips)
Seat 4: TurnOnTuneInDropOut ($103469 in chips)
Seat 5: prashantshah ($43988 in chips)
Seat 6: Prateek1986 ($26964 in chips)
slotmachine: posts small blind $500
TurnOnTuneInDropOut: posts big blind $1000
*** HOLE CARDS ***
Dealt to TurnOnTuneInDropOut [8c 7s Kd 8s]
prashantshah: folds
Prateek1986: folds
slotmachine: folds
Uncalled bet ($500) returned to TurnOnTuneInDropOut
TurnOnTuneInDropOut collected $1000 from pot
TurnOnTuneInDropOut: doesn't show hand
*** SUMMARY ***
Total pot $1000 | Rake $0
Seat 3: slotmachine (small blind) folded before Flop
Seat 4: TurnOnTuneInDropOut (big blind) collected ($1000)
Seat 5: prashantshah folded before Flop (didn't bet)
Seat 6: Prateek1986 (button) folded before Flop (didn't bet)

PokerStars Hand #1957459670: Omaha Pot Limit ($500/$1000 USD) - 2020/10/23 14:35:42 ET
Table 'ADA540885739' 6-max Seat #5 is the button
Seat 3: slotmachine ($195647 in chips)
Seat 4: TurnOnTuneInDropOut ($99969 in chips)
Seat 5: prashantshah ($42488 in chips)
Seat 6: Prateek1986 ($27389 in chips)
Prateek1986: posts small blind $500
slotmachine: posts big blind $1000
*** HOLE CARDS ***
Dealt to TurnOnTuneInDropOut [Jc 8c Jd 3d]
TurnOnTuneInDropOut: raises $2500 to $3500
prashantshah: folds
Prateek1986: folds
slotmachine: calls $2500
*** FLOP *** [9s 4d Js]
slotmachine: checks
TurnOnTuneInDropOut: bets $5625
slotmachine: calls $5625
*** TURN *** [9s 4d Js] [4c]
slotmachine: checks
TurnOnTuneInDropOut: bets $12375
slotmachine: calls $12375
*** RIVER *** [9s 4d Js 4c] [7h]
slotmachine: checks
TurnOnTuneInDropOut: bets $43500
slotmachine: folds
Uncalled bet ($43500) returned to TurnOnTuneInDropOut
TurnOnTuneInDropOut collected $42191 from pot
TurnOnTuneInDropOut: doesn't show hand
*** SUMMARY ***
Total pot $43500 | Rake $1309
Board [9s 4d Js 4c 7h]
Seat 3: slotmachine (big blind) folded on the River
Seat 4: TurnOnTuneInDropOut collected ($42191)
Seat 5: prashantshah (button) folded before Flop (didn't bet)
Seat 6: Prateek1986 (small blind) folded before Flop

PokerStars Hand #1957459671: Omaha Pot Limit ($500/$1000 USD) - 2020/10/23 14:37:32 ET
Table 'ADA540885739' 6-max Seat #6 is the button
Seat 3: slotmachine ($174147 in chips)
Seat 4: TurnOnTuneInDropOut ($120660 in chips)
Seat 5: prashantshah ($42488 in chips)
Seat 6: Prateek1986 ($26889 in chips)
slotmachine: posts small blind $500
TurnOnTuneInDropOut: posts big blind $1000
*** HOLE CARDS ***
Dealt to TurnOnTuneInDropOut [Ac Tc Ad As]
prashantshah: folds
Prateek1986: raises $2500 to $3500
slotmachine: folds
TurnOnTuneInDropOut: raises $7500 to $11000
Prateek1986: calls $7500
*** FLOP *** [7d 5c Td]
TurnOnTuneInDropOut: bets $22500
Prateek1986: calls $15889 and is all-in
Uncalled bet ($6611) returned to TurnOnTuneInDropOut
*** TURN *** [7d 5c Td] [2c]
*** RIVER *** [7d 5c Td 2c] [9c]
*** SHOW DOWN ***
TurnOnTuneInDropOut: shows [Ac Tc Ad As]
Prateek1986: shows [Qd 3s 4c Qc]
TurnOnTuneInDropOut collected $52879 from pot
*** SUMMARY ***
Total pot $54278 | Rake $1399
Board [7d 5c Td 2c 9c]
Seat 3: slotmachine (small blind) folded before Flop
Seat 4: TurnOnTuneInDropOut (big blind) showed [Ac Tc Ad As] and won ($52879)
Seat 5: prashantshah folded before Flop (didn't bet)
Seat 6: Prateek1986 (button) showed [Qd 3s 4c Qc] and lost

PokerStars Hand #1957459672: Omaha Pot Limit ($500/$1000 USD) - 2020/10/23 14:38:20 ET
Table 'ADA540885739' 6-max Seat #3 is the button
Seat 3: slotmachine ($173647 in chips)
Seat 4: TurnOnTuneInDropOut ($146650 in chips)
Seat 5: prashantshah ($42488 in chips)
TurnOnTuneInDropOut: posts small blind $500
prashantshah: posts big blind $1000
*** HOLE CARDS ***
Dealt to TurnOnTuneInDropOut [5c As 7c 2d]
slotmachine: folds
TurnOnTuneInDropOut: folds
Uncalled bet ($500) returned to prashantshah
prashantshah collected $1000 from pot
prashantshah: doesn't show hand
*** SUMMARY ***
Total pot $1000 | Rake $0
Seat 3: slotmachine (button) folded before Flop (didn't bet)
Seat 4: TurnOnTuneInDropOut (small blind) folded before Flop
Seat 5: prashantshah (big blind) collected ($1000)

PokerStars Hand #1957459673: Omaha Pot Limit ($500/$1000 USD) - 2020/10/23 14:38:34 ET
Table 'ADA540885739' 6-max Seat #4 is the button
Seat 1: terminator369 ($30000 in chips)
Seat 3: slotmachine ($173647 in chips)
Seat 4: TurnOnTuneInDropOut ($146150 in chips)
Seat 5: prashantshah ($42988 in chips)
prashantshah: posts small blind $500
terminator369: posts big blind $1000
*** HOLE CARDS ***
Dealt to TurnOnTuneInDropOut [4h Qs Jc 3c]
slotmachine: folds
TurnOnTuneInDropOut: folds
prashantshah: calls $500
terminator369: raises $2000 to $3000
prashantshah: folds
Uncalled bet ($2000) returned to terminator369
terminator369 collected $2000 from pot
terminator369: doesn't show hand
*** SUMMARY ***
Total pot $2000 | Rake $0
Seat 1: terminator369 (big blind) collected ($2000)
Seat 3: slotmachine folded before Flop (didn't bet)
Seat 4: TurnOnTuneInDropOut (button) folded before Flop (didn't bet)
Seat 5: prashantshah (small blind) folded before Flop

PokerStars Hand #1957459674: Omaha Pot Limit ($500/$1000 USD) - 2020/10/23 14:39:03 ET
Table 'ADA540885739' 6-max Seat #5 is the button
Seat 1: terminator369 ($31000 in chips)
Seat 3: slotmachine ($173647 in chips)
Seat 4: TurnOnTuneInDropOut ($146150 in chips)
Seat 5: prashantshah ($41988 in chips)
terminator369: posts small blind $500
slotmachine: posts big blind $1000
*** HOLE CARDS ***
Dealt to TurnOnTuneInDropOut [9s 8s Jc Kd]
TurnOnTuneInDropOut: raises $2500 to $3500
prashantshah: folds
terminator369: folds
slotmachine: folds
Uncalled bet ($2500) returned to TurnOnTuneInDropOut
TurnOnTuneInDropOut collected $2500 from pot
TurnOnTuneInDropOut: doesn't show hand
*** SUMMARY ***
Total pot $2500 | Rake $0
Seat 1: terminator369 (small blind) folded before Flop
Seat 3: slotmachine (big blind) folded before Flop
Seat 4: TurnOnTuneInDropOut collected ($2500)
Seat 5: prashantshah (button) folded before Flop (didn't bet)

PokerStars Hand #1255059641: Omaha Pot Limit ($200/$400 USD) - 2020/10/23 12:24:37 ET
Table 'ADA675920511' 6-max Seat #4 is the button
Seat 1: PokerMessi ($57050 in chips)
Seat 2: TurnOnTuneInDropOut ($29400 in chips)
Seat 3: slotmachine ($54021 in chips)
Seat 4: rajan2017 ($9360 in chips)
Seat 6: soundfsilenz ($39186 in chips)
soundfsilenz: posts small blind $200
PokerMessi: posts big blind $400
*** HOLE CARDS ***
Dealt to TurnOnTuneInDropOut [Qs 5d Jd Ks]
TurnOnTuneInDropOut: raises $1000 to $1400
slotmachine: folds
rajan2017: raises $3400 to $4800
soundfsilenz: folds
PokerMessi: folds
TurnOnTuneInDropOut: raises $10200 to $15000
rajan2017: calls $4560 and is all-in
Uncalled bet ($5640) returned to TurnOnTuneInDropOut
*** FLOP *** [2d Kc 7s]
*** TURN *** [2d Kc 7s] [2h]
*** RIVER *** [2d Kc 7s 2h] [6s]
*** SHOW DOWN ***
TurnOnTuneInDropOut: shows [Qs 5d Jd Ks]
rajan2017: shows [Jc 9d Kd 7c]
rajan2017 collected $18545 from pot
*** SUMMARY ***
Total pot $19320 | Rake $775
Board [2d Kc 7s 2h 6s]
Seat 1: PokerMessi (big blind) folded before Flop
Seat 2: TurnOnTuneInDropOut showed [Qs 5d Jd Ks] and lost
Seat 3: slotmachine folded before Flop (didn't bet)
Seat 4: rajan2017 (button) showed [Jc 9d Kd 7c] and won ($18545)
Seat 6: soundfsilenz (small blind) folded before Flop

PokerStars Hand #1255059682: Omaha Pot Limit ($200/$400 USD) - 2020/10/23 13:24:34 ET
Table 'ADA675920511' 6-max Seat #1 is the button
Seat 1: harshb_95 ($13480 in chips)
Seat 2: vaibz16 ($22100 in chips)
Seat 4: TurnOnTuneInDropOut ($30000 in chips)
vaibz16: posts small blind $200
TurnOnTuneInDropOut: posts big blind $400
*** HOLE CARDS ***
Dealt to TurnOnTuneInDropOut [As Ts 8c Kh]
harshb_95: raises $1000 to $1400
vaibz16: folds
TurnOnTuneInDropOut: raises $3000 to $4400
harshb_95: calls $3000
*** FLOP *** [6c 7d Ad]
TurnOnTuneInDropOut: bets $9000
harshb_95: raises $80 to $9080 and is all-in
TurnOnTuneInDropOut: calls $80
*** TURN *** [6c 7d Ad] [Qc]
*** RIVER *** [6c 7d Ad Qc] [Qs]
*** SHOW DOWN ***
TurnOnTuneInDropOut: shows [As Ts 8c Kh]
harshb_95: shows [8d Jd Jc Kc]
TurnOnTuneInDropOut collected $26460 from pot
*** SUMMARY ***
Total pot $27160 | Rake $700
Board [6c 7d Ad Qc Qs]
Seat 1: harshb_95 (button) showed [8d Jd Jc Kc] and lost
Seat 2: vaibz16 (small blind) folded before Flop
Seat 4: TurnOnTuneInDropOut (big blind) showed [As Ts 8c Kh] and won ($26460)

PokerStars Hand #1255059688: Omaha Pot Limit ($200/$400 USD) - 2020/10/23 13:28:01 ET
Table 'ADA675920511' 6-max Seat #1 is the button
Seat 1: harshb_95 ($11400 in chips)
Seat 2: gaganhyd ($19824 in chips)
Seat 4: TurnOnTuneInDropOut ($42780 in chips)
Seat 5: kimjongun ($42600 in chips)
Seat 6: karanchawla09 ($28905 in chips)
gaganhyd: posts small blind $200
TurnOnTuneInDropOut: posts big blind $400
karanchawla09: posts big blind $400
*** HOLE CARDS ***
Dealt to TurnOnTuneInDropOut [7c 5c Td Th]
kimjongun: folds
karanchawla09: raises $1000 to $1400
harshb_95: calls $1400
gaganhyd: folds
TurnOnTuneInDropOut: folds
*** FLOP *** [8c 8h 6c]
karanchawla09: checks
harshb_95: bets $3400
karanchawla09: raises $10200 to $13600
harshb_95: calls $6600 and is all-in
Uncalled bet ($3600) returned to karanchawla09
*** TURN *** [8c 8h 6c] [2d]
*** RIVER *** [8c 8h 6c 2d] [2h]
*** SHOW DOWN ***
karanchawla09: shows [4c Jh 3c 6s]
harshb_95: shows [Kd 7d 8s Ts]
harshb_95 collected $22600 from pot
*** SUMMARY ***
Total pot $23400 | Rake $800
Board [8c 8h 6c 2d 2h]
Seat 1: harshb_95 (button) showed [Kd 7d 8s Ts] and won ($22600)
Seat 2: gaganhyd (small blind) folded before Flop
Seat 4: TurnOnTuneInDropOut (big blind) folded before Flop
Seat 5: kimjongun folded before Flop (didn't bet)
Seat 6: karanchawla09 showed [4c Jh 3c 6s] and lost

PokerStars Hand #1255059689: Omaha Pot Limit ($200/$400 USD) - 2020/10/23 13:28:25 ET
Table 'ADA675920511' 6-max Seat #2 is the button
Seat 1: harshb_95 ($22600 in chips)
Seat 2: gaganhyd ($19624 in chips)
Seat 4: TurnOnTuneInDropOut ($42380 in chips)
Seat 5: kimjongun ($42600 in chips)
Seat 6: karanchawla09 ($17505 in chips)
TurnOnTuneInDropOut: posts small blind $200
kimjongun: posts big blind $400
*** HOLE CARDS ***
Dealt to TurnOnTuneInDropOut [3c Th Ah 2h]
karanchawla09: raises $1000 to $1400
harshb_95: folds
gaganhyd: folds
TurnOnTuneInDropOut: folds
kimjongun: calls $1000
*** FLOP *** [5s Kc Kh]
kimjongun: checks
karanchawla09: checks
*** TURN *** [5s Kc Kh] [8s]
kimjongun: bets $1050
karanchawla09: calls $1050
*** RIVER *** [5s Kc Kh 8s] [2d]
kimjongun: bets $2550
karanchawla09: calls $2550
*** SHOW DOWN ***
kimjongun: mucks hand
karanchawla09: shows [4d 9d 9s As]
karanchawla09 collected $9791 from pot
*** SUMMARY ***
Total pot $10200 | Rake $409
Board [5s Kc Kh 8s 2d]
Seat 1: harshb_95 folded before Flop (didn't bet)
Seat 2: gaganhyd (button) folded before Flop (didn't bet)
Seat 4: TurnOnTuneInDropOut (small blind) folded before Flop
Seat 5: kimjongun (big blind) mucked
Seat 6: karanchawla09 showed [4d 9d 9s As] and won ($9791)

PokerStars Hand #1255059691: Omaha Pot Limit ($200/$400 USD) - 2020/10/23 13:30:15 ET
Table 'ADA675920511' 6-max Seat #5 is the button
Seat 1: harshb_95 ($21000 in chips)
Seat 2: gaganhyd ($19624 in chips)
Seat 4: TurnOnTuneInDropOut ($42180 in chips)
Seat 5: kimjongun ($60696 in chips)
harshb_95: posts small blind $200
gaganhyd: posts big blind $400
*** HOLE CARDS ***
Dealt to TurnOnTuneInDropOut [Ts Ah Kc Tc]
TurnOnTuneInDropOut: raises $1000 to $1400
kimjongun: folds
harshb_95: folds
gaganhyd: folds
Uncalled bet ($1000) returned to TurnOnTuneInDropOut
TurnOnTuneInDropOut collected $1000 from pot
TurnOnTuneInDropOut: doesn't show hand
*** SUMMARY ***
Total pot $1000 | Rake $0
Seat 1: harshb_95 (small blind) folded before Flop
Seat 2: gaganhyd (big blind) folded before Flop
Seat 4: TurnOnTuneInDropOut collected ($1000)
Seat 5: kimjongun (button) folded before Flop (didn't bet)

PokerStars Hand #1255059692: Omaha Pot Limit ($200/$400 USD) - 2020/10/23 13:30:30 ET
Table 'ADA675920511' 6-max Seat #1 is the button
Seat 1: harshb_95 ($20800 in chips)
Seat 2: gaganhyd ($19224 in chips)
Seat 4: TurnOnTuneInDropOut ($42780 in chips)
Seat 5: kimjongun ($60696 in chips)
gaganhyd: posts small blind $200
TurnOnTuneInDropOut: posts big blind $400
*** HOLE CARDS ***
Dealt to TurnOnTuneInDropOut [7c Kd Ah 6c]
kimjongun: folds
harshb_95: raises $650 to $1050
gaganhyd: folds
TurnOnTuneInDropOut: calls $650
*** FLOP *** [5h 3d Ts]
TurnOnTuneInDropOut: checks
harshb_95: bets $1725
TurnOnTuneInDropOut: raises $3882 to $5607
harshb_95: raises $13514 to $19121
TurnOnTuneInDropOut: folds
Uncalled bet ($13514) returned to harshb_95
harshb_95 collected $12972 from pot
harshb_95: doesn't show hand
*** SUMMARY ***
Total pot $13514 | Rake $542
Board [5h 3d Ts]
Seat 1: harshb_95 (button) collected ($12972)
Seat 2: gaganhyd (small blind) folded before Flop
Seat 4: TurnOnTuneInDropOut (big blind) folded on the Flop
Seat 5: kimjongun folded before Flop (didn't bet)

PokerStars Hand #1255059693: Omaha Pot Limit ($200/$400 USD) - 2020/10/23 13:30:59 ET
Table 'ADA675920511' 6-max Seat #2 is the button
Seat 1: harshb_95 ($27115 in chips)
Seat 2: gaganhyd ($19024 in chips)
Seat 4: TurnOnTuneInDropOut ($36123 in chips)
Seat 5: kimjongun ($60696 in chips)
TurnOnTuneInDropOut: posts small blind $200
kimjongun: posts big blind $400
*** HOLE CARDS ***
Dealt to TurnOnTuneInDropOut [9c Ah Kh Jc]
harshb_95: folds
gaganhyd: folds
TurnOnTuneInDropOut: raises $800 to $1200
kimjongun: calls $800
*** FLOP *** [8h 4c 7d]
TurnOnTuneInDropOut: checks
kimjongun: checks
*** TURN *** [8h 4c 7d] [Jd]
TurnOnTuneInDropOut: bets $2400
kimjongun: folds
Uncalled bet ($2400) returned to TurnOnTuneInDropOut
TurnOnTuneInDropOut collected $2304 from pot
TurnOnTuneInDropOut: doesn't show hand
*** SUMMARY ***
Total pot $2400 | Rake $96
Board [8h 4c 7d Jd]
Seat 1: harshb_95 folded before Flop (didn't bet)
Seat 2: gaganhyd (button) folded before Flop (didn't bet)
Seat 4: TurnOnTuneInDropOut (small blind) collected ($2304)
Seat 5: kimjongun (big blind) folded on the Turn

PokerStars Hand #1255059694: Omaha Pot Limit ($200/$400 USD) - 2020/10/23 13:31:50 ET
Table 'ADA675920511' 6-max Seat #4 is the button
Seat 1: harshb_95 ($27115 in chips)
Seat 2: gaganhyd ($19024 in chips)
Seat 4: TurnOnTuneInDropOut ($37227 in chips)
Seat 5: kimjongun ($59496 in chips)
kimjongun: posts small blind $200
harshb_95: posts big blind $400
*** HOLE CARDS ***
Dealt to TurnOnTuneInDropOut [Jd Th Qs 3h]
gaganhyd: raises $400 to $800
TurnOnTuneInDropOut: folds
kimjongun: folds
harshb_95: calls $400
*** FLOP *** [2s Jh Ts]
harshb_95: checks
gaganhyd: bets $900
harshb_95: folds
Uncalled bet ($900) returned to gaganhyd
gaganhyd collected $1728 from pot
gaganhyd: doesn't show hand
*** SUMMARY ***
Total pot $1800 | Rake $72
Board [2s Jh Ts]
Seat 1: harshb_95 (big blind) folded on the Flop
Seat 2: gaganhyd collected ($1728)
Seat 4: TurnOnTuneInDropOut (button) folded before Flop (didn't bet)
Seat 5: kimjongun (small blind) folded before Flop

PokerStars Hand #1255059695: Omaha Pot Limit ($200/$400 USD) - 2020/10/23 13:32:37 ET
Table 'ADA675920511' 6-max Seat #5 is the button
Seat 1: harshb_95 ($26315 in chips)
Seat 2: gaganhyd ($19952 in chips)
Seat 4: TurnOnTuneInDropOut ($37227 in chips)
Seat 5: kimjongun ($59296 in chips)
harshb_95: posts small blind $200
gaganhyd: posts big blind $400
*** HOLE CARDS ***
Dealt to TurnOnTuneInDropOut [6d 2h 6c 2d]
TurnOnTuneInDropOut: raises $1000 to $1400
kimjongun: calls $1400
harshb_95: folds
gaganhyd: folds
*** FLOP *** [5s 9h 8h]
TurnOnTuneInDropOut: checks
kimjongun: checks
*** TURN *** [5s 9h 8h] [Kd]
TurnOnTuneInDropOut: bets $3400
kimjongun: folds
Uncalled bet ($3400) returned to TurnOnTuneInDropOut
TurnOnTuneInDropOut collected $3264 from pot
TurnOnTuneInDropOut: doesn't show hand
*** SUMMARY ***
Total pot $3400 | Rake $136
Board [5s 9h 8h Kd]
Seat 1: harshb_95 (small blind) folded before Flop
Seat 2: gaganhyd (big blind) folded before Flop
Seat 4: TurnOnTuneInDropOut collected ($3264)
Seat 5: kimjongun (button) folded on the Turn

PokerStars Hand #1255059696: Omaha Pot Limit ($200/$400 USD) - 2020/10/23 13:33:19 ET
Table 'ADA675920511' 6-max Seat #1 is the button
Seat 1: harshb_95 ($26115 in chips)
Seat 2: gaganhyd ($19552 in chips)
Seat 4: TurnOnTuneInDropOut ($39091 in chips)
Seat 5: kimjongun ($57896 in chips)
gaganhyd: posts small blind $200
TurnOnTuneInDropOut: posts big blind $400
*** HOLE CARDS ***
Dealt to TurnOnTuneInDropOut [2c 3c 9d 2h]
kimjongun: folds
harshb_95: folds
gaganhyd: folds
Uncalled bet ($200) returned to TurnOnTuneInDropOut
TurnOnTuneInDropOut collected $400 from pot
TurnOnTuneInDropOut: doesn't show hand
*** SUMMARY ***
Total pot $400 | Rake $0
Seat 1: harshb_95 (button) folded before Flop (didn't bet)
Seat 2: gaganhyd (small blind) folded before Flop
Seat 4: TurnOnTuneInDropOut (big blind) collected ($400)
Seat 5: kimjongun folded before Flop (didn't bet)

PokerStars Hand #1255059697: Omaha Pot Limit ($200/$400 USD) - 2020/10/23 13:33:59 ET
Table 'ADA675920511' 6-max Seat #2 is the button
Seat 1: harshb_95 ($26115 in chips)
Seat 2: gaganhyd ($19352 in chips)
Seat 4: TurnOnTuneInDropOut ($39291 in chips)
Seat 5: kimjongun ($57896 in chips)
TurnOnTuneInDropOut: posts small blind $200
kimjongun: posts big blind $400
*** HOLE CARDS ***
Dealt to TurnOnTuneInDropOut [4h Ks 3c 3d]
harshb_95: raises $1000 to $1400
gaganhyd: folds
TurnOnTuneInDropOut: folds
kimjongun: calls $1000
*** FLOP *** [8d 7h 2s]
kimjongun: bets $2250
harshb_95: raises $2250 to $4500
kimjongun: calls $2250
*** TURN *** [8d 7h 2s] [3s]
kimjongun: checks
harshb_95: bets $12000
kimjongun: raises $12000 to $24000
harshb_95: calls $8215 and is all-in
Uncalled bet ($3785) returned to kimjongun
*** RIVER *** [8d 7h 2s 3s] [Kc]
*** SHOW DOWN ***
kimjongun: shows [7d Qd Td Ts]
harshb_95: shows [Th 7c 7s 9h]
harshb_95 collected $51630 from pot
*** SUMMARY ***
Total pot $52430 | Rake $800
Board [8d 7h 2s 3s Kc]
Seat 1: harshb_95 showed [Th 7c 7s 9h] and won ($51630)
Seat 2: gaganhyd (button) folded before Flop (didn't bet)
Seat 4: TurnOnTuneInDropOut (small blind) folded before Flop
Seat 5: kimjongun (big blind) showed [7d Qd Td Ts] and lost

PokerStars Hand #1255059699: Omaha Pot Limit ($200/$400 USD) - 2020/10/23 13:35:36 ET
Table 'ADA675920511' 6-max Seat #5 is the button
Seat 1: harshb_95 ($51630 in chips)
Seat 2: gaganhyd ($19352 in chips)
Seat 4: TurnOnTuneInDropOut ($37691 in chips)
Seat 5: kimjongun ($31581 in chips)
Seat 6: Sam565 ($13600 in chips)
Sam565: posts small blind $200
harshb_95: posts big blind $400
*** HOLE CARDS ***
Dealt to TurnOnTuneInDropOut [7s Tc 7c 3s]
gaganhyd: folds
TurnOnTuneInDropOut: raises $1000 to $1400
kimjongun: calls $1400
Sam565: calls $1200
harshb_95: folds
*** FLOP *** [Ah 2h 5c]
Sam565: bets $4600
TurnOnTuneInDropOut: folds
kimjongun: folds
Uncalled bet ($4600) returned to Sam565
Sam565 collected $4416 from pot
Sam565: doesn't show hand
*** SUMMARY ***
Total pot $4600 | Rake $184
Board [Ah 2h 5c]
Seat 1: harshb_95 (big blind) folded before Flop
Seat 2: gaganhyd folded before Flop (didn't bet)
Seat 4: TurnOnTuneInDropOut folded on the Flop
Seat 5: kimjongun (button) folded on the Flop
Seat 6: Sam565 (small blind) collected ($4416)

PokerStars Hand #1255059700: Omaha Pot Limit ($200/$400 USD) - 2020/10/23 13:36:15 ET
Table 'ADA675920511' 6-max Seat #6 is the button
Seat 1: harshb_95 ($51230 in chips)
Seat 2: gaganhyd ($19352 in chips)
Seat 4: TurnOnTuneInDropOut ($48000 in chips)
Seat 5: kimjongun ($30181 in chips)
Seat 6: Sam565 ($16616 in chips)
harshb_95: posts small blind $200
gaganhyd: posts big blind $400
*** HOLE CARDS ***
Dealt to TurnOnTuneInDropOut [6c 5c 8d 9s]
TurnOnTuneInDropOut: folds
kimjongun: folds
Sam565: folds
harshb_95: folds
Uncalled bet ($200) returned to gaganhyd
gaganhyd collected $400 from pot
gaganhyd: doesn't show hand
*** SUMMARY ***
Total pot $400 | Rake $0
Seat 1: harshb_95 (small blind) folded before Flop
Seat 2: gaganhyd (big blind) collected ($400)
Seat 4: TurnOnTuneInDropOut folded before Flop (didn't bet)
Seat 5: kimjongun folded before Flop (didn't bet)
Seat 6: Sam565 (button) folded before Flop (didn't bet)

PokerStars Hand #1255059701: Omaha Pot Limit ($200/$400 USD) - 2020/10/23 13:36:29 ET
Table 'ADA675920511' 6-max Seat #1 is the button
Seat 1: harshb_95 ($51030 in chips)
Seat 2: gaganhyd ($19552 in chips)
Seat 3: slotmachine ($28231 in chips)
Seat 4: TurnOnTuneInDropOut ($48000 in chips)
Seat 5: kimjongun ($30181 in chips)
Seat 6: Sam565 ($16616 in chips)
gaganhyd: posts small blind $200
slotmachine: posts big blind $400
*** HOLE CARDS ***
Dealt to TurnOnTuneInDropOut [Jd 6d 2c 6h]
TurnOnTuneInDropOut: folds
kimjongun: folds
Sam565: folds
harshb_95: folds
gaganhyd: raises $800 to $1200
slotmachine: calls $800
*** FLOP *** [7c 5d 5s]
gaganhyd: checks
slotmachine: checks
*** TURN *** [7c 5d 5s] [5h]
gaganhyd: bets $1200
slotmachine: folds
Uncalled bet ($1200) returned to gaganhyd
gaganhyd collected $2304 from pot
gaganhyd: doesn't show hand
*** SUMMARY ***
Total pot $2400 | Rake $96
Board [7c 5d 5s 5h]
Seat 1: harshb_95 (button) folded before Flop (didn't bet)
Seat 2: gaganhyd (small blind) collected ($2304)
Seat 3: slotmachine (big blind) folded on the Turn
Seat 4: TurnOnTuneInDropOut folded before Flop (didn't bet)
Seat 5: kimjongun folded before Flop (didn't bet)
Seat 6: Sam565 folded before Flop (didn't bet)

PokerStars Hand #1255059704: Omaha Pot Limit ($200/$400 USD) - 2020/10/23 13:39:08 ET
Table 'ADA675920511' 6-max Seat #4 is the button
Seat 1: harshb_95 ($51590 in chips)
Seat 2: gaganhyd ($20656 in chips)
Seat 3: slotmachine ($48000 in chips)
Seat 4: TurnOnTuneInDropOut ($46740 in chips)
Seat 5: kimjongun ($29781 in chips)
Seat 6: Sam565 ($17783 in chips)
kimjongun: posts small blind $200
Sam565: posts big blind $400
*** HOLE CARDS ***
Dealt to TurnOnTuneInDropOut [Jh Ts Qs Td]
harshb_95: folds
gaganhyd: folds
slotmachine: folds
TurnOnTuneInDropOut: raises $1000 to $1400
kimjongun: folds
Sam565: folds
Uncalled bet ($1000) returned to TurnOnTuneInDropOut
TurnOnTuneInDropOut collected $1000 from pot
TurnOnTuneInDropOut: doesn't show hand
*** SUMMARY ***
Total pot $1000 | Rake $0
Seat 1: harshb_95 folded before Flop (didn't bet)
Seat 2: gaganhyd folded before Flop (didn't bet)
Seat 3: slotmachine folded before Flop (didn't bet)
Seat 4: TurnOnTuneInDropOut (button) collected ($1000)
Seat 5: kimjongun (small blind) folded before Flop
Seat 6: Sam565 (big blind) folded before Flop

PokerStars Hand #1255059705: Omaha Pot Limit ($200/$400 USD) - 2020/10/23 13:39:27 ET
Table 'ADA675920511' 6-max Seat #5 is the button
Seat 1: harshb_95 ($51590 in chips)
Seat 2: gaganhyd ($20656 in chips)
Seat 3: slotmachine ($48000 in chips)
Seat 4: TurnOnTuneInDropOut ($47340 in chips)
Seat 5: kimjongun ($29581 in chips)
Seat 6: Sam565 ($17383 in chips)
Sam565: posts small blind $200
harshb_95: posts big blind $400
*** HOLE CARDS ***
Dealt to TurnOnTuneInDropOut [Tc 7d Ts 3d]
gaganhyd: folds
slotmachine: folds
TurnOnTuneInDropOut: folds
kimjongun: folds
Sam565: calls $200
harshb_95: raises $600 to $1000
Sam565: calls $600
*** FLOP *** [8c 4s 2s]
Sam565: checks
harshb_95: bets $1000
Sam565: calls $1000
*** TURN *** [8c 4s 2s] [5s]
Sam565: checks
harshb_95: checks
*** RIVER *** [8c 4s 2s 5s] [2d]
Sam565: checks
harshb_95: checks
*** SHOW DOWN ***
Sam565: shows [6s 5h 8d Qh]
harshb_95: shows [Qc Th 7c Js]
Sam565 collected $3840 from pot
*** SUMMARY ***
Total pot $4000 | Rake $160
Board [8c 4s 2s 5s 2d]
Seat 1: harshb_95 (big blind) showed [Qc Th 7c Js] and lost
Seat 2: gaganhyd folded before Flop (didn't bet)
Seat 3: slotmachine folded before Flop (didn't bet)
Seat 4: TurnOnTuneInDropOut folded before Flop (didn't bet)
Seat 5: kimjongun (button) folded before Flop (didn't bet)
Seat 6: Sam565 (small blind) showed [6s 5h 8d Qh] and won ($3840)

PokerStars Hand #1255059706: Omaha Pot Limit ($200/$400 USD) - 2020/10/23 13:40:21 ET
Table 'ADA675920511' 6-max Seat #6 is the button
Seat 1: harshb_95 ($49590 in chips)
Seat 2: gaganhyd ($20656 in chips)
Seat 3: slotmachine ($48000 in chips)
Seat 4: TurnOnTuneInDropOut ($47340 in chips)
Seat 5: kimjongun ($29581 in chips)
Seat 6: Sam565 ($19223 in chips)
harshb_95: posts small blind $200
gaganhyd: posts big blind $400
*** HOLE CARDS ***
Dealt to TurnOnTuneInDropOut [Th 8c 3c Tc]
slotmachine: folds
TurnOnTuneInDropOut: folds
kimjongun: folds
Sam565: folds
harshb_95: folds
Uncalled bet ($200) returned to gaganhyd
gaganhyd collected $400 from pot
gaganhyd: doesn't show hand
*** SUMMARY ***
Total pot $400 | Rake $0
Seat 1: harshb_95 (small blind) folded before Flop
Seat 2: gaganhyd (big blind) collected ($400)
Seat 3: slotmachine folded before Flop (didn't bet)
Seat 4: TurnOnTuneInDropOut folded before Flop (didn't bet)
Seat 5: kimjongun folded before Flop (didn't bet)
Seat 6: Sam565 (button) folded before Flop (didn't bet)

PokerStars Hand #1255059707: Omaha Pot Limit ($200/$400 USD) - 2020/10/23 13:40:52 ET
Table 'ADA675920511' 6-max Seat #2 is the button
Seat 2: gaganhyd ($20856 in chips)
Seat 3: slotmachine ($48000 in chips)
Seat 4: TurnOnTuneInDropOut ($47340 in chips)
Seat 5: kimjongun ($29581 in chips)
Seat 6: Sam565 ($19223 in chips)
slotmachine: posts small blind $200
TurnOnTuneInDropOut: posts big blind $400
*** HOLE CARDS ***
Dealt to TurnOnTuneInDropOut [Jc Js 7h 7d]
kimjongun: folds
Sam565: folds
gaganhyd: folds
slotmachine: folds
Uncalled bet ($200) returned to TurnOnTuneInDropOut
TurnOnTuneInDropOut collected $400 from pot
TurnOnTuneInDropOut: doesn't show hand
*** SUMMARY ***
Total pot $400 | Rake $0
Seat 2: gaganhyd (button) folded before Flop (didn't bet)
Seat 3: slotmachine (small blind) folded before Flop
Seat 4: TurnOnTuneInDropOut (big blind) collected ($400)
Seat 5: kimjongun folded before Flop (didn't bet)
Seat 6: Sam565 folded before Flop (didn't bet)

PokerStars Hand #1255059709: Omaha Pot Limit ($200/$400 USD) - 2020/10/23 13:42:22 ET
Table 'ADA675920511' 6-max Seat #4 is the button
Seat 2: gaganhyd ($20856 in chips)
Seat 3: slotmachine ($47800 in chips)
Seat 4: TurnOnTuneInDropOut ($47340 in chips)
Seat 5: kimjongun ($24581 in chips)
Seat 6: Sam565 ($24014 in chips)
kimjongun: posts small blind $200
Sam565: posts big blind $400
*** HOLE CARDS ***
Dealt to TurnOnTuneInDropOut [Jh Qc Qs 4d]
gaganhyd: folds
slotmachine: raises $1000 to $1400
TurnOnTuneInDropOut: folds
kimjongun: folds
Sam565: folds
Uncalled bet ($1000) returned to slotmachine
slotmachine collected $1000 from pot
slotmachine: doesn't show hand
*** SUMMARY ***
Total pot $1000 | Rake $0
Seat 2: gaganhyd folded before Flop (didn't bet)
Seat 3: slotmachine collected ($1000)
Seat 4: TurnOnTuneInDropOut (button) folded before Flop (didn't bet)
Seat 5: kimjongun (small blind) folded before Flop
Seat 6: Sam565 (big blind) folded before Flop

PokerStars Hand #1255059710: Omaha Pot Limit ($200/$400 USD) - 2020/10/23 13:42:39 ET
Table 'ADA675920511' 6-max Seat #5 is the button
Seat 2: gaganhyd ($20856 in chips)
Seat 3: slotmachine ($48400 in chips)
Seat 4: TurnOnTuneInDropOut ($47340 in chips)
Seat 5: kimjongun ($24381 in chips)
Seat 6: Sam565 ($23614 in chips)
Sam565: posts small blind $200
gaganhyd: posts big blind $400
*** HOLE CARDS ***
Dealt to TurnOnTuneInDropOut [2h 8d Js 5s]
slotmachine: folds
TurnOnTuneInDropOut: folds
kimjongun: folds
Sam565: calls $200
gaganhyd: raises $800 to $1200
Sam565: calls $800
*** FLOP *** [2d Ad Kh]
Sam565: checks
gaganhyd: bets $1200
Sam565: calls $1200
*** TURN *** [2d Ad Kh] [3h]
Sam565: checks
gaganhyd: bets $4800
Sam565: folds
Uncalled bet ($4800) returned to gaganhyd
gaganhyd collected $4608 from pot
gaganhyd: doesn't show hand
*** SUMMARY ***
Total pot $4800 | Rake $192
Board [2d Ad Kh 3h]
Seat 2: gaganhyd (big blind) collected ($4608)
Seat 3: slotmachine folded before Flop (didn't bet)
Seat 4: TurnOnTuneInDropOut folded before Flop (didn't bet)
Seat 5: kimjongun (button) folded before Flop (didn't bet)
Seat 6: Sam565 (small blind) folded on the Turn

PokerStars Hand #1255059711: Omaha Pot Limit ($200/$400 USD) - 2020/10/23 13:43:23 ET
Table 'ADA675920511' 6-max Seat #6 is the button
Seat 2: gaganhyd ($23064 in chips)
Seat 3: slotmachine ($48400 in chips)
Seat 4: TurnOnTuneInDropOut ($47340 in chips)
Seat 5: kimjongun ($24381 in chips)
Seat 6: Sam565 ($21214 in chips)
gaganhyd: posts small blind $200
slotmachine: posts big blind $400
*** HOLE CARDS ***
Dealt to TurnOnTuneInDropOut [Kc 8h Ad 4s]
TurnOnTuneInDropOut: folds
kimjongun: folds
Sam565: folds
gaganhyd: folds
Uncalled bet ($200) returned to slotmachine
slotmachine collected $400 from pot
slotmachine: doesn't show hand
*** SUMMARY ***
Total pot $400 | Rake $0
Seat 2: gaganhyd (small blind) folded before Flop
Seat 3: slotmachine (big blind) collected ($400)
Seat 4: TurnOnTuneInDropOut folded before Flop (didn't bet)
Seat 5: kimjongun folded before Flop (didn't bet)
Seat 6: Sam565 (button) folded before Flop (didn't bet)

PokerStars Hand #1255059712: Omaha Pot Limit ($200/$400 USD) - 2020/10/23 13:43:39 ET
Table 'ADA675920511' 6-max Seat #2 is the button
Seat 2: gaganhyd ($22864 in chips)
Seat 3: slotmachine ($48600 in chips)
Seat 4: TurnOnTuneInDropOut ($47340 in chips)
Seat 5: kimjongun ($24381 in chips)
Seat 6: Sam565 ($21214 in chips)
slotmachine: posts small blind $200
TurnOnTuneInDropOut: posts big blind $400
*** HOLE CARDS ***
Dealt to TurnOnTuneInDropOut [9s Kd 5d Ts]
kimjongun: raises $600 to $1000
Sam565: folds
gaganhyd: folds
slotmachine: raises $2400 to $3400
TurnOnTuneInDropOut: folds
kimjongun: calls $2400
*** FLOP *** [Ac 4h 8s]
slotmachine: bets $3600
kimjongun: folds
Uncalled bet ($3600) returned to slotmachine
slotmachine collected $6911 from pot
slotmachine: doesn't show hand
*** SUMMARY ***
Total pot $7200 | Rake $289
Board [Ac 4h 8s]
Seat 2: gaganhyd (button) folded before Flop (didn't bet)
Seat 3: slotmachine (small blind) collected ($6911)
Seat 4: TurnOnTuneInDropOut (big blind) folded before Flop
Seat 5: kimjongun folded on the Flop
Seat 6: Sam565 folded before Flop (didn't bet)

PokerStars Hand #1255059714: Omaha Pot Limit ($200/$400 USD) - 2020/10/23 13:45:02 ET
Table 'ADA675920511' 6-max Seat #4 is the button
Seat 2: gaganhyd ($22864 in chips)
Seat 3: slotmachine ($52111 in chips)
Seat 4: TurnOnTuneInDropOut ($46740 in chips)
Seat 5: kimjongun ($21081 in chips)
Seat 6: Sam565 ($21314 in chips)
kimjongun: posts small blind $200
Sam565: posts big blind $400
*** HOLE CARDS ***
Dealt to TurnOnTuneInDropOut [2s Qs 3h Ad]
gaganhyd: raises $650 to $1050
slotmachine: folds
TurnOnTuneInDropOut: folds
kimjongun: folds
Sam565: calls $650
*** FLOP *** [Kh 3c 6s]
Sam565: checks
gaganhyd: bets $1150
Sam565: folds
Uncalled bet ($1150) returned to gaganhyd
gaganhyd collected $2208 from pot
gaganhyd: doesn't show hand
*** SUMMARY ***
Total pot $2300 | Rake $92
Board [Kh 3c 6s]
Seat 2: gaganhyd collected ($2208)
Seat 3: slotmachine folded before Flop (didn't bet)
Seat 4: TurnOnTuneInDropOut (button) folded before Flop (didn't bet)
Seat 5: kimjongun (small blind) folded before Flop
Seat 6: Sam565 (big blind) folded on the Flop

PokerStars Hand #1255059715: Omaha Pot Limit ($200/$400 USD) - 2020/10/23 13:45:32 ET
Table 'ADA675920511' 6-max Seat #5 is the button
Seat 2: gaganhyd ($24022 in chips)
Seat 3: slotmachine ($52111 in chips)
Seat 4: TurnOnTuneInDropOut ($46740 in chips)
Seat 5: kimjongun ($20881 in chips)
Seat 6: Sam565 ($20264 in chips)
Sam565: posts small blind $200
gaganhyd: posts big blind $400
*** HOLE CARDS ***
Dealt to TurnOnTuneInDropOut [Ad Ah Kh 5h]
slotmachine: folds
TurnOnTuneInDropOut: raises $1000 to $1400
kimjongun: folds
Sam565: folds
gaganhyd: folds
Uncalled bet ($1000) returned to TurnOnTuneInDropOut
TurnOnTuneInDropOut collected $1000 from pot
TurnOnTuneInDropOut: doesn't show hand
*** SUMMARY ***
Total pot $1000 | Rake $0
Seat 2: gaganhyd (big blind) folded before Flop
Seat 3: slotmachine folded before Flop (didn't bet)
Seat 4: TurnOnTuneInDropOut collected ($1000)
Seat 5: kimjongun (button) folded before Flop (didn't bet)
Seat 6: Sam565 (small blind) folded before Flop

PokerStars Hand #1255059716: Omaha Pot Limit ($200/$400 USD) - 2020/10/23 13:46:24 ET
Table 'ADA675920511' 6-max Seat #6 is the button
Seat 2: gaganhyd ($23622 in chips)
Seat 3: slotmachine ($52111 in chips)
Seat 4: TurnOnTuneInDropOut ($47340 in chips)
Seat 5: kimjongun ($20881 in chips)
Seat 6: Sam565 ($20064 in chips)
gaganhyd: posts small blind $200
slotmachine: posts big blind $400
*** HOLE CARDS ***
Dealt to TurnOnTuneInDropOut [3d 9d 6c Qc]
TurnOnTuneInDropOut: folds
kimjongun: folds
Sam565: calls $400
gaganhyd: folds
slotmachine: checks
*** FLOP *** [Jh 9h 5s]
slotmachine: checks
Sam565: bets $1000
slotmachine: folds
Uncalled bet ($1000) returned to Sam565
Sam565 collected $960 from pot
Sam565: doesn't show hand
*** SUMMARY ***
Total pot $1000 | Rake $40
Board [Jh 9h 5s]
Seat 2: gaganhyd (small blind) folded before Flop
Seat 3: slotmachine (big blind) folded on the Flop
Seat 4: TurnOnTuneInDropOut folded before Flop (didn't bet)
Seat 5: kimjongun folded before Flop (didn't bet)
Seat 6: Sam565 (button) collected ($960)

PokerStars Hand #1255059717: Omaha Pot Limit ($200/$400 USD) - 2020/10/23 13:46:54 ET
Table 'ADA675920511' 6-max Seat #2 is the button
Seat 2: gaganhyd ($23422 in chips)
Seat 3: slotmachine ($51711 in chips)
Seat 4: TurnOnTuneInDropOut ($47340 in chips)
Seat 5: kimjongun ($20881 in chips)
Seat 6: Sam565 ($20624 in chips)
slotmachine: posts small blind $200
TurnOnTuneInDropOut: posts big blind $400
*** HOLE CARDS ***
Dealt to TurnOnTuneInDropOut [Kd Ac 5s 7h]
kimjongun: folds
Sam565: folds
gaganhyd: folds
slotmachine: raises $800 to $1200
TurnOnTuneInDropOut: folds
Uncalled bet ($800) returned to slotmachine
slotmachine collected $800 from pot
slotmachine: doesn't show hand
*** SUMMARY ***
Total pot $800 | Rake $0
Seat 2: gaganhyd (button) folded before Flop (didn't bet)
Seat 3: slotmachine (small blind) collected ($800)
Seat 4: TurnOnTuneInDropOut (big blind) folded before Flop
Seat 5: kimjongun folded before Flop (didn't bet)
Seat 6: Sam565 folded before Flop (didn't bet)

PokerStars Hand #1255059718: Omaha Pot Limit ($200/$400 USD) - 2020/10/23 13:47:10 ET
Table 'ADA675920511' 6-max Seat #3 is the button
Seat 2: gaganhyd ($23422 in chips)
Seat 3: slotmachine ($52111 in chips)
Seat 4: TurnOnTuneInDropOut ($46940 in chips)
Seat 5: kimjongun ($26097 in chips)
Seat 6: Sam565 ($20624 in chips)
TurnOnTuneInDropOut: posts small blind $200
kimjongun: posts big blind $400
*** HOLE CARDS ***
Dealt to TurnOnTuneInDropOut [Jh Td 9d Jc]
Sam565: folds
gaganhyd: folds
slotmachine: raises $1000 to $1400
TurnOnTuneInDropOut: calls $1200
kimjongun: folds
*** FLOP *** [6d 3c Ts]
TurnOnTuneInDropOut: checks
slotmachine: bets $3200
TurnOnTuneInDropOut: calls $3200
*** TURN *** [6d 3c Ts] [9s]
TurnOnTuneInDropOut: checks
slotmachine: checks
*** RIVER *** [6d 3c Ts 9s] [4h]
TurnOnTuneInDropOut: bets $3936
slotmachine: raises $6768 to $10704
TurnOnTuneInDropOut: raises $31008 to $41712
slotmachine: folds
Uncalled bet ($31008) returned to TurnOnTuneInDropOut
TurnOnTuneInDropOut collected $30208 from pot
TurnOnTuneInDropOut: doesn't show hand
*** SUMMARY ***
Total pot $31008 | Rake $800
Board [6d 3c Ts 9s 4h]
Seat 2: gaganhyd folded before Flop (didn't bet)
Seat 3: slotmachine (button) folded on the River
Seat 4: TurnOnTuneInDropOut (small blind) collected ($30208)
Seat 5: kimjongun (big blind) folded before Flop
Seat 6: Sam565 folded before Flop (didn't bet)

PokerStars Hand #1255059719: Omaha Pot Limit ($200/$400 USD) - 2020/10/23 13:48:33 ET
Table 'ADA675920511' 6-max Seat #4 is the button
Seat 1: soundfsilenz ($42000 in chips)
Seat 2: gaganhyd ($23422 in chips)
Seat 3: slotmachine ($48000 in chips)
Seat 4: TurnOnTuneInDropOut ($61844 in chips)
Seat 5: kimjongun ($25697 in chips)
kimjongun: posts small blind $200
soundfsilenz: posts big blind $400
*** HOLE CARDS ***
Dealt to TurnOnTuneInDropOut [Ts Ac 7d Td]
gaganhyd: raises $650 to $1050
slotmachine: folds
TurnOnTuneInDropOut: folds
kimjongun: folds
soundfsilenz: folds
Uncalled bet ($650) returned to gaganhyd
gaganhyd collected $1000 from pot
gaganhyd: doesn't show hand
*** SUMMARY ***
Total pot $1000 | Rake $0
Seat 1: soundfsilenz (big blind) folded before Flop
Seat 2: gaganhyd collected ($1000)
Seat 3: slotmachine folded before Flop (didn't bet)
Seat 4: TurnOnTuneInDropOut (button) folded before Flop (didn't bet)
Seat 5: kimjongun (small blind) folded before Flop

PokerStars Hand #1255059720: Omaha Pot Limit ($200/$400 USD) - 2020/10/23 13:48:57 ET
Table 'ADA675920511' 6-max Seat #5 is the button
Seat 1: soundfsilenz ($41600 in chips)
Seat 2: gaganhyd ($24022 in chips)
Seat 3: slotmachine ($48000 in chips)
Seat 4: TurnOnTuneInDropOut ($61844 in chips)
Seat 5: kimjongun ($25497 in chips)
soundfsilenz: posts small blind $200
gaganhyd: posts big blind $400
*** HOLE CARDS ***
Dealt to TurnOnTuneInDropOut [8d Ts 8h Ad]
slotmachine: folds
TurnOnTuneInDropOut: raises $1000 to $1400
kimjongun: folds
soundfsilenz: folds
gaganhyd: folds
Uncalled bet ($1000) returned to TurnOnTuneInDropOut
TurnOnTuneInDropOut collected $1000 from pot
TurnOnTuneInDropOut: doesn't show hand
*** SUMMARY ***
Total pot $1000 | Rake $0
Seat 1: soundfsilenz (small blind) folded before Flop
Seat 2: gaganhyd (big blind) folded before Flop
Seat 3: slotmachine folded before Flop (didn't bet)
Seat 4: TurnOnTuneInDropOut collected ($1000)
Seat 5: kimjongun (button) folded before Flop (didn't bet)

PokerStars Hand #1255059721: Omaha Pot Limit ($200/$400 USD) - 2020/10/23 13:49:21 ET
Table 'ADA675920511' 6-max Seat #1 is the button
Seat 1: soundfsilenz ($41400 in chips)
Seat 2: gaganhyd ($23622 in chips)
Seat 3: slotmachine ($48000 in chips)
Seat 4: TurnOnTuneInDropOut ($62444 in chips)
Seat 5: kimjongun ($25497 in chips)
gaganhyd: posts small blind $200
slotmachine: posts big blind $400
*** HOLE CARDS ***
Dealt to TurnOnTuneInDropOut [8c 7h 2h 3d]
TurnOnTuneInDropOut: folds
kimjongun: folds
soundfsilenz: raises $1000 to $1400
gaganhyd: folds
slotmachine: folds
Uncalled bet ($1000) returned to soundfsilenz
soundfsilenz collected $1000 from pot
soundfsilenz: doesn't show hand
*** SUMMARY ***
Total pot $1000 | Rake $0
Seat 1: soundfsilenz (button) collected ($1000)
Seat 2: gaganhyd (small blind) folded before Flop
Seat 3: slotmachine (big blind) folded before Flop
Seat 4: TurnOnTuneInDropOut folded before Flop (didn't bet)
Seat 5: kimjongun folded before Flop (didn't bet)

PokerStars Hand #1255059722: Omaha Pot Limit ($200/$400 USD) - 2020/10/23 13:49:45 ET
Table 'ADA675920511' 6-max Seat #2 is the button
Seat 1: soundfsilenz ($42000 in chips)
Seat 2: gaganhyd ($23422 in chips)
Seat 3: slotmachine ($47600 in chips)
Seat 4: TurnOnTuneInDropOut ($62444 in chips)
Seat 5: kimjongun ($25497 in chips)
slotmachine: posts small blind $200
TurnOnTuneInDropOut: posts big blind $400
*** HOLE CARDS ***
Dealt to TurnOnTuneInDropOut [6d Qh 2s Tc]
kimjongun: raises $600 to $1000
soundfsilenz: folds
gaganhyd: calls $1000
slotmachine: folds
TurnOnTuneInDropOut: folds
*** FLOP *** [Ts 8h 4d]
kimjongun: checks
gaganhyd: bets $1300
kimjongun: calls $1300
*** TURN *** [Ts 8h 4d] [4s]
kimjongun: checks
gaganhyd: checks
*** RIVER *** [Ts 8h 4d 4s] [5d]
kimjongun: bets $2600
gaganhyd: folds
Uncalled bet ($2600) returned to kimjongun
kimjongun collected $4991 from pot
kimjongun: doesn't show hand
*** SUMMARY ***
Total pot $5200 | Rake $209
Board [Ts 8h 4d 4s 5d]
Seat 1: soundfsilenz folded before Flop (didn't bet)
Seat 2: gaganhyd (button) folded on the River
Seat 3: slotmachine (small blind) folded before Flop
Seat 4: TurnOnTuneInDropOut (big blind) folded before Flop
Seat 5: kimjongun collected ($4991)

PokerStars Hand #1255059724: Omaha Pot Limit ($200/$400 USD) - 2020/10/23 13:51:26 ET
Table 'ADA675920511' 6-max Seat #4 is the button
Seat 1: soundfsilenz ($42000 in chips)
Seat 2: gaganhyd ($21122 in chips)
Seat 3: slotmachine ($45600 in chips)
Seat 4: TurnOnTuneInDropOut ($61844 in chips)
Seat 5: kimjongun ($27788 in chips)
Seat 6: vikram2013 ($14620 in chips)
kimjongun: posts small blind $200
vikram2013: posts big blind $400
*** HOLE CARDS ***
Dealt to TurnOnTuneInDropOut [2d Jh 7s 8d]
soundfsilenz: raises $1000 to $1400
gaganhyd: calls $1400
slotmachine: folds
TurnOnTuneInDropOut: folds
kimjongun: folds
vikram2013: folds
*** FLOP *** [3s Qs 5s]
soundfsilenz: checks
gaganhyd: checks
*** TURN *** [3s Qs 5s] [9d]
soundfsilenz: checks
gaganhyd: checks
*** RIVER *** [3s Qs 5s 9d] [Kh]
soundfsilenz: checks
gaganhyd: bets $2550
soundfsilenz: folds
Uncalled bet ($2550) returned to gaganhyd
gaganhyd collected $3264 from pot
gaganhyd: doesn't show hand
*** SUMMARY ***
Total pot $3400 | Rake $136
Board [3s Qs 5s 9d Kh]
Seat 1: soundfsilenz folded on the River
Seat 2: gaganhyd collected ($3264)
Seat 3: slotmachine folded before Flop (didn't bet)
Seat 4: TurnOnTuneInDropOut (button) folded before Flop (didn't bet)
Seat 5: kimjongun (small blind) folded before Flop
Seat 6: vikram2013 (big blind) folded before Flop

PokerStars Hand #1255059725: Omaha Pot Limit ($200/$400 USD) - 2020/10/23 13:52:25 ET
Table 'ADA675920511' 6-max Seat #5 is the button
Seat 1: soundfsilenz ($40600 in chips)
Seat 2: gaganhyd ($22986 in chips)
Seat 3: slotmachine ($45600 in chips)
Seat 4: TurnOnTuneInDropOut ($61844 in chips)
Seat 5: kimjongun ($27588 in chips)
Seat 6: vikram2013 ($14220 in chips)
vikram2013: posts small blind $200
soundfsilenz: posts big blind $400
*** HOLE CARDS ***
Dealt to TurnOnTuneInDropOut [6h 3d 3s 8c]
gaganhyd: folds
slotmachine: folds
TurnOnTuneInDropOut: folds
kimjongun: folds
vikram2013: raises $800 to $1200
soundfsilenz: folds
Uncalled bet ($800) returned to vikram2013
vikram2013 collected $800 from pot
vikram2013: doesn't show hand
*** SUMMARY ***
Total pot $800 | Rake $0
Seat 1: soundfsilenz (big blind) folded before Flop
Seat 2: gaganhyd folded before Flop (didn't bet)
Seat 3: slotmachine folded before Flop (didn't bet)
Seat 4: TurnOnTuneInDropOut folded before Flop (didn't bet)
Seat 5: kimjongun (button) folded before Flop (didn't bet)
Seat 6: vikram2013 (small blind) collected ($800)

PokerStars Hand #1255059726: Omaha Pot Limit ($200/$400 USD) - 2020/10/23 13:53:10 ET
Table 'ADA675920511' 6-max Seat #6 is the button
Seat 1: soundfsilenz ($40200 in chips)
Seat 2: gaganhyd ($22986 in chips)
Seat 3: slotmachine ($45600 in chips)
Seat 4: TurnOnTuneInDropOut ($61844 in chips)
Seat 5: kimjongun ($27588 in chips)
Seat 6: vikram2013 ($14620 in chips)
soundfsilenz: posts small blind $200
gaganhyd: posts big blind $400
*** HOLE CARDS ***
Dealt to TurnOnTuneInDropOut [4d Ah Td Qh]
slotmachine: raises $1000 to $1400
TurnOnTuneInDropOut: calls $1400
kimjongun: folds
vikram2013: folds
soundfsilenz: folds
gaganhyd: calls $1000
*** FLOP *** [Js Kh 6d]
gaganhyd: checks
slotmachine: bets $2904
TurnOnTuneInDropOut: calls $2904
gaganhyd: folds
*** TURN *** [Js Kh 6d] [9s]
slotmachine: checks
TurnOnTuneInDropOut: bets $9698
slotmachine: folds
Uncalled bet ($9698) returned to TurnOnTuneInDropOut
TurnOnTuneInDropOut collected $9799 from pot
TurnOnTuneInDropOut: doesn't show hand
*** SUMMARY ***
Total pot $10208 | Rake $409
Board [Js Kh 6d 9s]
Seat 1: soundfsilenz (small blind) folded before Flop
Seat 2: gaganhyd (big blind) folded on the Flop
Seat 3: slotmachine folded on the Turn
Seat 4: TurnOnTuneInDropOut collected ($9799)
Seat 5: kimjongun folded before Flop (didn't bet)
Seat 6: vikram2013 (button) folded before Flop (didn't bet)

PokerStars Hand #1255059727: Omaha Pot Limit ($200/$400 USD) - 2020/10/23 13:54:03 ET
Table 'ADA675920511' 6-max Seat #1 is the button
Seat 1: soundfsilenz ($40000 in chips)
Seat 2: gaganhyd ($21586 in chips)
Seat 3: slotmachine ($41296 in chips)
Seat 4: TurnOnTuneInDropOut ($67339 in chips)
Seat 5: kimjongun ($27588 in chips)
Seat 6: vikram2013 ($14620 in chips)
gaganhyd: posts small blind $200
slotmachine: posts big blind $400
*** HOLE CARDS ***
Dealt to TurnOnTuneInDropOut [Ac 6h 4c Jd]
TurnOnTuneInDropOut: folds
kimjongun: folds
vikram2013: calls $400
soundfsilenz: folds
gaganhyd: calls $200
slotmachine: checks
*** FLOP *** [6c As 5c]
gaganhyd: checks
slotmachine: checks
vikram2013: checks
*** TURN *** [6c As 5c] [8h]
gaganhyd: checks
slotmachine: bets $792
vikram2013: folds
gaganhyd: folds
Uncalled bet ($792) returned to slotmachine
slotmachine collected $1152 from pot
slotmachine: doesn't show hand
*** SUMMARY ***
Total pot $1200 | Rake $48
Board [6c As 5c 8h]
Seat 1: soundfsilenz (button) folded before Flop (didn't bet)
Seat 2: gaganhyd (small blind) folded on the Turn
Seat 3: slotmachine (big blind) collected ($1152)
Seat 4: TurnOnTuneInDropOut folded before Flop (didn't bet)
Seat 5: kimjongun folded before Flop (didn't bet)
Seat 6: vikram2013 folded on the Turn

PokerStars Hand #1255059730: Omaha Pot Limit ($200/$400 USD) - 2020/10/23 13:57:11 ET
Table 'ADA675920511' 6-max Seat #4 is the button
Seat 1: soundfsilenz ($43767 in chips)
Seat 2: gaganhyd ($21186 in chips)
Seat 3: slotmachine ($40248 in chips)
Seat 4: TurnOnTuneInDropOut ($76739 in chips)
Seat 5: kimjongun ($27188 in chips)
Seat 6: vikram2013 ($2220 in chips)
kimjongun: posts small blind $200
vikram2013: posts big blind $400
*** HOLE CARDS ***
Dealt to TurnOnTuneInDropOut [4d 9s 8h Kd]
soundfsilenz: folds
gaganhyd: folds
slotmachine: folds
TurnOnTuneInDropOut: folds
kimjongun: folds
Uncalled bet ($200) returned to vikram2013
vikram2013 collected $400 from pot
vikram2013: doesn't show hand
*** SUMMARY ***
Total pot $400 | Rake $0
Seat 1: soundfsilenz folded before Flop (didn't bet)
Seat 2: gaganhyd folded before Flop (didn't bet)
Seat 3: slotmachine folded before Flop (didn't bet)
Seat 4: TurnOnTuneInDropOut (button) folded before Flop (didn't bet)
Seat 5: kimjongun (small blind) folded before Flop
Seat 6: vikram2013 (big blind) collected ($400)

PokerStars Hand #1255059731: Omaha Pot Limit ($200/$400 USD) - 2020/10/23 13:57:31 ET
Table 'ADA675920511' 6-max Seat #5 is the button
Seat 1: soundfsilenz ($43767 in chips)
Seat 2: gaganhyd ($21186 in chips)
Seat 3: slotmachine ($40248 in chips)
Seat 4: TurnOnTuneInDropOut ($76739 in chips)
Seat 5: kimjongun ($26988 in chips)
Seat 6: vikram2013 ($2420 in chips)
vikram2013: posts small blind $200
soundfsilenz: posts big blind $400
*** HOLE CARDS ***
Dealt to TurnOnTuneInDropOut [Kc 9c Qh 5c]
gaganhyd: folds
slotmachine: folds
TurnOnTuneInDropOut: folds
kimjongun: folds
vikram2013: raises $800 to $1200
soundfsilenz: raises $2400 to $3600
vikram2013: calls $1220 and is all-in
Uncalled bet ($1180) returned to soundfsilenz
*** FLOP *** [Qc 7s 7d]
*** TURN *** [Qc 7s 7d] [Td]
*** RIVER *** [Qc 7s 7d Td] [5d]
*** SHOW DOWN ***
vikram2013: shows [4h 5s Ad Js]
soundfsilenz: shows [4s 3s Ah 5h]
soundfsilenz collected $2420 from pot
vikram2013 collected $2420 from pot
*** SUMMARY ***
Total pot $4840 | Rake $0
Board [Qc 7s 7d Td 5d]
Seat 1: soundfsilenz (big blind) showed [4s 3s Ah 5h] and won ($2420)
Seat 2: gaganhyd folded before Flop (didn't bet)
Seat 3: slotmachine folded before Flop (didn't bet)
Seat 4: TurnOnTuneInDropOut folded before Flop (didn't bet)
Seat 5: kimjongun (button) folded before Flop (didn't bet)
Seat 6: vikram2013 (small blind) showed [4h 5s Ad Js] and won ($2420)

PokerStars Hand #1255059733: Omaha Pot Limit ($200/$400 USD) - 2020/10/23 13:58:46 ET
Table 'ADA675920511' 6-max Seat #1 is the button
Seat 1: soundfsilenz ($43567 in chips)
Seat 2: gaganhyd ($20786 in chips)
Seat 3: slotmachine ($40248 in chips)
Seat 4: TurnOnTuneInDropOut ($79541 in chips)
Seat 5: kimjongun ($26988 in chips)
gaganhyd: posts small blind $200
slotmachine: posts big blind $400
*** HOLE CARDS ***
Dealt to TurnOnTuneInDropOut [4d 4c 3c 2d]
TurnOnTuneInDropOut: folds
kimjongun: raises $1000 to $1400
soundfsilenz: folds
gaganhyd: folds
slotmachine: raises $3000 to $4400
kimjongun: folds
Uncalled bet ($3000) returned to slotmachine
slotmachine collected $3000 from pot
slotmachine: doesn't show hand
*** SUMMARY ***
Total pot $3000 | Rake $0
Seat 1: soundfsilenz (button) folded before Flop (didn't bet)
Seat 2: gaganhyd (small blind) folded before Flop
Seat 3: slotmachine (big blind) collected ($3000)
Seat 4: TurnOnTuneInDropOut folded before Flop (didn't bet)
Seat 5: kimjongun folded before Flop

PokerStars Hand #1255059734: Omaha Pot Limit ($200/$400 USD) - 2020/10/23 13:59:13 ET
Table 'ADA675920511' 6-max Seat #2 is the button
Seat 1: soundfsilenz ($43567 in chips)
Seat 2: gaganhyd ($20586 in chips)
Seat 3: slotmachine ($48000 in chips)
Seat 4: TurnOnTuneInDropOut ($79541 in chips)
Seat 5: kimjongun ($25588 in chips)
slotmachine: posts small blind $200
TurnOnTuneInDropOut: posts big blind $400
*** HOLE CARDS ***
Dealt to TurnOnTuneInDropOut [Kh Qs Ks 6s]
kimjongun: folds
soundfsilenz: folds
gaganhyd: folds
slotmachine: folds
Uncalled bet ($200) returned to TurnOnTuneInDropOut
TurnOnTuneInDropOut collected $400 from pot
TurnOnTuneInDropOut: doesn't show hand
*** SUMMARY ***
Total pot $400 | Rake $0
Seat 1: soundfsilenz folded before Flop (didn't bet)
Seat 2: gaganhyd (button) folded before Flop (didn't bet)
Seat 3: slotmachine (small blind) folded before Flop
Seat 4: TurnOnTuneInDropOut (big blind) collected ($400)
Seat 5: kimjongun folded before Flop (didn't bet)

PokerStars Hand #1255059756: Omaha Pot Limit ($200/$400 USD) - 2020/10/23 14:11:34 ET
Table 'ADA675920511' 6-max Seat #2 is the button
Seat 1: Prateek1986 ($21375 in chips)
Seat 2: sherpalife ($48000 in chips)
Seat 3: slotmachine ($44468 in chips)
Seat 5: TurnOnTuneInDropOut ($79741 in chips)
Seat 6: soundfsilenz ($38567 in chips)
slotmachine: posts small blind $200
TurnOnTuneInDropOut: posts big blind $400
*** HOLE CARDS ***
Dealt to TurnOnTuneInDropOut [2d 5d 8s Ad]
soundfsilenz: folds
Prateek1986: folds
sherpalife: folds
slotmachine: raises $800 to $1200
TurnOnTuneInDropOut: calls $800
*** FLOP *** [6h 5h Ac]
slotmachine: checks
TurnOnTuneInDropOut: bets $1584
slotmachine: folds
Uncalled bet ($1584) returned to TurnOnTuneInDropOut
TurnOnTuneInDropOut collected $2304 from pot
TurnOnTuneInDropOut: doesn't show hand
*** SUMMARY ***
Total pot $2400 | Rake $96
Board [6h 5h Ac]
Seat 1: Prateek1986 folded before Flop (didn't bet)
Seat 2: sherpalife (button) folded before Flop (didn't bet)
Seat 3: slotmachine (small blind) folded on the Flop
Seat 5: TurnOnTuneInDropOut (big blind) collected ($2304)
Seat 6: soundfsilenz folded before Flop (didn't bet)

PokerStars Hand #1255059758: Omaha Pot Limit ($200/$400 USD) - 2020/10/23 14:13:25 ET
Table 'ADA675920511' 6-max Seat #5 is the button
Seat 1: Prateek1986 ($20075 in chips)
Seat 2: sherpalife ($48000 in chips)
Seat 3: slotmachine ($43268 in chips)
Seat 5: TurnOnTuneInDropOut ($83289 in chips)
Seat 6: soundfsilenz ($37267 in chips)
soundfsilenz: posts small blind $200
Prateek1986: posts big blind $400
*** HOLE CARDS ***
Dealt to TurnOnTuneInDropOut [8h Ks 7h Th]
sherpalife: folds
slotmachine: folds
TurnOnTuneInDropOut: raises $1000 to $1400
soundfsilenz: folds
Prateek1986: calls $1000
*** FLOP *** [Ts 6s Qh]
Prateek1986: checks
TurnOnTuneInDropOut: checks
*** TURN *** [Ts 6s Qh] [Td]
Prateek1986: bets $2250
TurnOnTuneInDropOut: raises $5063 to $7313
Prateek1986: calls $5063
*** RIVER *** [Ts 6s Qh Td] [Js]
Prateek1986: checks
TurnOnTuneInDropOut: checks
*** SHOW DOWN ***
Prateek1986: shows [2d 2c Kh Tc]
TurnOnTuneInDropOut: shows [8h Ks 7h Th]
TurnOnTuneInDropOut collected $8813 from pot
Prateek1986 collected $8813 from pot
*** SUMMARY ***
Total pot $17626 | Rake $0
Board [Ts 6s Qh Td Js]
Seat 1: Prateek1986 (big blind) showed [2d 2c Kh Tc] and won ($8813)
Seat 2: sherpalife folded before Flop (didn't bet)
Seat 3: slotmachine folded before Flop (didn't bet)
Seat 5: TurnOnTuneInDropOut (button) showed [8h Ks 7h Th] and won ($8813)
Seat 6: soundfsilenz (small blind) folded before Flop

PokerStars Hand #1255059759: Omaha Pot Limit ($200/$400 USD) - 2020/10/23 14:14:22 ET
Table 'ADA675920511' 6-max Seat #6 is the button
Seat 1: Prateek1986 ($20175 in chips)
Seat 2: sherpalife ($48000 in chips)
Seat 3: slotmachine ($43268 in chips)
Seat 5: TurnOnTuneInDropOut ($83389 in chips)
Seat 6: soundfsilenz ($37067 in chips)
Prateek1986: posts small blind $200
sherpalife: posts big blind $400
*** HOLE CARDS ***
Dealt to TurnOnTuneInDropOut [Qs 7h Js Kd]
slotmachine: folds
TurnOnTuneInDropOut: folds
soundfsilenz: folds
Prateek1986: raises $800 to $1200
sherpalife: folds
Uncalled bet ($800) returned to Prateek1986
Prateek1986 collected $800 from pot
Prateek1986: doesn't show hand
*** SUMMARY ***
Total pot $800 | Rake $0
Seat 1: Prateek1986 (small blind) collected ($800)
Seat 2: sherpalife (big blind) folded before Flop
Seat 3: slotmachine folded before Flop (didn't bet)
Seat 5: TurnOnTuneInDropOut folded before Flop (didn't bet)
Seat 6: soundfsilenz (button) folded before Flop (didn't bet)

PokerStars Hand #1255059760: Omaha Pot Limit ($200/$400 USD) - 2020/10/23 14:16:06 ET
Table 'ADA675920511' 6-max Seat #1 is the button
Seat 1: Prateek1986 ($20575 in chips)
Seat 2: sherpalife ($47600 in chips)
Seat 3: slotmachine ($43268 in chips)
Seat 5: TurnOnTuneInDropOut ($83389 in chips)
Seat 6: soundfsilenz ($37067 in chips)
sherpalife: posts small blind $200
slotmachine: posts big blind $400
*** HOLE CARDS ***
Dealt to TurnOnTuneInDropOut [Qd 5h 7s 5c]
TurnOnTuneInDropOut: folds
soundfsilenz: folds
Prateek1986: calls $400
sherpalife: folds
slotmachine: checks
*** FLOP *** [7h Qc Td]
slotmachine: checks
Prateek1986: checks
*** TURN *** [7h Qc Td] [4h]
slotmachine: checks
Prateek1986: checks
*** RIVER *** [7h Qc Td 4h] [2c]
slotmachine: checks
Prateek1986: checks
*** SHOW DOWN ***
slotmachine: shows [6d 8s 2s 7c]
Prateek1986: mucks hand
slotmachine collected $960 from pot
*** SUMMARY ***
Total pot $1000 | Rake $40
Board [7h Qc Td 4h 2c]
Seat 1: Prateek1986 (button) mucked
Seat 2: sherpalife (small blind) folded before Flop
Seat 3: slotmachine (big blind) showed [6d 8s 2s 7c] and won ($960)
Seat 5: TurnOnTuneInDropOut folded before Flop (didn't bet)
Seat 6: soundfsilenz folded before Flop (didn't bet)

PokerStars Hand #1255059761: Omaha Pot Limit ($200/$400 USD) - 2020/10/23 14:17:09 ET
Table 'ADA675920511' 6-max Seat #2 is the button
Seat 1: Prateek1986 ($20175 in chips)
Seat 2: sherpalife ($47400 in chips)
Seat 3: slotmachine ($43828 in chips)
Seat 4: Sam565 ($12000 in chips)
Seat 5: TurnOnTuneInDropOut ($83389 in chips)
Seat 6: soundfsilenz ($37067 in chips)
slotmachine: posts small blind $200
Sam565: posts big blind $400
*** HOLE CARDS ***
Dealt to TurnOnTuneInDropOut [2d Qs 7c Ah]
TurnOnTuneInDropOut: folds
soundfsilenz: folds
Prateek1986: folds
sherpalife: folds
slotmachine: folds
Uncalled bet ($200) returned to Sam565
Sam565 collected $400 from pot
Sam565: doesn't show hand
*** SUMMARY ***
Total pot $400 | Rake $0
Seat 1: Prateek1986 folded before Flop (didn't bet)
Seat 2: sherpalife (button) folded before Flop (didn't bet)
Seat 3: slotmachine (small blind) folded before Flop
Seat 4: Sam565 (big blind) collected ($400)
Seat 5: TurnOnTuneInDropOut folded before Flop (didn't bet)
Seat 6: soundfsilenz folded before Flop (didn't bet)

PokerStars Hand #1255059764: Omaha Pot Limit ($200/$400 USD) - 2020/10/23 14:21:06 ET
Table 'ADA675920511' 6-max Seat #6 is the button
Seat 1: Prateek1986 ($18625 in chips)
Seat 2: sherpalife ($47960 in chips)
Seat 3: slotmachine ($43628 in chips)
Seat 5: TurnOnTuneInDropOut ($84639 in chips)
Seat 6: soundfsilenz ($36867 in chips)
Prateek1986: posts small blind $200
sherpalife: posts big blind $400
*** HOLE CARDS ***
Dealt to TurnOnTuneInDropOut [Tc Ah 7s 2s]
slotmachine: folds
TurnOnTuneInDropOut: folds
soundfsilenz: folds
Prateek1986: calls $200
sherpalife: raises $800 to $1200
Prateek1986: folds
Uncalled bet ($800) returned to sherpalife
sherpalife collected $800 from pot
sherpalife: doesn't show hand
*** SUMMARY ***
Total pot $800 | Rake $0
Seat 1: Prateek1986 (small blind) folded before Flop
Seat 2: sherpalife (big blind) collected ($800)
Seat 3: slotmachine folded before Flop (didn't bet)
Seat 5: TurnOnTuneInDropOut folded before Flop (didn't bet)
Seat 6: soundfsilenz (button) folded before Flop (didn't bet)

PokerStars Hand #1255059765: Omaha Pot Limit ($200/$400 USD) - 2020/10/23 14:22:01 ET
Table 'ADA675920511' 6-max Seat #1 is the button
Seat 1: Prateek1986 ($18225 in chips)
Seat 2: sherpalife ($48360 in chips)
Seat 3: slotmachine ($43628 in chips)
Seat 5: TurnOnTuneInDropOut ($84639 in chips)
Seat 6: soundfsilenz ($36867 in chips)
sherpalife: posts small blind $200
slotmachine: posts big blind $400
*** HOLE CARDS ***
Dealt to TurnOnTuneInDropOut [Th 7h 8s 5c]
TurnOnTuneInDropOut: folds
soundfsilenz: folds
Prateek1986: calls $400
sherpalife: folds
slotmachine: raises $1000 to $1400
Prateek1986: calls $1000
*** FLOP *** [Jh 8c 7s]
slotmachine: checks
Prateek1986: checks
*** TURN *** [Jh 8c 7s] [3c]
slotmachine: checks
Prateek1986: checks
*** RIVER *** [Jh 8c 7s 3c] [5h]
slotmachine: checks
Prateek1986: checks
*** SHOW DOWN ***
slotmachine: shows [3s Ks Kh 4h]
Prateek1986: mucks hand
slotmachine collected $2880 from pot
*** SUMMARY ***
Total pot $3000 | Rake $120
Board [Jh 8c 7s 3c 5h]
Seat 1: Prateek1986 (button) mucked
Seat 2: sherpalife (small blind) folded before Flop
Seat 3: slotmachine (big blind) showed [3s Ks Kh 4h] and won ($2880)
Seat 5: TurnOnTuneInDropOut folded before Flop (didn't bet)
Seat 6: soundfsilenz folded before Flop (didn't bet)

PokerStars Hand #1255059766: Omaha Pot Limit ($200/$400 USD) - 2020/10/23 14:23:36 ET
Table 'ADA675920511' 6-max Seat #2 is the button
Seat 1: Prateek1986 ($16825 in chips)
Seat 2: sherpalife ($48160 in chips)
Seat 3: slotmachine ($45108 in chips)
Seat 4: Sam565 ($12000 in chips)
Seat 5: TurnOnTuneInDropOut ($84639 in chips)
Seat 6: soundfsilenz ($36867 in chips)
slotmachine: posts small blind $200
Sam565: posts big blind $400
*** HOLE CARDS ***
Dealt to TurnOnTuneInDropOut [3c 8d 5h Ac]
TurnOnTuneInDropOut: folds
soundfsilenz: folds
Prateek1986: raises $1000 to $1400
sherpalife: folds
slotmachine: raises $3200 to $4600
Sam565: folds
Prateek1986: calls $3200
*** FLOP *** [Qc Jh Jd]
slotmachine: bets $2768
Prateek1986: raises $9457 to $12225 and is all-in
slotmachine: folds
Uncalled bet ($9457) returned to Prateek1986
Prateek1986 collected $14529 from pot
Prateek1986: doesn't show hand
*** SUMMARY ***
Total pot $15136 | Rake $607
Board [Qc Jh Jd]
Seat 1: Prateek1986 collected ($14529)
Seat 2: sherpalife (button) folded before Flop (didn't bet)
Seat 3: slotmachine (small blind) folded on the Flop
Seat 4: Sam565 (big blind) folded before Flop
Seat 5: TurnOnTuneInDropOut folded before Flop (didn't bet)
Seat 6: soundfsilenz folded before Flop (didn't bet)

PokerStars Hand #1255059768: Omaha Pot Limit ($200/$400 USD) - 2020/10/23 14:25:40 ET
Table 'ADA675920511' 6-max Seat #4 is the button
Seat 1: Prateek1986 ($22186 in chips)
Seat 2: sherpalife ($50392 in chips)
Seat 3: slotmachine ($48000 in chips)
Seat 4: Sam565 ($11400 in chips)
Seat 5: TurnOnTuneInDropOut ($84239 in chips)
Seat 6: soundfsilenz ($36867 in chips)
TurnOnTuneInDropOut: posts small blind $200
soundfsilenz: posts big blind $400
*** HOLE CARDS ***
Dealt to TurnOnTuneInDropOut [Td 6s 2c Tc]
Prateek1986: raises $1000 to $1400
sherpalife: folds
slotmachine: folds
Sam565: folds
TurnOnTuneInDropOut: folds
soundfsilenz: folds
Uncalled bet ($1000) returned to Prateek1986
Prateek1986 collected $1000 from pot
Prateek1986: doesn't show hand
*** SUMMARY ***
Total pot $1000 | Rake $0
Seat 1: Prateek1986 collected ($1000)
Seat 2: sherpalife folded before Flop (didn't bet)
Seat 3: slotmachine folded before Flop (didn't bet)
Seat 4: Sam565 (button) folded before Flop (didn't bet)
Seat 5: TurnOnTuneInDropOut (small blind) folded before Flop
Seat 6: soundfsilenz (big blind) folded before Flop

PokerStars Hand #1255059771: Omaha Pot Limit ($200/$400 USD) - 2020/10/23 14:30:21 ET
Table 'ADA675920511' 6-max Seat #1 is the button
Seat 1: Prateek1986 ($21986 in chips)
Seat 2: sherpalife ($49392 in chips)
Seat 3: slotmachine ($48000 in chips)
Seat 4: Sam565 ($11104 in chips)
Seat 5: TurnOnTuneInDropOut ($84039 in chips)
Seat 6: soundfsilenz ($38323 in chips)
sherpalife: posts small blind $200
slotmachine: posts big blind $400
*** HOLE CARDS ***
Dealt to TurnOnTuneInDropOut [Jd Ts 2d 9s]
Sam565: folds
TurnOnTuneInDropOut: folds
soundfsilenz: folds
Prateek1986: folds
sherpalife: folds
Uncalled bet ($200) returned to slotmachine
slotmachine collected $400 from pot
slotmachine: doesn't show hand
*** SUMMARY ***
Total pot $400 | Rake $0
Seat 1: Prateek1986 (button) folded before Flop (didn't bet)
Seat 2: sherpalife (small blind) folded before Flop
Seat 3: slotmachine (big blind) collected ($400)
Seat 4: Sam565 folded before Flop (didn't bet)
Seat 5: TurnOnTuneInDropOut folded before Flop (didn't bet)
Seat 6: soundfsilenz folded before Flop (didn't bet)

PokerStars Hand #1255059772: Omaha Pot Limit ($200/$400 USD) - 2020/10/23 14:30:55 ET
Table 'ADA675920511' 6-max Seat #2 is the button
Seat 1: Prateek1986 ($21986 in chips)
Seat 2: sherpalife ($49192 in chips)
Seat 3: slotmachine ($48200 in chips)
Seat 4: Sam565 ($11104 in chips)
Seat 5: TurnOnTuneInDropOut ($84039 in chips)
Seat 6: soundfsilenz ($38323 in chips)
slotmachine: posts small blind $200
Sam565: posts big blind $400
*** HOLE CARDS ***
Dealt to TurnOnTuneInDropOut [Ts 5s 6h 4c]
TurnOnTuneInDropOut: folds
soundfsilenz: folds
Prateek1986: raises $1000 to $1400
sherpalife: calls $1400
slotmachine: folds
Sam565: calls $1000
*** FLOP *** [Jc Td Ah]
Sam565: checks
Prateek1986: bets $4400
sherpalife: folds
Sam565: folds
Uncalled bet ($4400) returned to Prateek1986
Prateek1986 collected $4224 from pot
Prateek1986: doesn't show hand
*** SUMMARY ***
Total pot $4400 | Rake $176
Board [Jc Td Ah]
Seat 1: Prateek1986 collected ($4224)
Seat 2: sherpalife (button) folded on the Flop
Seat 3: slotmachine (small blind) folded before Flop
Seat 4: Sam565 (big blind) folded on the Flop
Seat 5: TurnOnTuneInDropOut folded before Flop (didn't bet)
Seat 6: soundfsilenz folded before Flop (didn't bet)

PokerStars Hand #1255059776: Omaha Pot Limit ($200/$400 USD) - 2020/10/23 14:35:38 ET
Table 'ADA675920511' 6-max Seat #6 is the button
Seat 1: Prateek1986 ($17382 in chips)
Seat 2: sherpalife ($40977 in chips)
Seat 3: slotmachine ($57082 in chips)
Seat 4: Sam565 ($9104 in chips)
Seat 5: TurnOnTuneInDropOut ($83439 in chips)
Seat 6: soundfsilenz ($43531 in chips)
Prateek1986: posts small blind $200
sherpalife: posts big blind $400
*** HOLE CARDS ***
Dealt to TurnOnTuneInDropOut [9d 3s Ks Qs]
slotmachine: raises $1000 to $1400
Sam565: folds
TurnOnTuneInDropOut: folds
soundfsilenz: folds
Prateek1986: calls $1200
sherpalife: calls $1000
*** FLOP *** [7s 6h Kd]
Prateek1986: bets $3150
sherpalife: raises $10500 to $13650
slotmachine: folds
Prateek1986: folds
Uncalled bet ($10500) returned to sherpalife
sherpalife collected $10079 from pot
sherpalife: doesn't show hand
*** SUMMARY ***
Total pot $10500 | Rake $421
Board [7s 6h Kd]
Seat 1: Prateek1986 (small blind) folded on the Flop
Seat 2: sherpalife (big blind) collected ($10079)
Seat 3: slotmachine folded on the Flop
Seat 4: Sam565 folded before Flop (didn't bet)
Seat 5: TurnOnTuneInDropOut folded before Flop (didn't bet)
Seat 6: soundfsilenz (button) folded before Flop (didn't bet)

PokerStars Hand #1255059777: Omaha Pot Limit ($200/$400 USD) - 2020/10/23 14:36:45 ET
Table 'ADA675920511' 6-max Seat #1 is the button
Seat 1: Prateek1986 ($12832 in chips)
Seat 2: sherpalife ($46506 in chips)
Seat 3: slotmachine ($55682 in chips)
Seat 4: Sam565 ($9104 in chips)
Seat 5: TurnOnTuneInDropOut ($83439 in chips)
Seat 6: soundfsilenz ($43531 in chips)
sherpalife: posts small blind $200
slotmachine: posts big blind $400
*** HOLE CARDS ***
Dealt to TurnOnTuneInDropOut [Tc 7s 9h 3c]
Sam565: folds
TurnOnTuneInDropOut: folds
soundfsilenz: raises $1000 to $1400
Prateek1986: raises $3400 to $4800
sherpalife: folds
slotmachine: folds
soundfsilenz: calls $3400
*** FLOP *** [4c 4h 6s]
soundfsilenz: checks
Prateek1986: bets $8032 and is all-in
soundfsilenz: folds
Uncalled bet ($8032) returned to Prateek1986
Prateek1986 collected $9791 from pot
Prateek1986: doesn't show hand
*** SUMMARY ***
Total pot $10200 | Rake $409
Board [4c 4h 6s]
Seat 1: Prateek1986 (button) collected ($9791)
Seat 2: sherpalife (small blind) folded before Flop
Seat 3: slotmachine (big blind) folded before Flop
Seat 4: Sam565 folded before Flop (didn't bet)
Seat 5: TurnOnTuneInDropOut folded before Flop (didn't bet)
Seat 6: soundfsilenz folded on the Flop

PokerStars Hand #1255059778: Omaha Pot Limit ($200/$400 USD) - 2020/10/23 14:37:54 ET
Table 'ADA675920511' 6-max Seat #2 is the button
Seat 1: Prateek1986 ($17823 in chips)
Seat 2: sherpalife ($46306 in chips)
Seat 3: slotmachine ($55282 in chips)
Seat 4: Sam565 ($9104 in chips)
Seat 5: TurnOnTuneInDropOut ($83439 in chips)
Seat 6: soundfsilenz ($38731 in chips)
slotmachine: posts small blind $200
Sam565: posts big blind $400
*** HOLE CARDS ***
Dealt to TurnOnTuneInDropOut [4d 7h 3c 9d]
TurnOnTuneInDropOut: folds
soundfsilenz: folds
Prateek1986: raises $1000 to $1400
sherpalife: folds
slotmachine: folds
Sam565: calls $1000
*** FLOP *** [8d Qc 8c]
Sam565: checks
Prateek1986: bets $3000
Sam565: calls $3000
*** TURN *** [8d Qc 8c] [Ad]
Sam565: bets $4704 and is all-in
Prateek1986: calls $4704
*** RIVER *** [8d Qc 8c Ad] [Ts]
*** SHOW DOWN ***
Sam565: shows [Jd Ac 6s 9c]
Prateek1986: shows [Qd 7c Kd 6c]
Sam565 collected $17670 from pot
*** SUMMARY ***
Total pot $18408 | Rake $738
Board [8d Qc 8c Ad Ts]
Seat 1: Prateek1986 showed [Qd 7c Kd 6c] and lost
Seat 2: sherpalife (button) folded before Flop (didn't bet)
Seat 3: slotmachine (small blind) folded before Flop
Seat 4: Sam565 (big blind) showed [Jd Ac 6s 9c] and won ($17670)
Seat 5: TurnOnTuneInDropOut folded before Flop (didn't bet)
Seat 6: soundfsilenz folded before Flop (didn't bet)

PokerStars Hand #1255059779: Omaha Pot Limit ($200/$400 USD) - 2020/10/23 14:39:00 ET
Table 'ADA675920511' 6-max Seat #3 is the button
Seat 1: Prateek1986 ($8719 in chips)
Seat 2: sherpalife ($46306 in chips)
Seat 3: slotmachine ($55082 in chips)
Seat 4: Sam565 ($17670 in chips)
Seat 5: TurnOnTuneInDropOut ($83439 in chips)
Seat 6: soundfsilenz ($38731 in chips)
Sam565: posts small blind $200
TurnOnTuneInDropOut: posts big blind $400
*** HOLE CARDS ***
Dealt to TurnOnTuneInDropOut [5c Qc 9s 2c]
soundfsilenz: folds
Prateek1986: raises $1000 to $1400
sherpalife: raises $3400 to $4800
slotmachine: folds
Sam565: folds
TurnOnTuneInDropOut: folds
Prateek1986: raises $3919 to $8719 and is all-in
sherpalife: calls $3919
*** FLOP *** [Ts Ah 4h]
*** TURN *** [Ts Ah 4h] [7h]
*** RIVER *** [Ts Ah 4h 7h] [8h]
*** SHOW DOWN ***
Prateek1986: shows [4c 3c Td 3d]
sherpalife: shows [Kc Tc Qh Ks]
Prateek1986 collected $17315 from pot
*** SUMMARY ***
Total pot $18038 | Rake $723
Board [Ts Ah 4h 7h 8h]
Seat 1: Prateek1986 showed [4c 3c Td 3d] and won ($17315)
Seat 2: sherpalife showed [Kc Tc Qh Ks] and lost
Seat 3: slotmachine (button) folded before Flop (didn't bet)
Seat 4: Sam565 (small blind) folded before Flop
Seat 5: TurnOnTuneInDropOut (big blind) folded before Flop
Seat 6: soundfsilenz folded before Flop (didn't bet)

PokerStars Hand #1255059781: Omaha Pot Limit ($200/$400 USD) - 2020/10/23 14:40:34 ET
Table 'ADA675920511' 6-max Seat #5 is the button
Seat 1: Prateek1986 ($17315 in chips)
Seat 2: sherpalife ($46850 in chips)
Seat 3: slotmachine ($45638 in chips)
Seat 4: Sam565 ($17470 in chips)
Seat 5: TurnOnTuneInDropOut ($82839 in chips)
Seat 6: soundfsilenz ($38331 in chips)
soundfsilenz: posts small blind $200
Prateek1986: posts big blind $400
*** HOLE CARDS ***
Dealt to TurnOnTuneInDropOut [Ad Qh 9c 5h]
sherpalife: folds
slotmachine: raises $1000 to $1400
Sam565: folds
TurnOnTuneInDropOut: folds
soundfsilenz: folds
Prateek1986: raises $3000 to $4400
slotmachine: raises $9000 to $13400
Prateek1986: raises $3915 to $17315 and is all-in
slotmachine: calls $3915
*** FLOP *** [Qs Qd 5s]
*** TURN *** [Qs Qd 5s] [8h]
*** RIVER *** [Qs Qd 5s 8h] [Kc]
*** SHOW DOWN ***
Prateek1986: shows [6c Jh 2c Jc]
slotmachine: shows [3c Kh Kd 6s]
slotmachine collected $34030 from pot
*** SUMMARY ***
Total pot $34830 | Rake $800
Board [Qs Qd 5s 8h Kc]
Seat 1: Prateek1986 (big blind) showed [6c Jh 2c Jc] and lost
Seat 2: sherpalife folded before Flop (didn't bet)
Seat 3: slotmachine showed [3c Kh Kd 6s] and won ($34030)
Seat 4: Sam565 folded before Flop (didn't bet)
Seat 5: TurnOnTuneInDropOut (button) folded before Flop (didn't bet)
Seat 6: soundfsilenz (small blind) folded before Flop

PokerStars Hand #1255059782: Omaha Pot Limit ($200/$400 USD) - 2020/10/23 14:41:21 ET
Table 'ADA675920511' 6-max Seat #6 is the button
Seat 2: sherpalife ($46850 in chips)
Seat 3: slotmachine ($62353 in chips)
Seat 4: Sam565 ($17470 in chips)
Seat 5: TurnOnTuneInDropOut ($82839 in chips)
Seat 6: soundfsilenz ($38131 in chips)
sherpalife: posts small blind $200
slotmachine: posts big blind $400
*** HOLE CARDS ***
Dealt to TurnOnTuneInDropOut [3c 5c 7h 8d]
Sam565: folds
TurnOnTuneInDropOut: folds
soundfsilenz: folds
sherpalife: calls $200
slotmachine: checks
*** FLOP *** [2h 9c Kc]
sherpalife: bets $400
slotmachine: raises $1600 to $2000
sherpalife: calls $1600
*** TURN *** [2h 9c Kc] [9s]
sherpalife: checks
slotmachine: bets $2400
sherpalife: calls $2400
*** RIVER *** [2h 9c Kc 9s] [Td]
sherpalife: checks
slotmachine: bets $4800
sherpalife: calls $4800
*** SHOW DOWN ***
sherpalife: mucks hand
slotmachine: shows [9h 6c Jh 9d]
slotmachine collected $18430 from pot
*** SUMMARY ***
Total pot $19200 | Rake $770
Board [2h 9c Kc 9s Td]
Seat 2: sherpalife (small blind) mucked
Seat 3: slotmachine (big blind) showed [9h 6c Jh 9d] and won ($18430)
Seat 4: Sam565 folded before Flop (didn't bet)
Seat 5: TurnOnTuneInDropOut folded before Flop (didn't bet)
Seat 6: soundfsilenz (button) folded before Flop (didn't bet)

PokerStars Hand #1109334719: Omaha Pot Limit ($200/$400 USD) - 2020/10/23 12:32:26 ET
Table 'ADA722387266' 6-max Seat #3 is the button
Seat 1: aakashchak76 ($47600 in chips)
Seat 2: TurnOnTuneInDropOut ($48000 in chips)
Seat 3: slotmachine ($45975 in chips)
aakashchak76: posts small blind $200
TurnOnTuneInDropOut: posts big blind $400
*** HOLE CARDS ***
Dealt to TurnOnTuneInDropOut [3c 5s Qc Qs]
slotmachine: folds
aakashchak76: calls $200
TurnOnTuneInDropOut: raises $800 to $1200
aakashchak76: calls $800
*** FLOP *** [5h 9c 8s]
aakashchak76: bets $400
TurnOnTuneInDropOut: calls $400
*** TURN *** [5h 9c 8s] [8d]
aakashchak76: checks
TurnOnTuneInDropOut: checks
*** RIVER *** [5h 9c 8s 8d] [Ac]
aakashchak76: checks
TurnOnTuneInDropOut: checks
*** SHOW DOWN ***
aakashchak76: shows [Qd 7h 4c Tc]
TurnOnTuneInDropOut: shows [3c 5s Qc Qs]
TurnOnTuneInDropOut collected $3072 from pot
*** SUMMARY ***
Total pot $3200 | Rake $128
Board [5h 9c 8s 8d Ac]
Seat 1: aakashchak76 (small blind) showed [Qd 7h 4c Tc] and lost
Seat 2: TurnOnTuneInDropOut (big blind) showed [3c 5s Qc Qs] and won ($3072)
Seat 3: slotmachine (button) folded before Flop (didn't bet)

PokerStars Hand #1109334720: Omaha Pot Limit ($200/$400 USD) - 2020/10/23 12:32:59 ET
Table 'ADA722387266' 6-max Seat #1 is the button
Seat 1: aakashchak76 ($46000 in chips)
Seat 2: TurnOnTuneInDropOut ($49472 in chips)
Seat 3: slotmachine ($45975 in chips)
TurnOnTuneInDropOut: posts small blind $200
slotmachine: posts big blind $400
*** HOLE CARDS ***
Dealt to TurnOnTuneInDropOut [8c As Tc 5h]
aakashchak76: folds
TurnOnTuneInDropOut: raises $800 to $1200
slotmachine: calls $800
*** FLOP *** [2d Jc Js]
TurnOnTuneInDropOut: bets $592
slotmachine: calls $592
*** TURN *** [2d Jc Js] [Qc]
TurnOnTuneInDropOut: bets $2366
slotmachine: calls $2366
*** RIVER *** [2d Jc Js Qc] [9s]
TurnOnTuneInDropOut: checks
slotmachine: checks
*** SHOW DOWN ***
TurnOnTuneInDropOut: shows [8c As Tc 5h]
slotmachine: mucks hand
TurnOnTuneInDropOut collected $7983 from pot
*** SUMMARY ***
Total pot $8316 | Rake $333
Board [2d Jc Js Qc 9s]
Seat 1: aakashchak76 (button) folded before Flop (didn't bet)
Seat 2: TurnOnTuneInDropOut (small blind) showed [8c As Tc 5h] and won ($7983)
Seat 3: slotmachine (big blind) mucked

PokerStars Hand #1109334721: Omaha Pot Limit ($200/$400 USD) - 2020/10/23 12:34:05 ET
Table 'ADA722387266' 6-max Seat #2 is the button
Seat 1: aakashchak76 ($46000 in chips)
Seat 2: TurnOnTuneInDropOut ($53297 in chips)
Seat 3: slotmachine ($41817 in chips)
slotmachine: posts small blind $200
aakashchak76: posts big blind $400
*** HOLE CARDS ***
Dealt to TurnOnTuneInDropOut [As Qh Ac 4h]
TurnOnTuneInDropOut: raises $1000 to $1400
slotmachine: folds
aakashchak76: calls $1000
*** FLOP *** [9c 5d 5c]
aakashchak76: bets $3000
TurnOnTuneInDropOut: calls $3000
*** TURN *** [9c 5d 5c] [7s]
aakashchak76: bets $9000
TurnOnTuneInDropOut: calls $9000
*** RIVER *** [9c 5d 5c 7s] [2c]
aakashchak76: bets $27000
TurnOnTuneInDropOut: folds
Uncalled bet ($27000) returned to aakashchak76
aakashchak76 collected $26300 from pot
aakashchak76: doesn't show hand
*** SUMMARY ***
Total pot $27000 | Rake $700
Board [9c 5d 5c 7s 2c]
Seat 1: aakashchak76 (big blind) collected ($26300)
Seat 2: TurnOnTuneInDropOut (button) folded on the River
Seat 3: slotmachine (small blind) folded before Flop

PokerStars Hand #1109334722: Omaha Pot Limit ($200/$400 USD) - 2020/10/23 12:35:10 ET
Table 'ADA722387266' 6-max Seat #3 is the button
Seat 1: aakashchak76 ($58900 in chips)
Seat 2: TurnOnTuneInDropOut ($48000 in chips)
Seat 3: slotmachine ($41617 in chips)
aakashchak76: posts small blind $200
TurnOnTuneInDropOut: posts big blind $400
*** HOLE CARDS ***
Dealt to TurnOnTuneInDropOut [9d 7s 6s 8c]
slotmachine: folds
aakashchak76: calls $200
TurnOnTuneInDropOut: raises $800 to $1200
aakashchak76: calls $800
*** FLOP *** [Ac 8s Jc]
aakashchak76: checks
TurnOnTuneInDropOut: bets $1200
aakashchak76: folds
Uncalled bet ($1200) returned to TurnOnTuneInDropOut
TurnOnTuneInDropOut collected $2304 from pot
TurnOnTuneInDropOut: doesn't show hand
*** SUMMARY ***
Total pot $2400 | Rake $96
Board [Ac 8s Jc]
Seat 1: aakashchak76 (small blind) folded on the Flop
Seat 2: TurnOnTuneInDropOut (big blind) collected ($2304)
Seat 3: slotmachine (button) folded before Flop (didn't bet)

PokerStars Hand #1109334786: Omaha Pot Limit ($200/$400 USD) - 2020/10/23 13:24:42 ET
Table 'ADA722387266' 6-max Seat #5 is the button
Seat 1: Lock2k16 ($24500 in chips)
Seat 2: TurnOnTuneInDropOut ($30000 in chips)
Seat 3: slotmachine ($49772 in chips)
Seat 4: XirT ($20466 in chips)
Seat 5: kimjongun ($34902 in chips)
Lock2k16: posts small blind $200
TurnOnTuneInDropOut: posts big blind $400
*** HOLE CARDS ***
Dealt to TurnOnTuneInDropOut [4c Qc 2s Th]
slotmachine: folds
XirT: folds
kimjongun: raises $1000 to $1400
Lock2k16: calls $1200
TurnOnTuneInDropOut: folds
*** FLOP *** [4s Ad Kd]
Lock2k16: checks
kimjongun: checks
*** TURN *** [4s Ad Kd] [As]
Lock2k16: bets $800
kimjongun: raises $3400 to $4200
Lock2k16: folds
Uncalled bet ($3400) returned to kimjongun
kimjongun collected $4608 from pot
kimjongun: doesn't show hand
*** SUMMARY ***
Total pot $4800 | Rake $192
Board [4s Ad Kd As]
Seat 1: Lock2k16 (small blind) folded on the Turn
Seat 2: TurnOnTuneInDropOut (big blind) folded before Flop
Seat 3: slotmachine folded before Flop (didn't bet)
Seat 4: XirT folded before Flop (didn't bet)
Seat 5: kimjongun (button) collected ($4608)

PokerStars Hand #1109334787: Omaha Pot Limit ($200/$400 USD) - 2020/10/23 13:25:44 ET
Table 'ADA722387266' 6-max Seat #1 is the button
Seat 1: Lock2k16 ($22300 in chips)
Seat 2: TurnOnTuneInDropOut ($29600 in chips)
Seat 3: slotmachine ($49772 in chips)
Seat 4: XirT ($20466 in chips)
Seat 5: kimjongun ($37310 in chips)
TurnOnTuneInDropOut: posts small blind $200
slotmachine: posts big blind $400
*** HOLE CARDS ***
Dealt to TurnOnTuneInDropOut [Td 2h Kd Ah]
XirT: folds
kimjongun: folds
Lock2k16: raises $400 to $800
TurnOnTuneInDropOut: raises $2000 to $2800
slotmachine: calls $2400
Lock2k16: calls $2000
*** FLOP *** [8d 7c 4s]
TurnOnTuneInDropOut: checks
slotmachine: checks
Lock2k16: bets $1200
TurnOnTuneInDropOut: folds
slotmachine: calls $1200
*** TURN *** [8d 7c 4s] [2c]
slotmachine: checks
Lock2k16: checks
*** RIVER *** [8d 7c 4s 2c] [4h]
slotmachine: checks
Lock2k16: checks
*** SHOW DOWN ***
slotmachine: mucks hand
Lock2k16: shows [Ks Tc Kc Ts]
Lock2k16 collected $10367 from pot
*** SUMMARY ***
Total pot $10800 | Rake $433
Board [8d 7c 4s 2c 4h]
Seat 1: Lock2k16 (button) showed [Ks Tc Kc Ts] and won ($10367)
Seat 2: TurnOnTuneInDropOut (small blind) folded on the Flop
Seat 3: slotmachine (big blind) mucked
Seat 4: XirT folded before Flop (didn't bet)
Seat 5: kimjongun folded before Flop (didn't bet)

PokerStars Hand #1109334791: Omaha Pot Limit ($200/$400 USD) - 2020/10/23 13:29:44 ET
Table 'ADA722387266' 6-max Seat #5 is the button
Seat 1: Lock2k16 ($29347 in chips)
Seat 2: TurnOnTuneInDropOut ($26800 in chips)
Seat 3: slotmachine ($49851 in chips)
Seat 4: XirT ($17866 in chips)
Seat 5: kimjongun ($33910 in chips)
Seat 6: vaibz16 ($12543 in chips)
vaibz16: posts small blind $200
Lock2k16: posts big blind $400
*** HOLE CARDS ***
Dealt to TurnOnTuneInDropOut [9d 5c As 3s]
TurnOnTuneInDropOut: folds
slotmachine: folds
XirT: calls $400
kimjongun: folds
vaibz16: folds
Lock2k16: raises $1000 to $1400
XirT: calls $1000
*** FLOP *** [9c Kh 7c]
Lock2k16: checks
XirT: bets $3000
Lock2k16: calls $3000
*** TURN *** [9c Kh 7c] [Jc]
Lock2k16: checks
XirT: checks
*** RIVER *** [9c Kh 7c Jc] [Qh]
Lock2k16: checks
XirT: checks
*** SHOW DOWN ***
Lock2k16: mucks hand
XirT: shows [4d Jd Kc Ks]
XirT collected $8639 from pot
*** SUMMARY ***
Total pot $9000 | Rake $361
Board [9c Kh 7c Jc Qh]
Seat 1: Lock2k16 (big blind) mucked
Seat 2: TurnOnTuneInDropOut folded before Flop (didn't bet)
Seat 3: slotmachine folded before Flop (didn't bet)
Seat 4: XirT showed [4d Jd Kc Ks] and won ($8639)
Seat 5: kimjongun (button) folded before Flop (didn't bet)
Seat 6: vaibz16 (small blind) folded before Flop

PokerStars Hand #1109334793: Omaha Pot Limit ($200/$400 USD) - 2020/10/23 13:31:45 ET
Table 'ADA722387266' 6-max Seat #1 is the button
Seat 1: Lock2k16 ($24147 in chips)
Seat 2: TurnOnTuneInDropOut ($39143 in chips)
Seat 3: slotmachine ($49851 in chips)
Seat 4: XirT ($22105 in chips)
Seat 5: kimjongun ($33910 in chips)
TurnOnTuneInDropOut: posts small blind $200
slotmachine: posts big blind $400
*** HOLE CARDS ***
Dealt to TurnOnTuneInDropOut [2s 2h 2d As]
XirT: folds
kimjongun: folds
Lock2k16: raises $400 to $800
TurnOnTuneInDropOut: folds
slotmachine: folds
Uncalled bet ($400) returned to Lock2k16
Lock2k16 collected $1000 from pot
Lock2k16: doesn't show hand
*** SUMMARY ***
Total pot $1000 | Rake $0
Seat 1: Lock2k16 (button) collected ($1000)
Seat 2: TurnOnTuneInDropOut (small blind) folded before Flop
Seat 3: slotmachine (big blind) folded before Flop
Seat 4: XirT folded before Flop (didn't bet)
Seat 5: kimjongun folded before Flop (didn't bet)

PokerStars Hand #1109334794: Omaha Pot Limit ($200/$400 USD) - 2020/10/23 13:32:00 ET
Table 'ADA722387266' 6-max Seat #2 is the button
Seat 1: Lock2k16 ($24747 in chips)
Seat 2: TurnOnTuneInDropOut ($38943 in chips)
Seat 3: slotmachine ($49451 in chips)
Seat 4: XirT ($22105 in chips)
Seat 5: kimjongun ($33910 in chips)
Seat 6: vaibz16 ($12000 in chips)
slotmachine: posts small blind $200
XirT: posts big blind $400
*** HOLE CARDS ***
Dealt to TurnOnTuneInDropOut [Qh 4h Jh 8s]
kimjongun: folds
vaibz16: folds
Lock2k16: raises $1000 to $1400
TurnOnTuneInDropOut: folds
slotmachine: folds
XirT: folds
Uncalled bet ($1000) returned to Lock2k16
Lock2k16 collected $1000 from pot
Lock2k16: doesn't show hand
*** SUMMARY ***
Total pot $1000 | Rake $0
Seat 1: Lock2k16 collected ($1000)
Seat 2: TurnOnTuneInDropOut (button) folded before Flop (didn't bet)
Seat 3: slotmachine (small blind) folded before Flop
Seat 4: XirT (big blind) folded before Flop
Seat 5: kimjongun folded before Flop (didn't bet)
Seat 6: vaibz16 folded before Flop (didn't bet)

PokerStars Hand #1109334796: Omaha Pot Limit ($200/$400 USD) - 2020/10/23 13:33:36 ET
Table 'ADA722387266' 6-max Seat #4 is the button
Seat 1: Lock2k16 ($62094 in chips)
Seat 2: TurnOnTuneInDropOut ($38943 in chips)
Seat 3: slotmachine ($49251 in chips)
Seat 4: XirT ($21505 in chips)
Seat 5: kimjongun ($8563 in chips)
kimjongun: posts small blind $200
Lock2k16: posts big blind $400
*** HOLE CARDS ***
Dealt to TurnOnTuneInDropOut [3h 4s 4h 6s]
TurnOnTuneInDropOut: folds
slotmachine: raises $1000 to $1400
XirT: folds
kimjongun: folds
Lock2k16: folds
Uncalled bet ($1000) returned to slotmachine
slotmachine collected $1000 from pot
slotmachine: doesn't show hand
*** SUMMARY ***
Total pot $1000 | Rake $0
Seat 1: Lock2k16 (big blind) folded before Flop
Seat 2: TurnOnTuneInDropOut folded before Flop (didn't bet)
Seat 3: slotmachine collected ($1000)
Seat 4: XirT (button) folded before Flop (didn't bet)
Seat 5: kimjongun (small blind) folded before Flop

PokerStars Hand #1109334797: Omaha Pot Limit ($200/$400 USD) - 2020/10/23 13:34:06 ET
Table 'ADA722387266' 6-max Seat #5 is the button
Seat 1: Lock2k16 ($61694 in chips)
Seat 2: TurnOnTuneInDropOut ($38943 in chips)
Seat 3: slotmachine ($49851 in chips)
Seat 4: XirT ($21505 in chips)
Seat 5: kimjongun ($8363 in chips)
Lock2k16: posts small blind $200
TurnOnTuneInDropOut: posts big blind $400
*** HOLE CARDS ***
Dealt to TurnOnTuneInDropOut [Jh 4d Ts Jd]
slotmachine: folds
XirT: raises $1000 to $1400
kimjongun: folds
Lock2k16: folds
TurnOnTuneInDropOut: calls $1000
*** FLOP *** [6s 7c 9d]
TurnOnTuneInDropOut: checks
XirT: checks
*** TURN *** [6s 7c 9d] [9s]
TurnOnTuneInDropOut: checks
XirT: bets $3000
TurnOnTuneInDropOut: calls $3000
*** RIVER *** [6s 7c 9d 9s] [2h]
TurnOnTuneInDropOut: checks
XirT: checks
*** SHOW DOWN ***
TurnOnTuneInDropOut: shows [Jh 4d Ts Jd]
XirT: mucks hand
TurnOnTuneInDropOut collected $8639 from pot
*** SUMMARY ***
Total pot $9000 | Rake $361
Board [6s 7c 9d 9s 2h]
Seat 1: Lock2k16 (small blind) folded before Flop
Seat 2: TurnOnTuneInDropOut (big blind) showed [Jh 4d Ts Jd] and won ($8639)
Seat 3: slotmachine folded before Flop (didn't bet)
Seat 4: XirT mucked
Seat 5: kimjongun (button) folded before Flop (didn't bet)

PokerStars Hand #1109334799: Omaha Pot Limit ($200/$400 USD) - 2020/10/23 13:35:47 ET
Table 'ADA722387266' 6-max Seat #2 is the button
Seat 1: Lock2k16 ($62630 in chips)
Seat 2: TurnOnTuneInDropOut ($42782 in chips)
Seat 3: slotmachine ($49451 in chips)
Seat 4: XirT ($16705 in chips)
Seat 5: kimjongun ($8363 in chips)
slotmachine: posts small blind $200
XirT: posts big blind $400
*** HOLE CARDS ***
Dealt to TurnOnTuneInDropOut [8c 6c Jh Jd]
kimjongun: folds
Lock2k16: raises $400 to $800
TurnOnTuneInDropOut: calls $800
slotmachine: folds
XirT: folds
*** FLOP *** [Ah 8d Th]
Lock2k16: bets $1650
TurnOnTuneInDropOut: folds
Uncalled bet ($1650) returned to Lock2k16
Lock2k16 collected $2112 from pot
Lock2k16: doesn't show hand
*** SUMMARY ***
Total pot $2200 | Rake $88
Board [Ah 8d Th]
Seat 1: Lock2k16 collected ($2112)
Seat 2: TurnOnTuneInDropOut (button) folded on the Flop
Seat 3: slotmachine (small blind) folded before Flop
Seat 4: XirT (big blind) folded before Flop
Seat 5: kimjongun folded before Flop (didn't bet)

PokerStars Hand #1109334802: Omaha Pot Limit ($200/$400 USD) - 2020/10/23 13:38:38 ET
Table 'ADA722387266' 6-max Seat #5 is the button
Seat 1: Lock2k16 ($62742 in chips)
Seat 2: TurnOnTuneInDropOut ($47111 in chips)
Seat 3: slotmachine ($49251 in chips)
Seat 4: XirT ($17425 in chips)
Seat 5: kimjongun ($27785 in chips)
Seat 6: vaibz16 ($7050 in chips)
vaibz16: posts small blind $200
Lock2k16: posts big blind $400
*** HOLE CARDS ***
Dealt to TurnOnTuneInDropOut [9d Tc As Js]
TurnOnTuneInDropOut: raises $1000 to $1400
slotmachine: calls $1400
XirT: folds
kimjongun: raises $4800 to $6200
vaibz16: folds
Lock2k16: folds
TurnOnTuneInDropOut: folds
slotmachine: calls $4800
*** FLOP *** [Jc Ts 2c]
slotmachine: checks
kimjongun: bets $14400
slotmachine: folds
Uncalled bet ($14400) returned to kimjongun
kimjongun collected $13823 from pot
kimjongun: doesn't show hand
*** SUMMARY ***
Total pot $14400 | Rake $577
Board [Jc Ts 2c]
Seat 1: Lock2k16 (big blind) folded before Flop
Seat 2: TurnOnTuneInDropOut folded before Flop
Seat 3: slotmachine folded on the Flop
Seat 4: XirT folded before Flop (didn't bet)
Seat 5: kimjongun (button) collected ($13823)
Seat 6: vaibz16 (small blind) folded before Flop

PokerStars Hand #1109334803: Omaha Pot Limit ($200/$400 USD) - 2020/10/23 13:39:26 ET
Table 'ADA722387266' 6-max Seat #6 is the button
Seat 1: Lock2k16 ($62342 in chips)
Seat 2: TurnOnTuneInDropOut ($45711 in chips)
Seat 3: slotmachine ($43051 in chips)
Seat 4: XirT ($17425 in chips)
Seat 5: kimjongun ($35408 in chips)
Seat 6: vaibz16 ($22673 in chips)
Lock2k16: posts small blind $200
TurnOnTuneInDropOut: posts big blind $400
*** HOLE CARDS ***
Dealt to TurnOnTuneInDropOut [3d 7h Kc Qd]
slotmachine: folds
XirT: folds
kimjongun: raises $1000 to $1400
vaibz16: folds
Lock2k16: calls $1200
TurnOnTuneInDropOut: folds
*** FLOP *** [Qh Kd 6s]
Lock2k16: bets $1600
kimjongun: folds
Uncalled bet ($1600) returned to Lock2k16
Lock2k16 collected $3072 from pot
Lock2k16: doesn't show hand
*** SUMMARY ***
Total pot $3200 | Rake $128
Board [Qh Kd 6s]
Seat 1: Lock2k16 (small blind) collected ($3072)
Seat 2: TurnOnTuneInDropOut (big blind) folded before Flop
Seat 3: slotmachine folded before Flop (didn't bet)
Seat 4: XirT folded before Flop (didn't bet)
Seat 5: kimjongun folded on the Flop
Seat 6: vaibz16 (button) folded before Flop (didn't bet)

PokerStars Hand #1109334804: Omaha Pot Limit ($200/$400 USD) - 2020/10/23 13:40:03 ET
Table 'ADA722387266' 6-max Seat #1 is the button
Seat 1: Lock2k16 ($64014 in chips)
Seat 2: TurnOnTuneInDropOut ($45311 in chips)
Seat 3: slotmachine ($43051 in chips)
Seat 4: XirT ($17425 in chips)
Seat 5: kimjongun ($34008 in chips)
Seat 6: vaibz16 ($22673 in chips)
TurnOnTuneInDropOut: posts small blind $200
slotmachine: posts big blind $400
*** HOLE CARDS ***
Dealt to TurnOnTuneInDropOut [3h 5s 8d Ad]
XirT: folds
kimjongun: folds
vaibz16: raises $1000 to $1400
Lock2k16: calls $1400
TurnOnTuneInDropOut: folds
slotmachine: raises $4400 to $5800
vaibz16: calls $4400
Lock2k16: calls $4400
*** FLOP *** [Kc Kd 3c]
slotmachine: bets $5808
vaibz16: calls $5808
Lock2k16: raises $35024 to $40832
slotmachine: folds
vaibz16: folds
Uncalled bet ($35024) returned to Lock2k16
Lock2k16 collected $34224 from pot
Lock2k16: doesn't show hand
*** SUMMARY ***
Total pot $35024 | Rake $800
Board [Kc Kd 3c]
Seat 1: Lock2k16 (button) collected ($34224)
Seat 2: TurnOnTuneInDropOut (small blind) folded before Flop
Seat 3: slotmachine (big blind) folded on the Flop
Seat 4: XirT folded before Flop (didn't bet)
Seat 5: kimjongun folded before Flop (didn't bet)
Seat 6: vaibz16 folded on the Flop

PokerStars Hand #1109334808: Omaha Pot Limit ($200/$400 USD) - 2020/10/23 13:44:32 ET
Table 'ADA722387266' 6-max Seat #5 is the button
Seat 1: Lock2k16 ($83762 in chips)
Seat 2: TurnOnTuneInDropOut ($56255 in chips)
Seat 3: slotmachine ($47800 in chips)
Seat 4: XirT ($16825 in chips)
Seat 5: kimjongun ($29367 in chips)
Seat 6: vaibz16 ($11713 in chips)
vaibz16: posts small blind $200
Lock2k16: posts big blind $400
*** HOLE CARDS ***
Dealt to TurnOnTuneInDropOut [6c 5d 3s Ts]
TurnOnTuneInDropOut: folds
slotmachine: raises $1000 to $1400
XirT: folds
kimjongun: folds
vaibz16: folds
Lock2k16: calls $1000
*** FLOP *** [Ah 9d 8h]
Lock2k16: checks
slotmachine: checks
*** TURN *** [Ah 9d 8h] [7c]
Lock2k16: bets $2250
slotmachine: folds
Uncalled bet ($2250) returned to Lock2k16
Lock2k16 collected $2880 from pot
Lock2k16: doesn't show hand
*** SUMMARY ***
Total pot $3000 | Rake $120
Board [Ah 9d 8h 7c]
Seat 1: Lock2k16 (big blind) collected ($2880)
Seat 2: TurnOnTuneInDropOut folded before Flop (didn't bet)
Seat 3: slotmachine folded on the Turn
Seat 4: XirT folded before Flop (didn't bet)
Seat 5: kimjongun (button) folded before Flop (didn't bet)
Seat 6: vaibz16 (small blind) folded before Flop

PokerStars Hand #1109334810: Omaha Pot Limit ($200/$400 USD) - 2020/10/23 13:46:21 ET
Table 'ADA722387266' 6-max Seat #1 is the button
Seat 1: Lock2k16 ($93449 in chips)
Seat 2: TurnOnTuneInDropOut ($50255 in chips)
Seat 3: slotmachine ($46400 in chips)
Seat 4: XirT ($16825 in chips)
Seat 5: kimjongun ($29367 in chips)
Seat 6: vaibz16 ($13288 in chips)
TurnOnTuneInDropOut: posts small blind $200
slotmachine: posts big blind $400
*** HOLE CARDS ***
Dealt to TurnOnTuneInDropOut [Qd 5s 3c Js]
XirT: folds
kimjongun: folds
vaibz16: folds
Lock2k16: raises $400 to $800
TurnOnTuneInDropOut: folds
slotmachine: folds
Uncalled bet ($400) returned to Lock2k16
Lock2k16 collected $1000 from pot
Lock2k16: doesn't show hand
*** SUMMARY ***
Total pot $1000 | Rake $0
Seat 1: Lock2k16 (button) collected ($1000)
Seat 2: TurnOnTuneInDropOut (small blind) folded before Flop
Seat 3: slotmachine (big blind) folded before Flop
Seat 4: XirT folded before Flop (didn't bet)
Seat 5: kimjongun folded before Flop (didn't bet)
Seat 6: vaibz16 folded before Flop (didn't bet)

PokerStars Hand #1109334811: Omaha Pot Limit ($200/$400 USD) - 2020/10/23 13:46:44 ET
Table 'ADA722387266' 6-max Seat #2 is the button
Seat 1: Lock2k16 ($94049 in chips)
Seat 2: TurnOnTuneInDropOut ($50055 in chips)
Seat 3: slotmachine ($46000 in chips)
Seat 4: XirT ($16825 in chips)
Seat 5: kimjongun ($29367 in chips)
Seat 6: vaibz16 ($13288 in chips)
slotmachine: posts small blind $200
XirT: posts big blind $400
*** HOLE CARDS ***
Dealt to TurnOnTuneInDropOut [Ts 4c 9c Js]
kimjongun: folds
vaibz16: folds
Lock2k16: raises $1000 to $1400
TurnOnTuneInDropOut: folds
slotmachine: raises $3200 to $4600
XirT: folds
Lock2k16: folds
Uncalled bet ($3200) returned to slotmachine
slotmachine collected $3200 from pot
slotmachine: doesn't show hand
*** SUMMARY ***
Total pot $3200 | Rake $0
Seat 1: Lock2k16 folded before Flop
Seat 2: TurnOnTuneInDropOut (button) folded before Flop (didn't bet)
Seat 3: slotmachine (small blind) collected ($3200)
Seat 4: XirT (big blind) folded before Flop
Seat 5: kimjongun folded before Flop (didn't bet)
Seat 6: vaibz16 folded before Flop (didn't bet)

PokerStars Hand #1109334812: Omaha Pot Limit ($200/$400 USD) - 2020/10/23 13:47:21 ET
Table 'ADA722387266' 6-max Seat #3 is the button
Seat 1: Lock2k16 ($92649 in chips)
Seat 2: TurnOnTuneInDropOut ($50055 in chips)
Seat 3: slotmachine ($47800 in chips)
Seat 4: XirT ($16425 in chips)
Seat 5: kimjongun ($29367 in chips)
Seat 6: vaibz16 ($13288 in chips)
XirT: posts small blind $200
kimjongun: posts big blind $400
*** HOLE CARDS ***
Dealt to TurnOnTuneInDropOut [3s 9d 4c Jh]
vaibz16: raises $1000 to $1400
Lock2k16: folds
TurnOnTuneInDropOut: folds
slotmachine: folds
XirT: calls $1200
kimjongun: folds
*** FLOP *** [Ks 2c 6d]
XirT: checks
vaibz16: bets $1600
XirT: calls $1600
*** TURN *** [Ks 2c 6d] [7c]
XirT: checks
vaibz16: checks
*** RIVER *** [Ks 2c 6d 7c] [As]
XirT: checks
vaibz16: bets $4800
XirT: folds
Uncalled bet ($4800) returned to vaibz16
vaibz16 collected $6143 from pot
vaibz16: doesn't show hand
*** SUMMARY ***
Total pot $6400 | Rake $257
Board [Ks 2c 6d 7c As]
Seat 1: Lock2k16 folded before Flop (didn't bet)
Seat 2: TurnOnTuneInDropOut folded before Flop (didn't bet)
Seat 3: slotmachine (button) folded before Flop (didn't bet)
Seat 4: XirT (small blind) folded on the River
Seat 5: kimjongun (big blind) folded before Flop
Seat 6: vaibz16 collected ($6143)

PokerStars Hand #1109334813: Omaha Pot Limit ($200/$400 USD) - 2020/10/23 13:48:17 ET
Table 'ADA722387266' 6-max Seat #4 is the button
Seat 2: TurnOnTuneInDropOut ($50055 in chips)
Seat 3: slotmachine ($47800 in chips)
Seat 4: XirT ($13425 in chips)
Seat 5: kimjongun ($28967 in chips)
Seat 6: vaibz16 ($16431 in chips)
kimjongun: posts small blind $200
vaibz16: posts big blind $400
*** HOLE CARDS ***
Dealt to TurnOnTuneInDropOut [Qh 8h Kc 4c]
TurnOnTuneInDropOut: raises $1000 to $1400
slotmachine: folds
XirT: folds
kimjongun: folds
vaibz16: calls $1000
*** FLOP *** [6d Ts Th]
vaibz16: checks
TurnOnTuneInDropOut: bets $990
vaibz16: calls $990
*** TURN *** [6d Ts Th] [2d]
vaibz16: checks
TurnOnTuneInDropOut: checks
*** RIVER *** [6d Ts Th 2d] [Jh]
vaibz16: checks
TurnOnTuneInDropOut: checks
*** SHOW DOWN ***
vaibz16: shows [Qs 6s 8c 9s]
vaibz16 collected $4780 from pot
*** SUMMARY ***
Total pot $4980 | Rake $200
Board [6d Ts Th 2d Jh]
Seat 2: TurnOnTuneInDropOut
Seat 3: slotmachine folded before Flop (didn't bet)
Seat 4: XirT (button) folded before Flop (didn't bet)
Seat 5: kimjongun (small blind) folded before Flop
Seat 6: vaibz16 (big blind) showed [Qs 6s 8c 9s] and won ($4780)

PokerStars Hand #1109334814: Omaha Pot Limit ($200/$400 USD) - 2020/10/23 13:49:09 ET
Table 'ADA722387266' 6-max Seat #5 is the button
Seat 1: soundfsilenz ($42000 in chips)
Seat 2: TurnOnTuneInDropOut ($47665 in chips)
Seat 3: slotmachine ($47800 in chips)
Seat 4: XirT ($13425 in chips)
Seat 5: kimjongun ($28767 in chips)
Seat 6: vaibz16 ($18821 in chips)
vaibz16: posts small blind $200
soundfsilenz: posts big blind $400
*** HOLE CARDS ***
Dealt to TurnOnTuneInDropOut [9d Tc 2s Qd]
TurnOnTuneInDropOut: folds
slotmachine: folds
XirT: folds
kimjongun: folds
vaibz16: raises $800 to $1200
soundfsilenz: folds
Uncalled bet ($800) returned to vaibz16
vaibz16 collected $800 from pot
vaibz16: doesn't show hand
*** SUMMARY ***
Total pot $800 | Rake $0
Seat 1: soundfsilenz (big blind) folded before Flop
Seat 2: TurnOnTuneInDropOut folded before Flop (didn't bet)
Seat 3: slotmachine folded before Flop (didn't bet)
Seat 4: XirT folded before Flop (didn't bet)
Seat 5: kimjongun (button) folded before Flop (didn't bet)
Seat 6: vaibz16 (small blind) collected ($800)

PokerStars Hand #1109334815: Omaha Pot Limit ($200/$400 USD) - 2020/10/23 13:49:39 ET
Table 'ADA722387266' 6-max Seat #6 is the button
Seat 1: soundfsilenz ($41600 in chips)
Seat 2: TurnOnTuneInDropOut ($47665 in chips)
Seat 3: slotmachine ($47800 in chips)
Seat 4: XirT ($13425 in chips)
Seat 5: kimjongun ($28767 in chips)
Seat 6: vaibz16 ($19221 in chips)
soundfsilenz: posts small blind $200
TurnOnTuneInDropOut: posts big blind $400
*** HOLE CARDS ***
Dealt to TurnOnTuneInDropOut [9s 6h 6s 8d]
slotmachine: raises $1000 to $1400
XirT: calls $1400
kimjongun: folds
vaibz16: folds
soundfsilenz: raises $4600 to $6000
TurnOnTuneInDropOut: folds
slotmachine: folds
XirT: calls $4600
*** FLOP *** [5s 9d Jc]
soundfsilenz: bets $9246
XirT: calls $7425 and is all-in
Uncalled bet ($1821) returned to soundfsilenz
*** TURN *** [5s 9d Jc] [8h]
*** RIVER *** [5s 9d Jc 8h] [5d]
*** SHOW DOWN ***
soundfsilenz: shows [Ah 8c Ac 2d]
XirT: shows [Jh 6c Kc Ts]
soundfsilenz collected $27850 from pot
*** SUMMARY ***
Total pot $28650 | Rake $800
Board [5s 9d Jc 8h 5d]
Seat 1: soundfsilenz (small blind) showed [Ah 8c Ac 2d] and won ($27850)
Seat 2: TurnOnTuneInDropOut (big blind) folded before Flop
Seat 3: slotmachine folded before Flop
Seat 4: XirT showed [Jh 6c Kc Ts] and lost
Seat 5: kimjongun folded before Flop (didn't bet)
Seat 6: vaibz16 (button) folded before Flop (didn't bet)

PokerStars Hand #1109334816: Omaha Pot Limit ($200/$400 USD) - 2020/10/23 13:50:33 ET
Table 'ADA722387266' 6-max Seat #1 is the button
Seat 1: soundfsilenz ($56025 in chips)
Seat 2: TurnOnTuneInDropOut ($47265 in chips)
Seat 3: slotmachine ($46400 in chips)
Seat 5: kimjongun ($28767 in chips)
Seat 6: vaibz16 ($19221 in chips)
TurnOnTuneInDropOut: posts small blind $200
slotmachine: posts big blind $400
*** HOLE CARDS ***
Dealt to TurnOnTuneInDropOut [7s Qc Ts 9h]
kimjongun: folds
vaibz16: folds
soundfsilenz: folds
TurnOnTuneInDropOut: raises $800 to $1200
slotmachine: calls $800
*** FLOP *** [Tc 4s 3s]
TurnOnTuneInDropOut: checks
slotmachine: checks
*** TURN *** [Tc 4s 3s] [5d]
TurnOnTuneInDropOut: checks
slotmachine: checks
*** RIVER *** [Tc 4s 3s 5d] [3h]
TurnOnTuneInDropOut: checks
slotmachine: checks
*** SHOW DOWN ***
TurnOnTuneInDropOut: shows [7s Qc Ts 9h]
slotmachine: mucks hand
TurnOnTuneInDropOut collected $2304 from pot
*** SUMMARY ***
Total pot $2400 | Rake $96
Board [Tc 4s 3s 5d 3h]
Seat 1: soundfsilenz (button) folded before Flop (didn't bet)
Seat 2: TurnOnTuneInDropOut (small blind) showed [7s Qc Ts 9h] and won ($2304)
Seat 3: slotmachine (big blind) mucked
Seat 5: kimjongun folded before Flop (didn't bet)
Seat 6: vaibz16 folded before Flop (didn't bet)

PokerStars Hand #1109334817: Omaha Pot Limit ($200/$400 USD) - 2020/10/23 13:51:11 ET
Table 'ADA722387266' 6-max Seat #2 is the button
Seat 1: soundfsilenz ($56025 in chips)
Seat 2: TurnOnTuneInDropOut ($48369 in chips)
Seat 3: slotmachine ($45200 in chips)
Seat 4: Sam565 ($12462 in chips)
Seat 5: kimjongun ($28767 in chips)
Seat 6: vaibz16 ($19221 in chips)
slotmachine: posts small blind $200
Sam565: posts big blind $400
*** HOLE CARDS ***
Dealt to TurnOnTuneInDropOut [8s 4h Ac 8d]
kimjongun: folds
vaibz16: raises $1000 to $1400
soundfsilenz: raises $3400 to $4800
TurnOnTuneInDropOut: folds
slotmachine: folds
Sam565: calls $4400
vaibz16: calls $3400
*** FLOP *** [8h 4c 9c]
Sam565: bets $7662 and is all-in
vaibz16: calls $7662
soundfsilenz: raises $7662 to $15324
vaibz16: calls $6759 and is all-in
Uncalled bet ($903) returned to soundfsilenz
*** TURN *** [8h 4c 9c] [3h]
*** RIVER *** [8h 4c 9c 3h] [3s]
*** SHOW DOWN ***
vaibz16: shows [Th Jh Kd Td]
soundfsilenz: shows [Jd Tc Ah Qc]
vaibz16 collected $13518 from side pot
Sam565: shows [7h 9s Kh Kc]
Sam565 collected $36786 from main pot
*** SUMMARY ***
Total pot $51104 Main pot $36786. Side pot $13518. | Rake $800
Board [8h 4c 9c 3h 3s]
Seat 1: soundfsilenz showed [Jd Tc Ah Qc] and lost
Seat 2: TurnOnTuneInDropOut (button) folded before Flop (didn't bet)
Seat 3: slotmachine (small blind) folded before Flop
Seat 4: Sam565 (big blind) showed [7h 9s Kh Kc] and won ($36786)
Seat 5: kimjongun folded before Flop (didn't bet)
Seat 6: vaibz16 showed [Th Jh Kd Td] and won ($13518)

PokerStars Hand #1109334841: Omaha Pot Limit ($200/$400 USD) - 2020/10/23 14:12:06 ET
Table 'ADA722387266' 6-max Seat #4 is the button
Seat 1: soundfsilenz ($45605 in chips)
Seat 2: gaganhyd ($16539 in chips)
Seat 3: slotmachine ($43000 in chips)
Seat 4: mangeshnc ($19959 in chips)
Seat 5: kimjongun ($22926 in chips)
Seat 6: TurnOnTuneInDropOut ($48369 in chips)
kimjongun: posts small blind $200
TurnOnTuneInDropOut: posts big blind $400
*** HOLE CARDS ***
Dealt to TurnOnTuneInDropOut [8h 7d Ts 6c]
soundfsilenz: folds
gaganhyd: folds
slotmachine: raises $1000 to $1400
mangeshnc: folds
kimjongun: folds
TurnOnTuneInDropOut: folds
Uncalled bet ($1000) returned to slotmachine
slotmachine collected $1000 from pot
slotmachine: doesn't show hand
*** SUMMARY ***
Total pot $1000 | Rake $0
Seat 1: soundfsilenz folded before Flop (didn't bet)
Seat 2: gaganhyd folded before Flop (didn't bet)
Seat 3: slotmachine collected ($1000)
Seat 4: mangeshnc (button) folded before Flop (didn't bet)
Seat 5: kimjongun (small blind) folded before Flop
Seat 6: TurnOnTuneInDropOut (big blind) folded before Flop

PokerStars Hand #1109334842: Omaha Pot Limit ($200/$400 USD) - 2020/10/23 14:12:44 ET
Table 'ADA722387266' 6-max Seat #5 is the button
Seat 1: soundfsilenz ($45605 in chips)
Seat 2: gaganhyd ($16539 in chips)
Seat 3: slotmachine ($43600 in chips)
Seat 4: mangeshnc ($19959 in chips)
Seat 5: kimjongun ($22726 in chips)
Seat 6: TurnOnTuneInDropOut ($47969 in chips)
TurnOnTuneInDropOut: posts small blind $200
soundfsilenz: posts big blind $400
*** HOLE CARDS ***
Dealt to TurnOnTuneInDropOut [Kc Ts 6h 7h]
gaganhyd: folds
slotmachine: folds
mangeshnc: folds
kimjongun: raises $1000 to $1400
TurnOnTuneInDropOut: folds
soundfsilenz: folds
Uncalled bet ($1000) returned to kimjongun
kimjongun collected $1000 from pot
kimjongun: doesn't show hand
*** SUMMARY ***
Total pot $1000 | Rake $0
Seat 1: soundfsilenz (big blind) folded before Flop
Seat 2: gaganhyd folded before Flop (didn't bet)
Seat 3: slotmachine folded before Flop (didn't bet)
Seat 4: mangeshnc folded before Flop (didn't bet)
Seat 5: kimjongun (button) collected ($1000)
Seat 6: TurnOnTuneInDropOut (small blind) folded before Flop

PokerStars Hand #1109334843: Omaha Pot Limit ($200/$400 USD) - 2020/10/23 14:13:24 ET
Table 'ADA722387266' 6-max Seat #6 is the button
Seat 1: soundfsilenz ($45205 in chips)
Seat 2: gaganhyd ($16539 in chips)
Seat 3: slotmachine ($43600 in chips)
Seat 4: mangeshnc ($19959 in chips)
Seat 5: kimjongun ($23326 in chips)
Seat 6: TurnOnTuneInDropOut ($47769 in chips)
soundfsilenz: posts small blind $200
gaganhyd: posts big blind $400
*** HOLE CARDS ***
Dealt to TurnOnTuneInDropOut [Qc Ah 7d 6c]
slotmachine: raises $1000 to $1400
mangeshnc: folds
kimjongun: folds
TurnOnTuneInDropOut: folds
soundfsilenz: folds
gaganhyd: folds
Uncalled bet ($1000) returned to slotmachine
slotmachine collected $1000 from pot
slotmachine: doesn't show hand
*** SUMMARY ***
Total pot $1000 | Rake $0
Seat 1: soundfsilenz (small blind) folded before Flop
Seat 2: gaganhyd (big blind) folded before Flop
Seat 3: slotmachine collected ($1000)
Seat 4: mangeshnc folded before Flop (didn't bet)
Seat 5: kimjongun folded before Flop (didn't bet)
Seat 6: TurnOnTuneInDropOut (button) folded before Flop (didn't bet)

PokerStars Hand #1109334844: Omaha Pot Limit ($200/$400 USD) - 2020/10/23 14:14:05 ET
Table 'ADA722387266' 6-max Seat #1 is the button
Seat 1: soundfsilenz ($45005 in chips)
Seat 2: gaganhyd ($16139 in chips)
Seat 3: slotmachine ($44200 in chips)
Seat 4: mangeshnc ($19959 in chips)
Seat 5: kimjongun ($23326 in chips)
Seat 6: TurnOnTuneInDropOut ($47769 in chips)
gaganhyd: posts small blind $200
slotmachine: posts big blind $400
*** HOLE CARDS ***
Dealt to TurnOnTuneInDropOut [8h Kc 5d 9s]
mangeshnc: raises $1000 to $1400
kimjongun: folds
TurnOnTuneInDropOut: folds
soundfsilenz: folds
gaganhyd: calls $1200
slotmachine: folds
*** FLOP *** [5c 3s Kh]
gaganhyd: checks
mangeshnc: bets $3200
gaganhyd: raises $9600 to $12800
mangeshnc: calls $9600
*** TURN *** [5c 3s Kh] [7h]
gaganhyd: bets $1939 and is all-in
mangeshnc: calls $1939
*** RIVER *** [5c 3s Kh 7h] [7c]
*** SHOW DOWN ***
gaganhyd: shows [3c 2h 4h Ac]
mangeshnc: shows [Jc 7s Jh 4c]
mangeshnc collected $31878 from pot
*** SUMMARY ***
Total pot $32678 | Rake $800
Board [5c 3s Kh 7h 7c]
Seat 1: soundfsilenz (button) folded before Flop (didn't bet)
Seat 2: gaganhyd (small blind) showed [3c 2h 4h Ac] and lost
Seat 3: slotmachine (big blind) folded before Flop
Seat 4: mangeshnc showed [Jc 7s Jh 4c] and won ($31878)
Seat 5: kimjongun folded before Flop (didn't bet)
Seat 6: TurnOnTuneInDropOut folded before Flop (didn't bet)

PokerStars Hand #1109334845: Omaha Pot Limit ($200/$400 USD) - 2020/10/23 14:15:04 ET
Table 'ADA722387266' 6-max Seat #3 is the button
Seat 1: soundfsilenz ($45005 in chips)
Seat 3: slotmachine ($43800 in chips)
Seat 4: mangeshnc ($35698 in chips)
Seat 5: kimjongun ($23326 in chips)
Seat 6: TurnOnTuneInDropOut ($47769 in chips)
mangeshnc: posts small blind $200
kimjongun: posts big blind $400
*** HOLE CARDS ***
Dealt to TurnOnTuneInDropOut [6h 4h Qc 8c]
TurnOnTuneInDropOut: folds
soundfsilenz: folds
slotmachine: folds
mangeshnc: calls $200
kimjongun: checks
*** FLOP *** [3s 7h 8s]
mangeshnc: checks
kimjongun: checks
*** TURN *** [3s 7h 8s] [6c]
mangeshnc: bets $800
kimjongun: calls $800
*** RIVER *** [3s 7h 8s 6c] [Kh]
mangeshnc: bets $2400
kimjongun: calls $2400
*** SHOW DOWN ***
mangeshnc: shows [4c Ks 5d Ac]
kimjongun: mucks hand
mangeshnc collected $6911 from pot
*** SUMMARY ***
Total pot $7200 | Rake $289
Board [3s 7h 8s 6c Kh]
Seat 1: soundfsilenz folded before Flop (didn't bet)
Seat 3: slotmachine (button) folded before Flop (didn't bet)
Seat 4: mangeshnc (small blind) showed [4c Ks 5d Ac] and won ($6911)
Seat 5: kimjongun (big blind) mucked
Seat 6: TurnOnTuneInDropOut folded before Flop (didn't bet)

PokerStars Hand #1109334846: Omaha Pot Limit ($200/$400 USD) - 2020/10/23 14:16:28 ET
Table 'ADA722387266' 6-max Seat #4 is the button
Seat 1: soundfsilenz ($45005 in chips)
Seat 2: gaganhyd ($20682 in chips)
Seat 3: slotmachine ($43800 in chips)
Seat 4: mangeshnc ($39009 in chips)
Seat 5: kimjongun ($19726 in chips)
Seat 6: TurnOnTuneInDropOut ($47769 in chips)
kimjongun: posts small blind $200
TurnOnTuneInDropOut: posts big blind $400
*** HOLE CARDS ***
Dealt to TurnOnTuneInDropOut [Th Ts Ah 6d]
soundfsilenz: folds
gaganhyd: raises $650 to $1050
slotmachine: calls $1050
mangeshnc: calls $1050
kimjongun: folds
TurnOnTuneInDropOut: calls $650
*** FLOP *** [Js 9d Jd]
TurnOnTuneInDropOut: checks
gaganhyd: checks
slotmachine: checks
mangeshnc: checks
*** TURN *** [Js 9d Jd] [Jh]
TurnOnTuneInDropOut: checks
gaganhyd: checks
slotmachine: checks
mangeshnc: bets $4400
TurnOnTuneInDropOut: folds
gaganhyd: folds
slotmachine: calls $4400
*** RIVER *** [Js 9d Jd Jh] [2s]
slotmachine: checks
mangeshnc: checks
*** SHOW DOWN ***
slotmachine: shows [9s Kh 2c Ks]
mangeshnc: mucks hand
slotmachine collected $12671 from pot
*** SUMMARY ***
Total pot $13200 | Rake $529
Board [Js 9d Jd Jh 2s]
Seat 1: soundfsilenz folded before Flop (didn't bet)
Seat 2: gaganhyd folded on the Turn
Seat 3: slotmachine showed [9s Kh 2c Ks] and won ($12671)
Seat 4: mangeshnc (button) mucked
Seat 5: kimjongun (small blind) folded before Flop
Seat 6: TurnOnTuneInDropOut (big blind) folded on the Turn

PokerStars Hand #1109334850: Omaha Pot Limit ($200/$400 USD) - 2020/10/23 14:20:10 ET
Table 'ADA722387266' 6-max Seat #2 is the button
Seat 1: soundfsilenz ($46285 in chips)
Seat 2: gaganhyd ($19032 in chips)
Seat 3: slotmachine ($50621 in chips)
Seat 4: mangeshnc ($33279 in chips)
Seat 5: kimjongun ($19526 in chips)
Seat 6: TurnOnTuneInDropOut ($46519 in chips)
slotmachine: posts small blind $200
mangeshnc: posts big blind $400
*** HOLE CARDS ***
Dealt to TurnOnTuneInDropOut [Jc 9h 5h Kh]
kimjongun: raises $600 to $1000
TurnOnTuneInDropOut: folds
soundfsilenz: folds
gaganhyd: folds
slotmachine: folds
mangeshnc: calls $600
*** FLOP *** [4h Td Js]
mangeshnc: checks
kimjongun: bets $1452
mangeshnc: calls $1452
*** TURN *** [4h Td Js] [7d]
mangeshnc: checks
kimjongun: bets $3828
mangeshnc: calls $3828
*** RIVER *** [4h Td Js 7d] [6d]
mangeshnc: bets $12760
kimjongun: raises $486 to $13246 and is all-in
mangeshnc: calls $486
*** SHOW DOWN ***
mangeshnc: shows [Ad 3c Tc 3d]
kimjongun: shows [9d 9c Qd 7c]
mangeshnc collected $38452 from pot
*** SUMMARY ***
Total pot $39252 | Rake $800
Board [4h Td Js 7d 6d]
Seat 1: soundfsilenz folded before Flop (didn't bet)
Seat 2: gaganhyd (button) folded before Flop (didn't bet)
Seat 3: slotmachine (small blind) folded before Flop
Seat 4: mangeshnc (big blind) showed [Ad 3c Tc 3d] and won ($38452)
Seat 5: kimjongun showed [9d 9c Qd 7c] and lost
Seat 6: TurnOnTuneInDropOut folded before Flop (didn't bet)

PokerStars Hand #1109334851: Omaha Pot Limit ($200/$400 USD) - 2020/10/23 14:21:13 ET
Table 'ADA722387266' 6-max Seat #3 is the button
Seat 1: soundfsilenz ($46285 in chips)
Seat 2: gaganhyd ($19032 in chips)
Seat 3: slotmachine ($50421 in chips)
Seat 4: mangeshnc ($52205 in chips)
Seat 5: kimjongun ($27462 in chips)
Seat 6: TurnOnTuneInDropOut ($46519 in chips)
mangeshnc: posts small blind $200
kimjongun: posts big blind $400
*** HOLE CARDS ***
Dealt to TurnOnTuneInDropOut [Jd 4s Qc 5s]
TurnOnTuneInDropOut: folds
soundfsilenz: raises $1000 to $1400
gaganhyd: folds
slotmachine: raises $3400 to $4800
mangeshnc: folds
kimjongun: folds
soundfsilenz: folds
Uncalled bet ($3400) returned to slotmachine
slotmachine collected $3400 from pot
slotmachine: doesn't show hand
*** SUMMARY ***
Total pot $3400 | Rake $0
Seat 1: soundfsilenz folded before Flop
Seat 2: gaganhyd folded before Flop (didn't bet)
Seat 3: slotmachine (button) collected ($3400)
Seat 4: mangeshnc (small blind) folded before Flop
Seat 5: kimjongun (big blind) folded before Flop
Seat 6: TurnOnTuneInDropOut folded before Flop (didn't bet)

PokerStars Hand #1109334854: Omaha Pot Limit ($200/$400 USD) - 2020/10/23 14:23:30 ET
Table 'ADA722387266' 6-max Seat #6 is the button
Seat 1: soundfsilenz ($44485 in chips)
Seat 2: gaganhyd ($19032 in chips)
Seat 3: slotmachine ($52421 in chips)
Seat 4: mangeshnc ($52414 in chips)
Seat 5: kimjongun ($26862 in chips)
Seat 6: TurnOnTuneInDropOut ($46400 in chips)
soundfsilenz: posts small blind $200
gaganhyd: posts big blind $400
*** HOLE CARDS ***
Dealt to TurnOnTuneInDropOut [8h Jc 5d Kd]
slotmachine: folds
mangeshnc: folds
kimjongun: folds
TurnOnTuneInDropOut: folds
soundfsilenz: raises $800 to $1200
gaganhyd: calls $800
*** FLOP *** [4h 9s 5c]
soundfsilenz: bets $1608
gaganhyd: calls $1608
*** TURN *** [4h 9s 5c] [Qs]
soundfsilenz: checks
gaganhyd: checks
*** RIVER *** [4h 9s 5c Qs] [Jd]
soundfsilenz: checks
gaganhyd: bets $4212
soundfsilenz: calls $4212
*** SHOW DOWN ***
soundfsilenz: mucks hand
gaganhyd: shows [Kc Ts 8c 6d]
gaganhyd collected $13477 from pot
*** SUMMARY ***
Total pot $14040 | Rake $563
Board [4h 9s 5c Qs Jd]
Seat 1: soundfsilenz (small blind) mucked
Seat 2: gaganhyd (big blind) showed [Kc Ts 8c 6d] and won ($13477)
Seat 3: slotmachine folded before Flop (didn't bet)
Seat 4: mangeshnc folded before Flop (didn't bet)
Seat 5: kimjongun folded before Flop (didn't bet)
Seat 6: TurnOnTuneInDropOut (button) folded before Flop (didn't bet)

PokerStars Hand #1109334855: Omaha Pot Limit ($200/$400 USD) - 2020/10/23 14:24:47 ET
Table 'ADA722387266' 6-max Seat #1 is the button
Seat 1: soundfsilenz ($37465 in chips)
Seat 2: gaganhyd ($25489 in chips)
Seat 3: slotmachine ($52421 in chips)
Seat 4: mangeshnc ($52414 in chips)
Seat 5: kimjongun ($26862 in chips)
Seat 6: TurnOnTuneInDropOut ($46400 in chips)
gaganhyd: posts small blind $200
slotmachine: posts big blind $400
*** HOLE CARDS ***
Dealt to TurnOnTuneInDropOut [2s Th 4c As]
mangeshnc: folds
kimjongun: folds
TurnOnTuneInDropOut: folds
soundfsilenz: folds
gaganhyd: folds
Uncalled bet ($200) returned to slotmachine
slotmachine collected $400 from pot
slotmachine: doesn't show hand
*** SUMMARY ***
Total pot $400 | Rake $0
Seat 1: soundfsilenz (button) folded before Flop (didn't bet)
Seat 2: gaganhyd (small blind) folded before Flop
Seat 3: slotmachine (big blind) collected ($400)
Seat 4: mangeshnc folded before Flop (didn't bet)
Seat 5: kimjongun folded before Flop (didn't bet)
Seat 6: TurnOnTuneInDropOut folded before Flop (didn't bet)

PokerStars Hand #1109334856: Omaha Pot Limit ($200/$400 USD) - 2020/10/23 14:25:14 ET
Table 'ADA722387266' 6-max Seat #2 is the button
Seat 1: soundfsilenz ($37465 in chips)
Seat 2: gaganhyd ($25289 in chips)
Seat 3: slotmachine ($52621 in chips)
Seat 4: mangeshnc ($52414 in chips)
Seat 5: kimjongun ($26862 in chips)
Seat 6: TurnOnTuneInDropOut ($46400 in chips)
slotmachine: posts small blind $200
mangeshnc: posts big blind $400
*** HOLE CARDS ***
Dealt to TurnOnTuneInDropOut [2h 4d 6s 3h]
kimjongun: folds
TurnOnTuneInDropOut: folds
soundfsilenz: folds
gaganhyd: folds
slotmachine: raises $800 to $1200
mangeshnc: folds
Uncalled bet ($800) returned to slotmachine
slotmachine collected $800 from pot
slotmachine: doesn't show hand
*** SUMMARY ***
Total pot $800 | Rake $0
Seat 1: soundfsilenz folded before Flop (didn't bet)
Seat 2: gaganhyd (button) folded before Flop (didn't bet)
Seat 3: slotmachine (small blind) collected ($800)
Seat 4: mangeshnc (big blind) folded before Flop
Seat 5: kimjongun folded before Flop (didn't bet)
Seat 6: TurnOnTuneInDropOut folded before Flop (didn't bet)

PokerStars Hand #1109334857: Omaha Pot Limit ($200/$400 USD) - 2020/10/23 14:26:01 ET
Table 'ADA722387266' 6-max Seat #3 is the button
Seat 1: soundfsilenz ($37465 in chips)
Seat 2: gaganhyd ($25289 in chips)
Seat 3: slotmachine ($53021 in chips)
Seat 4: mangeshnc ($52014 in chips)
Seat 5: kimjongun ($26862 in chips)
Seat 6: TurnOnTuneInDropOut ($46400 in chips)
mangeshnc: posts small blind $200
kimjongun: posts big blind $400
*** HOLE CARDS ***
Dealt to TurnOnTuneInDropOut [Ah 2d 3s Kc]
TurnOnTuneInDropOut: folds
soundfsilenz: raises $1000 to $1400
gaganhyd: calls $1400
slotmachine: folds
mangeshnc: folds
kimjongun: folds
*** FLOP *** [7d 6h 5c]
soundfsilenz: checks
gaganhyd: checks
*** TURN *** [7d 6h 5c] [Th]
soundfsilenz: checks
gaganhyd: bets $1700
soundfsilenz: raises $4760 to $6460
gaganhyd: raises $16320 to $22780
soundfsilenz: folds
Uncalled bet ($16320) returned to gaganhyd
gaganhyd collected $15666 from pot
gaganhyd: doesn't show hand
*** SUMMARY ***
Total pot $16320 | Rake $654
Board [7d 6h 5c Th]
Seat 1: soundfsilenz folded on the Turn
Seat 2: gaganhyd collected ($15666)
Seat 3: slotmachine (button) folded before Flop (didn't bet)
Seat 4: mangeshnc (small blind) folded before Flop
Seat 5: kimjongun (big blind) folded before Flop
Seat 6: TurnOnTuneInDropOut folded before Flop (didn't bet)

PokerStars Hand #1109334859: Omaha Pot Limit ($200/$400 USD) - 2020/10/23 14:28:34 ET
Table 'ADA722387266' 6-max Seat #6 is the button
Seat 1: soundfsilenz ($29205 in chips)
Seat 2: gaganhyd ($33095 in chips)
Seat 3: slotmachine ($53021 in chips)
Seat 4: mangeshnc ($53294 in chips)
Seat 6: TurnOnTuneInDropOut ($45208 in chips)
soundfsilenz: posts small blind $200
gaganhyd: posts big blind $400
*** HOLE CARDS ***
Dealt to TurnOnTuneInDropOut [3h 2h 9s 3c]
slotmachine: folds
mangeshnc: folds
TurnOnTuneInDropOut: folds
soundfsilenz: folds
Uncalled bet ($200) returned to gaganhyd
gaganhyd collected $400 from pot
gaganhyd: doesn't show hand
*** SUMMARY ***
Total pot $400 | Rake $0
Seat 1: soundfsilenz (small blind) folded before Flop
Seat 2: gaganhyd (big blind) collected ($400)
Seat 3: slotmachine folded before Flop (didn't bet)
Seat 4: mangeshnc folded before Flop (didn't bet)
Seat 6: TurnOnTuneInDropOut (button) folded before Flop (didn't bet)

PokerStars Hand #1109334860: Omaha Pot Limit ($200/$400 USD) - 2020/10/23 14:28:56 ET
Table 'ADA722387266' 6-max Seat #1 is the button
Seat 1: soundfsilenz ($29005 in chips)
Seat 2: gaganhyd ($33295 in chips)
Seat 3: slotmachine ($53021 in chips)
Seat 4: mangeshnc ($53294 in chips)
Seat 6: TurnOnTuneInDropOut ($45208 in chips)
gaganhyd: posts small blind $200
slotmachine: posts big blind $400
*** HOLE CARDS ***
Dealt to TurnOnTuneInDropOut [6d Kd Td Th]
mangeshnc: folds
TurnOnTuneInDropOut: folds
soundfsilenz: folds
gaganhyd: folds
Uncalled bet ($200) returned to slotmachine
slotmachine collected $400 from pot
slotmachine: doesn't show hand
*** SUMMARY ***
Total pot $400 | Rake $0
Seat 1: soundfsilenz (button) folded before Flop (didn't bet)
Seat 2: gaganhyd (small blind) folded before Flop
Seat 3: slotmachine (big blind) collected ($400)
Seat 4: mangeshnc folded before Flop (didn't bet)
Seat 6: TurnOnTuneInDropOut folded before Flop (didn't bet)

PokerStars Hand #1109334861: Omaha Pot Limit ($200/$400 USD) - 2020/10/23 14:29:29 ET
Table 'ADA722387266' 6-max Seat #2 is the button
Seat 1: soundfsilenz ($29005 in chips)
Seat 2: gaganhyd ($33095 in chips)
Seat 3: slotmachine ($53221 in chips)
Seat 4: mangeshnc ($53294 in chips)
Seat 6: TurnOnTuneInDropOut ($45208 in chips)
slotmachine: posts small blind $200
mangeshnc: posts big blind $400
*** HOLE CARDS ***
Dealt to TurnOnTuneInDropOut [2h 9c 4c Th]
TurnOnTuneInDropOut: folds
soundfsilenz: folds
gaganhyd: folds
slotmachine: folds
Uncalled bet ($200) returned to mangeshnc
mangeshnc collected $400 from pot
mangeshnc: doesn't show hand
*** SUMMARY ***
Total pot $400 | Rake $0
Seat 1: soundfsilenz folded before Flop (didn't bet)
Seat 2: gaganhyd (button) folded before Flop (didn't bet)
Seat 3: slotmachine (small blind) folded before Flop
Seat 4: mangeshnc (big blind) collected ($400)
Seat 6: TurnOnTuneInDropOut folded before Flop (didn't bet)

PokerStars Hand #1109334862: Omaha Pot Limit ($200/$400 USD) - 2020/10/23 14:29:43 ET
Table 'ADA722387266' 6-max Seat #3 is the button
Seat 1: soundfsilenz ($29005 in chips)
Seat 2: gaganhyd ($33095 in chips)
Seat 3: slotmachine ($53021 in chips)
Seat 4: mangeshnc ($53494 in chips)
Seat 5: kimjongun ($26462 in chips)
Seat 6: TurnOnTuneInDropOut ($45208 in chips)
mangeshnc: posts small blind $200
kimjongun: posts big blind $400
*** HOLE CARDS ***
Dealt to TurnOnTuneInDropOut [5c 9h Ah 2d]
TurnOnTuneInDropOut: folds
soundfsilenz: folds
gaganhyd: folds
slotmachine: raises $1000 to $1400
mangeshnc: calls $1200
kimjongun: folds
*** FLOP *** [9d 4d 3c]
mangeshnc: checks
slotmachine: bets $3200
mangeshnc: calls $3200
*** TURN *** [9d 4d 3c] [5d]
mangeshnc: checks
slotmachine: bets $9600
mangeshnc: folds
Uncalled bet ($9600) returned to slotmachine
slotmachine collected $9215 from pot
slotmachine: doesn't show hand
*** SUMMARY ***
Total pot $9600 | Rake $385
Board [9d 4d 3c 5d]
Seat 1: soundfsilenz folded before Flop (didn't bet)
Seat 2: gaganhyd folded before Flop (didn't bet)
Seat 3: slotmachine (button) collected ($9215)
Seat 4: mangeshnc (small blind) folded on the Turn
Seat 5: kimjongun (big blind) folded before Flop
Seat 6: TurnOnTuneInDropOut folded before Flop (didn't bet)

PokerStars Hand #1109334864: Omaha Pot Limit ($200/$400 USD) - 2020/10/23 14:32:37 ET
Table 'ADA722387266' 6-max Seat #5 is the button
Seat 1: soundfsilenz ($29005 in chips)
Seat 2: gaganhyd ($27645 in chips)
Seat 3: slotmachine ($48000 in chips)
Seat 4: mangeshnc ($47844 in chips)
Seat 5: kimjongun ($25862 in chips)
Seat 6: TurnOnTuneInDropOut ($96316 in chips)
TurnOnTuneInDropOut: posts small blind $200
soundfsilenz: posts big blind $400
*** HOLE CARDS ***
Dealt to TurnOnTuneInDropOut [3c Qs 6h Ad]
gaganhyd: folds
slotmachine: folds
mangeshnc: raises $1000 to $1400
kimjongun: calls $1400
TurnOnTuneInDropOut: folds
soundfsilenz: folds
*** FLOP *** [8c 5h 4s]
mangeshnc: bets $3400
kimjongun: calls $3400
*** TURN *** [8c 5h 4s] [9d]
mangeshnc: checks
kimjongun: checks
*** RIVER *** [8c 5h 4s 9d] [Ts]
mangeshnc: bets $10200
kimjongun: raises $10862 to $21062 and is all-in
mangeshnc: calls $10862
*** SHOW DOWN ***
mangeshnc: shows [Jc Qc Qh Kc]
kimjongun: shows [Jh 7s Th Jd]
mangeshnc collected $51524 from pot
*** SUMMARY ***
Total pot $52324 | Rake $800
Board [8c 5h 4s 9d Ts]
Seat 1: soundfsilenz (big blind) folded before Flop
Seat 2: gaganhyd folded before Flop (didn't bet)
Seat 3: slotmachine folded before Flop (didn't bet)
Seat 4: mangeshnc showed [Jc Qc Qh Kc] and won ($51524)
Seat 5: kimjongun (button) showed [Jh 7s Th Jd] and lost
Seat 6: TurnOnTuneInDropOut (small blind) folded before Flop

PokerStars Hand #1109334865: Omaha Pot Limit ($200/$400 USD) - 2020/10/23 14:33:55 ET
Table 'ADA722387266' 6-max Seat #6 is the button
Seat 1: soundfsilenz ($28605 in chips)
Seat 2: gaganhyd ($27645 in chips)
Seat 3: slotmachine ($48000 in chips)
Seat 4: mangeshnc ($73506 in chips)
Seat 6: TurnOnTuneInDropOut ($96116 in chips)
soundfsilenz: posts small blind $200
gaganhyd: posts big blind $400
*** HOLE CARDS ***
Dealt to TurnOnTuneInDropOut [4s Jd 5s 8h]
slotmachine: folds
mangeshnc: folds
TurnOnTuneInDropOut: folds
soundfsilenz: folds
Uncalled bet ($200) returned to gaganhyd
gaganhyd collected $400 from pot
gaganhyd: doesn't show hand
*** SUMMARY ***
Total pot $400 | Rake $0
Seat 1: soundfsilenz (small blind) folded before Flop
Seat 2: gaganhyd (big blind) collected ($400)
Seat 3: slotmachine folded before Flop (didn't bet)
Seat 4: mangeshnc folded before Flop (didn't bet)
Seat 6: TurnOnTuneInDropOut (button) folded before Flop (didn't bet)

PokerStars Hand #1109334866: Omaha Pot Limit ($200/$400 USD) - 2020/10/23 14:34:16 ET
Table 'ADA722387266' 6-max Seat #1 is the button
Seat 1: soundfsilenz ($28405 in chips)
Seat 2: gaganhyd ($27845 in chips)
Seat 3: slotmachine ($48000 in chips)
Seat 4: mangeshnc ($73506 in chips)
Seat 6: TurnOnTuneInDropOut ($96116 in chips)
gaganhyd: posts small blind $200
slotmachine: posts big blind $400
*** HOLE CARDS ***
Dealt to TurnOnTuneInDropOut [6d 5h 6s Th]
mangeshnc: folds
TurnOnTuneInDropOut: folds
soundfsilenz: folds
gaganhyd: folds
Uncalled bet ($200) returned to slotmachine
slotmachine collected $400 from pot
slotmachine: doesn't show hand
*** SUMMARY ***
Total pot $400 | Rake $0
Seat 1: soundfsilenz (button) folded before Flop (didn't bet)
Seat 2: gaganhyd (small blind) folded before Flop
Seat 3: slotmachine (big blind) collected ($400)
Seat 4: mangeshnc folded before Flop (didn't bet)
Seat 6: TurnOnTuneInDropOut folded before Flop (didn't bet)

PokerStars Hand #1109334867: Omaha Pot Limit ($200/$400 USD) - 2020/10/23 14:34:42 ET
Table 'ADA722387266' 6-max Seat #2 is the button
Seat 1: soundfsilenz ($28405 in chips)
Seat 2: gaganhyd ($27645 in chips)
Seat 3: slotmachine ($48200 in chips)
Seat 4: mangeshnc ($73506 in chips)
Seat 6: TurnOnTuneInDropOut ($96116 in chips)
slotmachine: posts small blind $200
mangeshnc: posts big blind $400
*** HOLE CARDS ***
Dealt to TurnOnTuneInDropOut [4s 6s 9h 2h]
TurnOnTuneInDropOut: folds
soundfsilenz: raises $1000 to $1400
gaganhyd: calls $1400
slotmachine: calls $1200
mangeshnc: calls $1000
*** FLOP *** [3c 8c Kh]
slotmachine: checks
mangeshnc: checks
soundfsilenz: checks
gaganhyd: bets $2800
slotmachine: folds
mangeshnc: calls $2800
soundfsilenz: folds
*** TURN *** [3c 8c Kh] [8d]
mangeshnc: checks
gaganhyd: bets $4904
mangeshnc: calls $4904
*** RIVER *** [3c 8c Kh 8d] [4d]
mangeshnc: checks
gaganhyd: bets $9409
mangeshnc: folds
Uncalled bet ($9409) returned to gaganhyd
gaganhyd collected $20208 from pot
gaganhyd: doesn't show hand
*** SUMMARY ***
Total pot $21008 | Rake $800
Board [3c 8c Kh 8d 4d]
Seat 1: soundfsilenz folded on the Flop
Seat 2: gaganhyd (button) collected ($20208)
Seat 3: slotmachine (small blind) folded on the Flop
Seat 4: mangeshnc (big blind) folded on the River
Seat 6: TurnOnTuneInDropOut folded before Flop (didn't bet)

PokerStars Hand #1109334868: Omaha Pot Limit ($200/$400 USD) - 2020/10/23 14:36:16 ET
Table 'ADA722387266' 6-max Seat #3 is the button
Seat 1: soundfsilenz ($27005 in chips)
Seat 2: gaganhyd ($38749 in chips)
Seat 3: slotmachine ($46800 in chips)
Seat 4: mangeshnc ($64402 in chips)
Seat 5: kimjongun ($28001 in chips)
Seat 6: TurnOnTuneInDropOut ($96116 in chips)
mangeshnc: posts small blind $200
kimjongun: posts big blind $400
*** HOLE CARDS ***
Dealt to TurnOnTuneInDropOut [3h Tc 9c Ah]
TurnOnTuneInDropOut: folds
soundfsilenz: folds
gaganhyd: raises $1000 to $1400
slotmachine: folds
mangeshnc: calls $1200
kimjongun: folds
*** FLOP *** [4s As 9h]
mangeshnc: bets $3200
gaganhyd: folds
Uncalled bet ($3200) returned to mangeshnc
mangeshnc collected $3072 from pot
mangeshnc: doesn't show hand
*** SUMMARY ***
Total pot $3200 | Rake $128
Board [4s As 9h]
Seat 1: soundfsilenz folded before Flop (didn't bet)
Seat 2: gaganhyd folded on the Flop
Seat 3: slotmachine (button) folded before Flop (didn't bet)
Seat 4: mangeshnc (small blind) collected ($3072)
Seat 5: kimjongun (big blind) folded before Flop
Seat 6: TurnOnTuneInDropOut folded before Flop (didn't bet)

PokerStars Hand #1109334869: Omaha Pot Limit ($200/$400 USD) - 2020/10/23 14:37:37 ET
Table 'ADA722387266' 6-max Seat #4 is the button
Seat 1: soundfsilenz ($39006 in chips)
Seat 2: gaganhyd ($37349 in chips)
Seat 3: slotmachine ($46800 in chips)
Seat 4: mangeshnc ($66074 in chips)
Seat 5: kimjongun ($27601 in chips)
Seat 6: TurnOnTuneInDropOut ($96116 in chips)
kimjongun: posts small blind $200
TurnOnTuneInDropOut: posts big blind $400
*** HOLE CARDS ***
Dealt to TurnOnTuneInDropOut [9c 6h 6s 4d]
soundfsilenz: folds
gaganhyd: raises $650 to $1050
slotmachine: folds
mangeshnc: folds
kimjongun: folds
TurnOnTuneInDropOut: folds
Uncalled bet ($650) returned to gaganhyd
gaganhyd collected $1000 from pot
gaganhyd: doesn't show hand
*** SUMMARY ***
Total pot $1000 | Rake $0
Seat 1: soundfsilenz folded before Flop (didn't bet)
Seat 2: gaganhyd collected ($1000)
Seat 3: slotmachine folded before Flop (didn't bet)
Seat 4: mangeshnc (button) folded before Flop (didn't bet)
Seat 5: kimjongun (small blind) folded before Flop
Seat 6: TurnOnTuneInDropOut (big blind) folded before Flop

PokerStars Hand #1109334870: Omaha Pot Limit ($200/$400 USD) - 2020/10/23 14:38:03 ET
Table 'ADA722387266' 6-max Seat #5 is the button
Seat 1: soundfsilenz ($39006 in chips)
Seat 2: gaganhyd ($37949 in chips)
Seat 3: slotmachine ($46800 in chips)
Seat 4: mangeshnc ($66074 in chips)
Seat 5: kimjongun ($27401 in chips)
Seat 6: TurnOnTuneInDropOut ($95716 in chips)
TurnOnTuneInDropOut: posts small blind $200
soundfsilenz: posts big blind $400
*** HOLE CARDS ***
Dealt to TurnOnTuneInDropOut [7d Ac 6d 8c]
gaganhyd: folds
slotmachine: raises $1000 to $1400
mangeshnc: calls $1400
kimjongun: folds
TurnOnTuneInDropOut: folds
soundfsilenz: folds
*** FLOP *** [7c 6c 2d]
slotmachine: checks
mangeshnc: bets $3400
slotmachine: folds
Uncalled bet ($3400) returned to mangeshnc
mangeshnc collected $3264 from pot
mangeshnc: doesn't show hand
*** SUMMARY ***
Total pot $3400 | Rake $136
Board [7c 6c 2d]
Seat 1: soundfsilenz (big blind) folded before Flop
Seat 2: gaganhyd folded before Flop (didn't bet)
Seat 3: slotmachine folded on the Flop
Seat 4: mangeshnc collected ($3264)
Seat 5: kimjongun (button) folded before Flop (didn't bet)
Seat 6: TurnOnTuneInDropOut (small blind) folded before Flop

PokerStars Hand #1109334872: Omaha Pot Limit ($200/$400 USD) - 2020/10/23 14:40:37 ET
Table 'ADA722387266' 6-max Seat #1 is the button
Seat 1: soundfsilenz ($38406 in chips)
Seat 2: gaganhyd ($46327 in chips)
Seat 3: slotmachine ($45400 in chips)
Seat 4: mangeshnc ($59038 in chips)
Seat 5: kimjongun ($27401 in chips)
Seat 6: TurnOnTuneInDropOut ($95516 in chips)
gaganhyd: posts small blind $200
slotmachine: posts big blind $400
*** HOLE CARDS ***
Dealt to TurnOnTuneInDropOut [9h 8c 4s 4h]
mangeshnc: raises $1000 to $1400
kimjongun: folds
TurnOnTuneInDropOut: folds
soundfsilenz: raises $3400 to $4800
gaganhyd: folds
slotmachine: folds
mangeshnc: calls $3400
*** FLOP *** [8d As Th]
mangeshnc: checks
soundfsilenz: bets $5508
mangeshnc: calls $5508
*** TURN *** [8d As Th] [Kd]
mangeshnc: checks
soundfsilenz: checks
*** RIVER *** [8d As Th Kd] [Jc]
mangeshnc: bets $10608
soundfsilenz: folds
Uncalled bet ($10608) returned to mangeshnc
mangeshnc collected $20416 from pot
mangeshnc: doesn't show hand
*** SUMMARY ***
Total pot $21216 | Rake $800
Board [8d As Th Kd Jc]
Seat 1: soundfsilenz (button) folded on the River
Seat 2: gaganhyd (small blind) folded before Flop
Seat 3: slotmachine (big blind) folded before Flop
Seat 4: mangeshnc collected ($20416)
Seat 5: kimjongun folded before Flop (didn't bet)
Seat 6: TurnOnTuneInDropOut folded before Flop (didn't bet)

PokerStars Hand #1109334873: Omaha Pot Limit ($200/$400 USD) - 2020/10/23 14:42:17 ET
Table 'ADA722387266' 6-max Seat #2 is the button
Seat 1: soundfsilenz ($28098 in chips)
Seat 2: gaganhyd ($46127 in chips)
Seat 3: slotmachine ($45000 in chips)
Seat 4: mangeshnc ($69146 in chips)
Seat 5: kimjongun ($27401 in chips)
Seat 6: TurnOnTuneInDropOut ($95516 in chips)
slotmachine: posts small blind $200
mangeshnc: posts big blind $400
*** HOLE CARDS ***
Dealt to TurnOnTuneInDropOut [4c 5c 4h Qc]
kimjongun: folds
TurnOnTuneInDropOut: folds
soundfsilenz: raises $1000 to $1400
gaganhyd: raises $3400 to $4800
slotmachine: folds
mangeshnc: folds
soundfsilenz: calls $3400
*** FLOP *** [Ac Qh Qd]
soundfsilenz: checks
gaganhyd: checks
*** TURN *** [Ac Qh Qd] [7s]
soundfsilenz: checks
gaganhyd: bets $3465
soundfsilenz: folds
Uncalled bet ($3465) returned to gaganhyd
gaganhyd collected $9791 from pot
gaganhyd: doesn't show hand
*** SUMMARY ***
Total pot $10200 | Rake $409
Board [Ac Qh Qd 7s]
Seat 1: soundfsilenz folded on the Turn
Seat 2: gaganhyd (button) collected ($9791)
Seat 3: slotmachine (small blind) folded before Flop
Seat 4: mangeshnc (big blind) folded before Flop
Seat 5: kimjongun folded before Flop (didn't bet)
Seat 6: TurnOnTuneInDropOut folded before Flop (didn't bet)

PokerStars Hand #1109334874: Omaha Pot Limit ($200/$400 USD) - 2020/10/23 14:43:31 ET
Table 'ADA722387266' 6-max Seat #3 is the button
Seat 1: soundfsilenz ($40099 in chips)
Seat 2: gaganhyd ($51118 in chips)
Seat 3: slotmachine ($44800 in chips)
Seat 4: mangeshnc ($68746 in chips)
Seat 5: kimjongun ($27401 in chips)
Seat 6: TurnOnTuneInDropOut ($95516 in chips)
mangeshnc: posts small blind $200
kimjongun: posts big blind $400
*** HOLE CARDS ***
Dealt to TurnOnTuneInDropOut [7c 2c Th 8d]
TurnOnTuneInDropOut: folds
soundfsilenz: folds
gaganhyd: folds
slotmachine: raises $1000 to $1400
mangeshnc: calls $1200
kimjongun: folds
*** FLOP *** [Ac 6s Js]
mangeshnc: checks
slotmachine: checks
*** TURN *** [Ac 6s Js] [4d]
mangeshnc: bets $3200
slotmachine: folds
Uncalled bet ($3200) returned to mangeshnc
mangeshnc collected $3072 from pot
mangeshnc: doesn't show hand
*** SUMMARY ***
Total pot $3200 | Rake $128
Board [Ac 6s Js 4d]
Seat 1: soundfsilenz folded before Flop (didn't bet)
Seat 2: gaganhyd folded before Flop (didn't bet)
Seat 3: slotmachine (button) folded on the Turn
Seat 4: mangeshnc (small blind) collected ($3072)
Seat 5: kimjongun (big blind) folded before Flop
Seat 6: TurnOnTuneInDropOut folded before Flop (didn't bet)

PokerStars Hand #155975274: Omaha Pot Limit ($500/$1000 USD) - 2020/10/23 13:56:32 ET
Table 'ADA766532706' 6-max Seat #1 is the button
Seat 1: slotmachine ($136209 in chips)
Seat 2: TurnOnTuneInDropOut ($74000 in chips)
Seat 3: vaibz16 ($30000 in chips)
Seat 4: slowcoach ($60995 in chips)
Seat 5: badtameez_donk ($124108 in chips)
Seat 6: aggtarun ($127841 in chips)
TurnOnTuneInDropOut: posts small blind $500
vaibz16: posts big blind $1000
*** HOLE CARDS ***
Dealt to TurnOnTuneInDropOut [4s Td 6s Kh]
slowcoach: raises $1000 to $2000
badtameez_donk: folds
aggtarun: calls $2000
slotmachine: folds
TurnOnTuneInDropOut: folds
vaibz16: calls $1000
*** FLOP *** [3c Ts 4d]
vaibz16: checks
slowcoach: bets $4875
aggtarun: calls $4875
vaibz16: folds
*** TURN *** [3c Ts 4d] [3s]
slowcoach: bets $8125
aggtarun: calls $8125
*** RIVER *** [3c Ts 4d 3s] [9s]
slowcoach: checks
aggtarun: bets $20725
slowcoach: folds
Uncalled bet ($20725) returned to aggtarun
aggtarun collected $31522 from pot
aggtarun: doesn't show hand
*** SUMMARY ***
Total pot $32500 | Rake $978
Board [3c Ts 4d 3s 9s]
Seat 1: slotmachine (button) folded before Flop (didn't bet)
Seat 2: TurnOnTuneInDropOut (small blind) folded before Flop
Seat 3: vaibz16 (big blind) folded on the Flop
Seat 4: slowcoach folded on the River
Seat 5: badtameez_donk folded before Flop (didn't bet)
Seat 6: aggtarun collected ($31522)

PokerStars Hand #155975276: Omaha Pot Limit ($500/$1000 USD) - 2020/10/23 14:00:29 ET
Table 'ADA766532706' 6-max Seat #3 is the button
Seat 1: slotmachine ($135209 in chips)
Seat 2: TurnOnTuneInDropOut ($73500 in chips)
Seat 3: vaibz16 ($27000 in chips)
Seat 4: slowcoach ($1995 in chips)
Seat 5: badtameez_donk ($168709 in chips)
Seat 6: aggtarun ($144363 in chips)
slowcoach: posts small blind $500
badtameez_donk: posts big blind $1000
*** HOLE CARDS ***
Dealt to TurnOnTuneInDropOut [2d 3s 5h 3d]
aggtarun: raises $2500 to $3500
slotmachine: folds
TurnOnTuneInDropOut: folds
vaibz16: calls $3500
slowcoach: calls $1495 and is all-in
badtameez_donk: folds
*** FLOP *** [Qs Jh 5c]
aggtarun: bets $9995
vaibz16: folds
Uncalled bet ($9995) returned to aggtarun
*** TURN *** [Qs Jh 5c] [4h]
*** RIVER *** [Qs Jh 5c 4h] [2s]
*** SHOW DOWN ***
aggtarun: shows [Js Ad 6c Qd]
aggtarun collected $3010 from side pot
slowcoach: shows [4c Ac Kh 4d]
slowcoach collected $6684 from main pot
*** SUMMARY ***
Total pot $9995 Main pot $6684. Side pot $3010. | Rake $301
Board [Qs Jh 5c 4h 2s]
Seat 1: slotmachine folded before Flop (didn't bet)
Seat 2: TurnOnTuneInDropOut folded before Flop (didn't bet)
Seat 3: vaibz16 (button) folded on the Flop
Seat 4: slowcoach (small blind) showed [4c Ac Kh 4d] and won ($6684)
Seat 5: badtameez_donk (big blind) folded before Flop
Seat 6: aggtarun showed [Js Ad 6c Qd] and won ($3010)

PokerStars Hand #155975277: Omaha Pot Limit ($500/$1000 USD) - 2020/10/23 14:01:12 ET
Table 'ADA766532706' 6-max Seat #4 is the button
Seat 1: slotmachine ($135209 in chips)
Seat 2: TurnOnTuneInDropOut ($73500 in chips)
Seat 3: vaibz16 ($23500 in chips)
Seat 4: slowcoach ($6775 in chips)
Seat 5: badtameez_donk ($167709 in chips)
badtameez_donk: posts small blind $500
slotmachine: posts big blind $1000
*** HOLE CARDS ***
Dealt to TurnOnTuneInDropOut [Jd Th 9c Ts]
TurnOnTuneInDropOut: folds
vaibz16: folds
slowcoach: raises $2500 to $3500
badtameez_donk: folds
slotmachine: raises $5500 to $9000
slowcoach: calls $3275 and is all-in
Uncalled bet ($2225) returned to slotmachine
*** FLOP *** [8d 4h 5c]
*** TURN *** [8d 4h 5c] [5s]
*** RIVER *** [8d 4h 5c 5s] [3s]
*** SHOW DOWN ***
slotmachine: shows [9h Qc 3h Tc]
slowcoach: shows [Kc Jc 7c 8s]
slowcoach collected $13627 from pot
*** SUMMARY ***
Total pot $14050 | Rake $423
Board [8d 4h 5c 5s 3s]
Seat 1: slotmachine (big blind) showed [9h Qc 3h Tc] and lost
Seat 2: TurnOnTuneInDropOut folded before Flop (didn't bet)
Seat 3: vaibz16 folded before Flop (didn't bet)
Seat 4: slowcoach (button) showed [Kc Jc 7c 8s] and won ($13627)
Seat 5: badtameez_donk (small blind) folded before Flop

PokerStars Hand #1099153772: Omaha Pot Limit ($200/$400 USD) - 2020/10/24 06:23:33 ET
Table 'ADA120881500' 6-max Seat #1 is the button
Seat 1: DoJingBULLETS ($48000 in chips)
Seat 2: bothras ($52447 in chips)
Seat 3: vimalchotai001 ($15320 in chips)
Seat 4: TurnOnTuneInDropOut ($30200 in chips)
Seat 6: yatin47 ($44400 in chips)
bothras: posts small blind $200
vimalchotai001: posts big blind $400
*** HOLE CARDS ***
Dealt to TurnOnTuneInDropOut [4c Ts 8c 8d]
TurnOnTuneInDropOut: folds
yatin47: folds
DoJingBULLETS: folds
bothras: calls $200
vimalchotai001: checks
*** FLOP *** [8h Ad Jh]
bothras: bets $600
vimalchotai001: folds
Uncalled bet ($600) returned to bothras
bothras collected $768 from pot
bothras: doesn't show hand
*** SUMMARY ***
Total pot $800 | Rake $32
Board [8h Ad Jh]
Seat 1: DoJingBULLETS (button) folded before Flop (didn't bet)
Seat 2: bothras (small blind) collected ($768)
Seat 3: vimalchotai001 (big blind) folded on the Flop
Seat 4: TurnOnTuneInDropOut folded before Flop (didn't bet)
Seat 6: yatin47 folded before Flop (didn't bet)

PokerStars Hand #1099153773: Omaha Pot Limit ($200/$400 USD) - 2020/10/24 06:24:08 ET
Table 'ADA120881500' 6-max Seat #2 is the button
Seat 1: DoJingBULLETS ($48000 in chips)
Seat 2: bothras ($52815 in chips)
Seat 3: vimalchotai001 ($14920 in chips)
Seat 4: TurnOnTuneInDropOut ($30200 in chips)
Seat 6: yatin47 ($44400 in chips)
vimalchotai001: posts small blind $200
TurnOnTuneInDropOut: posts big blind $400
*** HOLE CARDS ***
Dealt to TurnOnTuneInDropOut [Ad Js 7s Qd]
yatin47: folds
DoJingBULLETS: folds
bothras: raises $1000 to $1400
vimalchotai001: calls $1200
TurnOnTuneInDropOut: raises $4200 to $5600
bothras: calls $4200
vimalchotai001: folds
*** FLOP *** [Td 5h Qc]
TurnOnTuneInDropOut: bets $8116
bothras: folds
Uncalled bet ($8116) returned to TurnOnTuneInDropOut
TurnOnTuneInDropOut collected $12095 from pot
TurnOnTuneInDropOut: doesn't show hand
*** SUMMARY ***
Total pot $12600 | Rake $505
Board [Td 5h Qc]
Seat 1: DoJingBULLETS folded before Flop (didn't bet)
Seat 2: bothras (button) folded on the Flop
Seat 3: vimalchotai001 (small blind) folded before Flop
Seat 4: TurnOnTuneInDropOut (big blind) collected ($12095)
Seat 6: yatin47 folded before Flop (didn't bet)

PokerStars Hand #1099153777: Omaha Pot Limit ($200/$400 USD) - 2020/10/24 06:27:07 ET
Table 'ADA120881500' 6-max Seat #1 is the button
Seat 1: DoJingBULLETS ($48000 in chips)
Seat 2: bothras ($46815 in chips)
Seat 3: vimalchotai001 ($17156 in chips)
Seat 4: TurnOnTuneInDropOut ($36495 in chips)
Seat 6: yatin47 ($43400 in chips)
bothras: posts small blind $200
vimalchotai001: posts big blind $400
*** HOLE CARDS ***
Dealt to TurnOnTuneInDropOut [Qh 7c 8c 8s]
TurnOnTuneInDropOut: folds
yatin47: calls $400
DoJingBULLETS: folds
bothras: calls $200
vimalchotai001: checks
*** FLOP *** [7h 3h 2h]
bothras: checks
vimalchotai001: checks
yatin47: checks
*** TURN *** [7h 3h 2h] [6d]
bothras: bets $900
vimalchotai001: folds
yatin47: folds
Uncalled bet ($900) returned to bothras
bothras collected $1152 from pot
bothras: doesn't show hand
*** SUMMARY ***
Total pot $1200 | Rake $48
Board [7h 3h 2h 6d]
Seat 1: DoJingBULLETS (button) folded before Flop (didn't bet)
Seat 2: bothras (small blind) collected ($1152)
Seat 3: vimalchotai001 (big blind) folded on the Turn
Seat 4: TurnOnTuneInDropOut folded before Flop (didn't bet)
Seat 6: yatin47 folded on the Turn

PokerStars Hand #1099153778: Omaha Pot Limit ($200/$400 USD) - 2020/10/24 06:27:41 ET
Table 'ADA120881500' 6-max Seat #2 is the button
Seat 1: DoJingBULLETS ($48000 in chips)
Seat 2: bothras ($47567 in chips)
Seat 3: vimalchotai001 ($16756 in chips)
Seat 4: TurnOnTuneInDropOut ($36495 in chips)
Seat 6: yatin47 ($43000 in chips)
vimalchotai001: posts small blind $200
TurnOnTuneInDropOut: posts big blind $400
*** HOLE CARDS ***
Dealt to TurnOnTuneInDropOut [Kd 4s Tc 8h]
yatin47: folds
DoJingBULLETS: folds
bothras: raises $1000 to $1400
vimalchotai001: folds
TurnOnTuneInDropOut: folds
Uncalled bet ($1000) returned to bothras
bothras collected $1000 from pot
bothras: doesn't show hand
*** SUMMARY ***
Total pot $1000 | Rake $0
Seat 1: DoJingBULLETS folded before Flop (didn't bet)
Seat 2: bothras (button) collected ($1000)
Seat 3: vimalchotai001 (small blind) folded before Flop
Seat 4: TurnOnTuneInDropOut (big blind) folded before Flop
Seat 6: yatin47 folded before Flop (didn't bet)

PokerStars Hand #1099153779: Omaha Pot Limit ($200/$400 USD) - 2020/10/24 06:28:17 ET
Table 'ADA120881500' 6-max Seat #3 is the button
Seat 1: DoJingBULLETS ($48000 in chips)
Seat 2: bothras ($48167 in chips)
Seat 3: vimalchotai001 ($16556 in chips)
Seat 4: TurnOnTuneInDropOut ($36095 in chips)
Seat 6: yatin47 ($43000 in chips)
TurnOnTuneInDropOut: posts small blind $200
yatin47: posts big blind $400
*** HOLE CARDS ***
Dealt to TurnOnTuneInDropOut [Qh 7d Jd 3h]
DoJingBULLETS: folds
bothras: raises $1000 to $1400
vimalchotai001: folds
TurnOnTuneInDropOut: folds
yatin47: calls $1000
*** FLOP *** [4h 8d 3s]
yatin47: checks
bothras: bets $1800
yatin47: folds
Uncalled bet ($1800) returned to bothras
bothras collected $2880 from pot
bothras: doesn't show hand
*** SUMMARY ***
Total pot $3000 | Rake $120
Board [4h 8d 3s]
Seat 1: DoJingBULLETS folded before Flop (didn't bet)
Seat 2: bothras collected ($2880)
Seat 3: vimalchotai001 (button) folded before Flop (didn't bet)
Seat 4: TurnOnTuneInDropOut (small blind) folded before Flop
Seat 6: yatin47 (big blind) folded on the Flop

PokerStars Hand #1099153781: Omaha Pot Limit ($200/$400 USD) - 2020/10/24 06:29:22 ET
Table 'ADA120881500' 6-max Seat #6 is the button
Seat 2: bothras ($50207 in chips)
Seat 3: vimalchotai001 ($16156 in chips)
Seat 4: TurnOnTuneInDropOut ($35895 in chips)
Seat 6: yatin47 ($41400 in chips)
bothras: posts small blind $200
vimalchotai001: posts big blind $400
*** HOLE CARDS ***
Dealt to TurnOnTuneInDropOut [8d Jd 9h Js]
TurnOnTuneInDropOut: raises $1000 to $1400
yatin47: folds
bothras: folds
vimalchotai001: folds
Uncalled bet ($1000) returned to TurnOnTuneInDropOut
TurnOnTuneInDropOut collected $1000 from pot
TurnOnTuneInDropOut: doesn't show hand
*** SUMMARY ***
Total pot $1000 | Rake $0
Seat 2: bothras (small blind) folded before Flop
Seat 3: vimalchotai001 (big blind) folded before Flop
Seat 4: TurnOnTuneInDropOut collected ($1000)
Seat 6: yatin47 (button) folded before Flop (didn't bet)

PokerStars Hand #1099153782: Omaha Pot Limit ($200/$400 USD) - 2020/10/24 06:29:38 ET
Table 'ADA120881500' 6-max Seat #2 is the button
Seat 2: bothras ($50007 in chips)
Seat 3: vimalchotai001 ($15756 in chips)
Seat 4: TurnOnTuneInDropOut ($36495 in chips)
Seat 6: yatin47 ($41400 in chips)
vimalchotai001: posts small blind $200
TurnOnTuneInDropOut: posts big blind $400
*** HOLE CARDS ***
Dealt to TurnOnTuneInDropOut [Kd 9c 3h Ts]
yatin47: folds
bothras: raises $1000 to $1400
vimalchotai001: calls $1200
TurnOnTuneInDropOut: folds
*** FLOP *** [5h 7h 7s]
vimalchotai001: checks
bothras: checks
*** TURN *** [5h 7h 7s] [2d]
vimalchotai001: bets $800
bothras: calls $800
*** RIVER *** [5h 7h 7s 2d] [8d]
vimalchotai001: bets $1200
bothras: calls $1200
*** SHOW DOWN ***
vimalchotai001: mucks hand
bothras: shows [Ks Ad Ac Js]
bothras collected $6911 from pot
*** SUMMARY ***
Total pot $7200 | Rake $289
Board [5h 7h 7s 2d 8d]
Seat 2: bothras (button) showed [Ks Ad Ac Js] and won ($6911)
Seat 3: vimalchotai001 (small blind) mucked
Seat 4: TurnOnTuneInDropOut (big blind) folded before Flop
Seat 6: yatin47 folded before Flop (didn't bet)

PokerStars Hand #163848419: Omaha Pot Limit ($200/$400 USD) - 2020/10/24 06:01:29 ET
Table 'ADA874189191' 6-max Seat #3 is the button
Seat 1: fernz666 ($48000 in chips)
Seat 3: vimalchotai001 ($14186 in chips)
Seat 4: TurnOnTuneInDropOut ($30368 in chips)
Seat 5: hashstack ($22317 in chips)
Seat 6: nimit2908 ($17704 in chips)
TurnOnTuneInDropOut: posts small blind $200
hashstack: posts big blind $400
*** HOLE CARDS ***
Dealt to TurnOnTuneInDropOut [7s 6d 3d 5h]
nimit2908: folds
fernz666: raises $1000 to $1400
vimalchotai001: calls $1400
TurnOnTuneInDropOut: folds
hashstack: folds
*** FLOP *** [9c Ac 6c]
fernz666: bets $2150
vimalchotai001: folds
Uncalled bet ($2150) returned to fernz666
fernz666 collected $3264 from pot
fernz666: doesn't show hand
*** SUMMARY ***
Total pot $3400 | Rake $136
Board [9c Ac 6c]
Seat 1: fernz666 collected ($3264)
Seat 3: vimalchotai001 (button) folded on the Flop
Seat 4: TurnOnTuneInDropOut (small blind) folded before Flop
Seat 5: hashstack (big blind) folded before Flop
Seat 6: nimit2908 folded before Flop (didn't bet)

PokerStars Hand #163848422: Omaha Pot Limit ($200/$400 USD) - 2020/10/24 06:03:02 ET
Table 'ADA874189191' 6-max Seat #6 is the button
Seat 1: fernz666 ($49464 in chips)
Seat 3: vimalchotai001 ($13346 in chips)
Seat 4: TurnOnTuneInDropOut ($25768 in chips)
Seat 5: hashstack ($21717 in chips)
Seat 6: nimit2908 ($21743 in chips)
fernz666: posts small blind $200
vimalchotai001: posts big blind $400
*** HOLE CARDS ***
Dealt to TurnOnTuneInDropOut [9h Ks 3s Jc]
TurnOnTuneInDropOut: folds
hashstack: raises $650 to $1050
nimit2908: folds
fernz666: folds
vimalchotai001: calls $650
*** FLOP *** [3c Ad 9c]
vimalchotai001: bets $800
hashstack: calls $800
*** TURN *** [3c Ad 9c] [Qc]
vimalchotai001: bets $800
hashstack: raises $1797 to $2597
vimalchotai001: calls $1797
*** RIVER *** [3c Ad 9c Qc] [7s]
vimalchotai001: bets $1600
hashstack: folds
Uncalled bet ($1600) returned to vimalchotai001
vimalchotai001 collected $8729 from pot
vimalchotai001: doesn't show hand
*** SUMMARY ***
Total pot $9094 | Rake $365
Board [3c Ad 9c Qc 7s]
Seat 1: fernz666 (small blind) folded before Flop
Seat 3: vimalchotai001 (big blind) collected ($8729)
Seat 4: TurnOnTuneInDropOut folded before Flop (didn't bet)
Seat 5: hashstack folded on the River
Seat 6: nimit2908 (button) folded before Flop (didn't bet)

PokerStars Hand #163848426: Omaha Pot Limit ($200/$400 USD) - 2020/10/24 06:05:55 ET
Table 'ADA874189191' 6-max Seat #5 is the button
Seat 1: fernz666 ($49264 in chips)
Seat 3: vimalchotai001 ($13628 in chips)
Seat 4: TurnOnTuneInDropOut ($25168 in chips)
Seat 5: hashstack ($21158 in chips)
Seat 6: nimit2908 ($22095 in chips)
nimit2908: posts small blind $200
fernz666: posts big blind $400
*** HOLE CARDS ***
Dealt to TurnOnTuneInDropOut [Ah Ts 9c Kh]
vimalchotai001: raises $800 to $1200
TurnOnTuneInDropOut: raises $3000 to $4200
hashstack: folds
nimit2908: folds
fernz666: folds
vimalchotai001: calls $3000
*** FLOP *** [Td 4s Kd]
vimalchotai001: bets $1600
TurnOnTuneInDropOut: raises $12200 to $13800
vimalchotai001: calls $7828 and is all-in
Uncalled bet ($4372) returned to TurnOnTuneInDropOut
*** TURN *** [Td 4s Kd] [4c]
*** RIVER *** [Td 4s Kd 4c] [8s]
*** SHOW DOWN ***
vimalchotai001: shows [Qd Ac 5h As]
TurnOnTuneInDropOut: shows [Ah Ts 9c Kh]
vimalchotai001 collected $27056 from pot
*** SUMMARY ***
Total pot $27856 | Rake $800
Board [Td 4s Kd 4c 8s]
Seat 1: fernz666 (big blind) folded before Flop
Seat 3: vimalchotai001 showed [Qd Ac 5h As] and won ($27056)
Seat 4: TurnOnTuneInDropOut showed [Ah Ts 9c Kh] and lost
Seat 5: hashstack (button) folded before Flop (didn't bet)
Seat 6: nimit2908 (small blind) folded before Flop

PokerStars Hand #163848427: Omaha Pot Limit ($200/$400 USD) - 2020/10/24 06:06:29 ET
Table 'ADA874189191' 6-max Seat #6 is the button
Seat 1: fernz666 ($48864 in chips)
Seat 2: bothras ($48000 in chips)
Seat 3: vimalchotai001 ($27056 in chips)
Seat 4: TurnOnTuneInDropOut ($11540 in chips)
Seat 5: hashstack ($21158 in chips)
Seat 6: nimit2908 ($21895 in chips)
fernz666: posts small blind $200
bothras: posts big blind $400
*** HOLE CARDS ***
Dealt to TurnOnTuneInDropOut [2h 5c 4h 3s]
vimalchotai001: folds
TurnOnTuneInDropOut: folds
hashstack: folds
nimit2908: folds
fernz666: folds
Uncalled bet ($200) returned to bothras
bothras collected $400 from pot
bothras: doesn't show hand
*** SUMMARY ***
Total pot $400 | Rake $0
Seat 1: fernz666 (small blind) folded before Flop
Seat 2: bothras (big blind) collected ($400)
Seat 3: vimalchotai001 folded before Flop (didn't bet)
Seat 4: TurnOnTuneInDropOut folded before Flop (didn't bet)
Seat 5: hashstack folded before Flop (didn't bet)
Seat 6: nimit2908 (button) folded before Flop (didn't bet)

PokerStars Hand #163848428: Omaha Pot Limit ($200/$400 USD) - 2020/10/24 06:06:48 ET
Table 'ADA874189191' 6-max Seat #1 is the button
Seat 1: fernz666 ($48664 in chips)
Seat 2: bothras ($48200 in chips)
Seat 3: vimalchotai001 ($27056 in chips)
Seat 4: TurnOnTuneInDropOut ($24000 in chips)
Seat 5: hashstack ($21158 in chips)
Seat 6: nimit2908 ($21895 in chips)
bothras: posts small blind $200
vimalchotai001: posts big blind $400
*** HOLE CARDS ***
Dealt to TurnOnTuneInDropOut [Qs 3h 2s 4c]
TurnOnTuneInDropOut: folds
hashstack: raises $650 to $1050
nimit2908: folds
fernz666: folds
bothras: folds
vimalchotai001: folds
Uncalled bet ($650) returned to hashstack
hashstack collected $1000 from pot
hashstack: doesn't show hand
*** SUMMARY ***
Total pot $1000 | Rake $0
Seat 1: fernz666 (button) folded before Flop (didn't bet)
Seat 2: bothras (small blind) folded before Flop
Seat 3: vimalchotai001 (big blind) folded before Flop
Seat 4: TurnOnTuneInDropOut folded before Flop (didn't bet)
Seat 5: hashstack collected ($1000)
Seat 6: nimit2908 folded before Flop (didn't bet)

PokerStars Hand #163848429: Omaha Pot Limit ($200/$400 USD) - 2020/10/24 06:07:05 ET
Table 'ADA874189191' 6-max Seat #2 is the button
Seat 1: fernz666 ($48664 in chips)
Seat 2: bothras ($48000 in chips)
Seat 3: vimalchotai001 ($26656 in chips)
Seat 4: TurnOnTuneInDropOut ($24000 in chips)
Seat 5: hashstack ($21758 in chips)
Seat 6: nimit2908 ($21895 in chips)
vimalchotai001: posts small blind $200
TurnOnTuneInDropOut: posts big blind $400
*** HOLE CARDS ***
Dealt to TurnOnTuneInDropOut [5s 3d 5c 6s]
hashstack: folds
nimit2908: folds
fernz666: folds
bothras: raises $1000 to $1400
vimalchotai001: calls $1200
TurnOnTuneInDropOut: folds
*** FLOP *** [Ah 6d 8s]
vimalchotai001: checks
bothras: checks
*** TURN *** [Ah 6d 8s] [5d]
vimalchotai001: bets $1200
bothras: folds
Uncalled bet ($1200) returned to vimalchotai001
vimalchotai001 collected $3072 from pot
vimalchotai001: doesn't show hand
*** SUMMARY ***
Total pot $3200 | Rake $128
Board [Ah 6d 8s 5d]
Seat 1: fernz666 folded before Flop (didn't bet)
Seat 2: bothras (button) folded on the Turn
Seat 3: vimalchotai001 (small blind) collected ($3072)
Seat 4: TurnOnTuneInDropOut (big blind) folded before Flop
Seat 5: hashstack folded before Flop (didn't bet)
Seat 6: nimit2908 folded before Flop (didn't bet)

PokerStars Hand #163848431: Omaha Pot Limit ($200/$400 USD) - 2020/10/24 06:08:22 ET
Table 'ADA874189191' 6-max Seat #4 is the button
Seat 1: fernz666 ($48664 in chips)
Seat 2: bothras ($46600 in chips)
Seat 3: vimalchotai001 ($27428 in chips)
Seat 4: TurnOnTuneInDropOut ($23400 in chips)
Seat 5: hashstack ($22778 in chips)
Seat 6: nimit2908 ($21895 in chips)
hashstack: posts small blind $200
nimit2908: posts big blind $400
*** HOLE CARDS ***
Dealt to TurnOnTuneInDropOut [4c Jd Ac 5c]
fernz666: raises $1000 to $1400
bothras: folds
vimalchotai001: folds
TurnOnTuneInDropOut: folds
hashstack: folds
nimit2908: folds
Uncalled bet ($1000) returned to fernz666
fernz666 collected $1000 from pot
fernz666: doesn't show hand
*** SUMMARY ***
Total pot $1000 | Rake $0
Seat 1: fernz666 collected ($1000)
Seat 2: bothras folded before Flop (didn't bet)
Seat 3: vimalchotai001 folded before Flop (didn't bet)
Seat 4: TurnOnTuneInDropOut (button) folded before Flop (didn't bet)
Seat 5: hashstack (small blind) folded before Flop
Seat 6: nimit2908 (big blind) folded before Flop

PokerStars Hand #163848437: Omaha Pot Limit ($200/$400 USD) - 2020/10/24 06:12:01 ET
Table 'ADA874189191' 6-max Seat #4 is the button
Seat 1: fernz666 ($57179 in chips)
Seat 2: bothras ($37360 in chips)
Seat 3: vimalchotai001 ($29212 in chips)
Seat 4: TurnOnTuneInDropOut ($32226 in chips)
Seat 5: hashstack ($22178 in chips)
Seat 6: nimit2908 ($17695 in chips)
hashstack: posts small blind $200
nimit2908: posts big blind $400
*** HOLE CARDS ***
Dealt to TurnOnTuneInDropOut [7s 4h 2s 6s]
fernz666: folds
bothras: folds
vimalchotai001: folds
TurnOnTuneInDropOut: folds
hashstack: calls $200
nimit2908: raises $800 to $1200
hashstack: calls $800
*** FLOP *** [4s Qc Ts]
hashstack: checks
nimit2908: bets $1800
hashstack: raises $6000 to $7800
nimit2908: folds
Uncalled bet ($6000) returned to hashstack
hashstack collected $5759 from pot
hashstack: doesn't show hand
*** SUMMARY ***
Total pot $6000 | Rake $241
Board [4s Qc Ts]
Seat 1: fernz666 folded before Flop (didn't bet)
Seat 2: bothras folded before Flop (didn't bet)
Seat 3: vimalchotai001 folded before Flop (didn't bet)
Seat 4: TurnOnTuneInDropOut (button) folded before Flop (didn't bet)
Seat 5: hashstack (small blind) collected ($5759)
Seat 6: nimit2908 (big blind) folded on the Flop

PokerStars Hand #163848438: Omaha Pot Limit ($200/$400 USD) - 2020/10/24 06:12:42 ET
Table 'ADA874189191' 6-max Seat #5 is the button
Seat 1: fernz666 ($57179 in chips)
Seat 2: bothras ($37360 in chips)
Seat 3: vimalchotai001 ($29212 in chips)
Seat 4: TurnOnTuneInDropOut ($32226 in chips)
Seat 5: hashstack ($24937 in chips)
Seat 6: nimit2908 ($14695 in chips)
nimit2908: posts small blind $200
fernz666: posts big blind $400
*** HOLE CARDS ***
Dealt to TurnOnTuneInDropOut [Ks Tc 7d 9d]
bothras: folds
vimalchotai001: folds
TurnOnTuneInDropOut: raises $1000 to $1400
hashstack: calls $1400
nimit2908: calls $1200
fernz666: folds
*** FLOP *** [7s 6d 2d]
nimit2908: checks
TurnOnTuneInDropOut: checks
hashstack: checks
*** TURN *** [7s 6d 2d] [As]
nimit2908: checks
TurnOnTuneInDropOut: checks
hashstack: checks
*** RIVER *** [7s 6d 2d As] [Ad]
nimit2908: checks
TurnOnTuneInDropOut: checks
hashstack: bets $2250
nimit2908: folds
TurnOnTuneInDropOut: calls $2250
*** SHOW DOWN ***
TurnOnTuneInDropOut: shows [Ks Tc 7d 9d]
hashstack: shows [Qh Td Js 2s]
TurnOnTuneInDropOut collected $8735 from pot
*** SUMMARY ***
Total pot $9100 | Rake $365
Board [7s 6d 2d As Ad]
Seat 1: fernz666 (big blind) folded before Flop
Seat 2: bothras folded before Flop (didn't bet)
Seat 3: vimalchotai001 folded before Flop (didn't bet)
Seat 4: TurnOnTuneInDropOut showed [Ks Tc 7d 9d] and won ($8735)
Seat 5: hashstack (button) showed [Qh Td Js 2s] and lost
Seat 6: nimit2908 (small blind) folded on the River

PokerStars Hand #163848440: Omaha Pot Limit ($200/$400 USD) - 2020/10/24 06:14:19 ET
Table 'ADA874189191' 6-max Seat #1 is the button
Seat 1: fernz666 ($56579 in chips)
Seat 2: bothras ($36960 in chips)
Seat 3: vimalchotai001 ($28812 in chips)
Seat 4: TurnOnTuneInDropOut ($50806 in chips)
Seat 5: hashstack ($21287 in chips)
bothras: posts small blind $200
vimalchotai001: posts big blind $400
*** HOLE CARDS ***
Dealt to TurnOnTuneInDropOut [2c Kd Qd Td]
TurnOnTuneInDropOut: folds
hashstack: folds
fernz666: folds
bothras: folds
Uncalled bet ($200) returned to vimalchotai001
vimalchotai001 collected $400 from pot
vimalchotai001: doesn't show hand
*** SUMMARY ***
Total pot $400 | Rake $0
Seat 1: fernz666 (button) folded before Flop (didn't bet)
Seat 2: bothras (small blind) folded before Flop
Seat 3: vimalchotai001 (big blind) collected ($400)
Seat 4: TurnOnTuneInDropOut folded before Flop (didn't bet)
Seat 5: hashstack folded before Flop (didn't bet)

PokerStars Hand #163848441: Omaha Pot Limit ($200/$400 USD) - 2020/10/24 06:14:32 ET
Table 'ADA874189191' 6-max Seat #2 is the button
Seat 1: fernz666 ($56579 in chips)
Seat 2: bothras ($36760 in chips)
Seat 3: vimalchotai001 ($29012 in chips)
Seat 4: TurnOnTuneInDropOut ($50806 in chips)
Seat 5: hashstack ($21287 in chips)
vimalchotai001: posts small blind $200
TurnOnTuneInDropOut: posts big blind $400
*** HOLE CARDS ***
Dealt to TurnOnTuneInDropOut [9d Kh 2c 9s]
hashstack: folds
fernz666: raises $1000 to $1400
bothras: folds
vimalchotai001: calls $1200
TurnOnTuneInDropOut: folds
*** FLOP *** [4d 5c 7d]
vimalchotai001: checks
fernz666: checks
*** TURN *** [4d 5c 7d] [Kd]
vimalchotai001: bets $800
fernz666: folds
Uncalled bet ($800) returned to vimalchotai001
vimalchotai001 collected $3072 from pot
vimalchotai001: doesn't show hand
*** SUMMARY ***
Total pot $3200 | Rake $128
Board [4d 5c 7d Kd]
Seat 1: fernz666 folded on the Turn
Seat 2: bothras (button) folded before Flop (didn't bet)
Seat 3: vimalchotai001 (small blind) collected ($3072)
Seat 4: TurnOnTuneInDropOut (big blind) folded before Flop
Seat 5: hashstack folded before Flop (didn't bet)

PokerStars Hand #163848442: Omaha Pot Limit ($200/$400 USD) - 2020/10/24 06:15:02 ET
Table 'ADA874189191' 6-max Seat #3 is the button
Seat 1: fernz666 ($55179 in chips)
Seat 2: bothras ($36760 in chips)
Seat 3: vimalchotai001 ($30684 in chips)
Seat 4: TurnOnTuneInDropOut ($50406 in chips)
Seat 5: hashstack ($21287 in chips)
TurnOnTuneInDropOut: posts small blind $200
hashstack: posts big blind $400
*** HOLE CARDS ***
Dealt to TurnOnTuneInDropOut [6c 7s Tc 8d]
fernz666: raises $1000 to $1400
bothras: folds
vimalchotai001: folds
TurnOnTuneInDropOut: folds
hashstack: folds
Uncalled bet ($1000) returned to fernz666
fernz666 collected $1000 from pot
fernz666: doesn't show hand
*** SUMMARY ***
Total pot $1000 | Rake $0
Seat 1: fernz666 collected ($1000)
Seat 2: bothras folded before Flop (didn't bet)
Seat 3: vimalchotai001 (button) folded before Flop (didn't bet)
Seat 4: TurnOnTuneInDropOut (small blind) folded before Flop
Seat 5: hashstack (big blind) folded before Flop

PokerStars Hand #163848443: Omaha Pot Limit ($200/$400 USD) - 2020/10/24 06:15:20 ET
Table 'ADA874189191' 6-max Seat #4 is the button
Seat 1: fernz666 ($55779 in chips)
Seat 2: bothras ($36760 in chips)
Seat 3: vimalchotai001 ($30684 in chips)
Seat 4: TurnOnTuneInDropOut ($50206 in chips)
Seat 5: hashstack ($20887 in chips)
hashstack: posts small blind $200
fernz666: posts big blind $400
*** HOLE CARDS ***
Dealt to TurnOnTuneInDropOut [Th 7c 3h 8s]
bothras: folds
vimalchotai001: folds
TurnOnTuneInDropOut: raises $1000 to $1400
hashstack: folds
fernz666: folds
Uncalled bet ($1000) returned to TurnOnTuneInDropOut
TurnOnTuneInDropOut collected $1000 from pot
TurnOnTuneInDropOut: doesn't show hand
*** SUMMARY ***
Total pot $1000 | Rake $0
Seat 1: fernz666 (big blind) folded before Flop
Seat 2: bothras folded before Flop (didn't bet)
Seat 3: vimalchotai001 folded before Flop (didn't bet)
Seat 4: TurnOnTuneInDropOut (button) collected ($1000)
Seat 5: hashstack (small blind) folded before Flop

PokerStars Hand #163848445: Omaha Pot Limit ($200/$400 USD) - 2020/10/24 06:16:06 ET
Table 'ADA874189191' 6-max Seat #1 is the button
Seat 1: fernz666 ($55179 in chips)
Seat 2: bothras ($37320 in chips)
Seat 3: vimalchotai001 ($30284 in chips)
Seat 4: TurnOnTuneInDropOut ($50806 in chips)
Seat 5: hashstack ($20687 in chips)
bothras: posts small blind $200
vimalchotai001: posts big blind $400
*** HOLE CARDS ***
Dealt to TurnOnTuneInDropOut [Ad Kc 5h 9d]
TurnOnTuneInDropOut: folds
hashstack: folds
fernz666: raises $1000 to $1400
bothras: folds
vimalchotai001: calls $1000
*** FLOP *** [7h Qc Qh]
vimalchotai001: checks
fernz666: bets $1900
vimalchotai001: calls $1900
*** TURN *** [7h Qc Qh] [Qs]
vimalchotai001: checks
fernz666: bets $4200
vimalchotai001: calls $4200
*** RIVER *** [7h Qc Qh Qs] [As]
vimalchotai001: bets $3200
fernz666: folds
Uncalled bet ($3200) returned to vimalchotai001
vimalchotai001 collected $14590 from pot
vimalchotai001: doesn't show hand
*** SUMMARY ***
Total pot $15200 | Rake $610
Board [7h Qc Qh Qs As]
Seat 1: fernz666 (button) folded on the River
Seat 2: bothras (small blind) folded before Flop
Seat 3: vimalchotai001 (big blind) collected ($14590)
Seat 4: TurnOnTuneInDropOut folded before Flop (didn't bet)
Seat 5: hashstack folded before Flop (didn't bet)

PokerStars Hand #163848450: Omaha Pot Limit ($200/$400 USD) - 2020/10/24 06:19:33 ET
Table 'ADA874189191' 6-max Seat #1 is the button
Seat 1: fernz666 ($47079 in chips)
Seat 2: bothras ($38952 in chips)
Seat 3: vimalchotai001 ($35726 in chips)
Seat 4: TurnOnTuneInDropOut ($53965 in chips)
Seat 5: hashstack ($17439 in chips)
bothras: posts small blind $200
vimalchotai001: posts big blind $400
*** HOLE CARDS ***
Dealt to TurnOnTuneInDropOut [Jc 3d 4s 9c]
TurnOnTuneInDropOut: folds
hashstack: folds
fernz666: raises $1000 to $1400
bothras: folds
vimalchotai001: calls $1000
*** FLOP *** [Ts Kd Qd]
vimalchotai001: bets $800
fernz666: raises $3250 to $4050
vimalchotai001: calls $3250
*** TURN *** [Ts Kd Qd] [5c]
vimalchotai001: bets $1200
fernz666: raises $9825 to $11025
vimalchotai001: folds
Uncalled bet ($9825) returned to fernz666
fernz666 collected $12959 from pot
fernz666: doesn't show hand
*** SUMMARY ***
Total pot $13500 | Rake $541
Board [Ts Kd Qd 5c]
Seat 1: fernz666 (button) collected ($12959)
Seat 2: bothras (small blind) folded before Flop
Seat 3: vimalchotai001 (big blind) folded on the Turn
Seat 4: TurnOnTuneInDropOut folded before Flop (didn't bet)
Seat 5: hashstack folded before Flop (didn't bet)

PokerStars Hand #163848451: Omaha Pot Limit ($200/$400 USD) - 2020/10/24 06:20:19 ET
Table 'ADA874189191' 6-max Seat #2 is the button
Seat 1: fernz666 ($53388 in chips)
Seat 2: bothras ($38752 in chips)
Seat 3: vimalchotai001 ($29076 in chips)
Seat 4: TurnOnTuneInDropOut ($53965 in chips)
Seat 5: hashstack ($17439 in chips)
vimalchotai001: posts small blind $200
TurnOnTuneInDropOut: posts big blind $400
*** HOLE CARDS ***
Dealt to TurnOnTuneInDropOut [9s Jc 7s 2h]
hashstack: raises $400 to $800
fernz666: folds
bothras: calls $800
vimalchotai001: folds
TurnOnTuneInDropOut: folds
*** FLOP *** [8s Qh 4c]
hashstack: checks
bothras: checks
*** TURN *** [8s Qh 4c] [4s]
hashstack: bets $1500
bothras: folds
Uncalled bet ($1500) returned to hashstack
hashstack collected $2112 from pot
hashstack: doesn't show hand
*** SUMMARY ***
Total pot $2200 | Rake $88
Board [8s Qh 4c 4s]
Seat 1: fernz666 folded before Flop (didn't bet)
Seat 2: bothras (button) folded on the Turn
Seat 3: vimalchotai001 (small blind) folded before Flop
Seat 4: TurnOnTuneInDropOut (big blind) folded before Flop
Seat 5: hashstack collected ($2112)

PokerStars Hand #163848452: Omaha Pot Limit ($200/$400 USD) - 2020/10/24 06:20:58 ET
Table 'ADA874189191' 6-max Seat #3 is the button
Seat 1: fernz666 ($53388 in chips)
Seat 2: bothras ($37952 in chips)
Seat 3: vimalchotai001 ($28876 in chips)
Seat 4: TurnOnTuneInDropOut ($53565 in chips)
Seat 5: hashstack ($18751 in chips)
TurnOnTuneInDropOut: posts small blind $200
hashstack: posts big blind $400
*** HOLE CARDS ***
Dealt to TurnOnTuneInDropOut [4d 2c 4c Qd]
fernz666: folds
bothras: raises $1000 to $1400
vimalchotai001: folds
TurnOnTuneInDropOut: folds
hashstack: calls $1000
*** FLOP *** [2d Jh 8s]
hashstack: checks
bothras: bets $2250
hashstack: folds
Uncalled bet ($2250) returned to bothras
bothras collected $2880 from pot
bothras: doesn't show hand
*** SUMMARY ***
Total pot $3000 | Rake $120
Board [2d Jh 8s]
Seat 1: fernz666 folded before Flop (didn't bet)
Seat 2: bothras collected ($2880)
Seat 3: vimalchotai001 (button) folded before Flop (didn't bet)
Seat 4: TurnOnTuneInDropOut (small blind) folded before Flop
Seat 5: hashstack (big blind) folded on the Flop

PokerStars Hand #163848454: Omaha Pot Limit ($200/$400 USD) - 2020/10/24 06:22:13 ET
Table 'ADA874189191' 6-max Seat #5 is the button
Seat 1: fernz666 ($36037 in chips)
Seat 2: bothras ($39432 in chips)
Seat 3: vimalchotai001 ($28476 in chips)
Seat 4: TurnOnTuneInDropOut ($51565 in chips)
Seat 5: hashstack ($36102 in chips)
fernz666: posts small blind $200
bothras: posts big blind $400
*** HOLE CARDS ***
Dealt to TurnOnTuneInDropOut [Jh Tc 9d 9c]
vimalchotai001: folds
TurnOnTuneInDropOut: raises $1000 to $1400
hashstack: folds
fernz666: folds
bothras: calls $1000
*** FLOP *** [Ad 4h Qh]
bothras: checks
TurnOnTuneInDropOut: bets $1980
bothras: calls $1980
*** TURN *** [Ad 4h Qh] [7h]
bothras: checks
TurnOnTuneInDropOut: bets $2854
bothras: folds
Uncalled bet ($2854) returned to TurnOnTuneInDropOut
TurnOnTuneInDropOut collected $6681 from pot
TurnOnTuneInDropOut: doesn't show hand
*** SUMMARY ***
Total pot $6960 | Rake $279
Board [Ad 4h Qh 7h]
Seat 1: fernz666 (small blind) folded before Flop
Seat 2: bothras (big blind) folded on the Turn
Seat 3: vimalchotai001 folded before Flop (didn't bet)
Seat 4: TurnOnTuneInDropOut collected ($6681)
Seat 5: hashstack (button) folded before Flop (didn't bet)

PokerStars Hand #163848455: Omaha Pot Limit ($200/$400 USD) - 2020/10/24 06:22:50 ET
Table 'ADA874189191' 6-max Seat #1 is the button
Seat 1: fernz666 ($48000 in chips)
Seat 2: bothras ($36052 in chips)
Seat 3: vimalchotai001 ($28476 in chips)
Seat 4: TurnOnTuneInDropOut ($54866 in chips)
Seat 5: hashstack ($36102 in chips)
bothras: posts small blind $200
vimalchotai001: posts big blind $400
*** HOLE CARDS ***
Dealt to TurnOnTuneInDropOut [4d 6s 3c 4c]
TurnOnTuneInDropOut: folds
hashstack: folds
fernz666: folds
bothras: folds
Uncalled bet ($200) returned to vimalchotai001
vimalchotai001 collected $400 from pot
vimalchotai001: doesn't show hand
*** SUMMARY ***
Total pot $400 | Rake $0
Seat 1: fernz666 (button) folded before Flop (didn't bet)
Seat 2: bothras (small blind) folded before Flop
Seat 3: vimalchotai001 (big blind) collected ($400)
Seat 4: TurnOnTuneInDropOut folded before Flop (didn't bet)
Seat 5: hashstack folded before Flop (didn't bet)

PokerStars Hand #163848456: Omaha Pot Limit ($200/$400 USD) - 2020/10/24 06:23:02 ET
Table 'ADA874189191' 6-max Seat #2 is the button
Seat 1: fernz666 ($48000 in chips)
Seat 2: bothras ($35852 in chips)
Seat 3: vimalchotai001 ($28676 in chips)
Seat 4: TurnOnTuneInDropOut ($54866 in chips)
Seat 5: hashstack ($36102 in chips)
vimalchotai001: posts small blind $200
TurnOnTuneInDropOut: posts big blind $400
*** HOLE CARDS ***
Dealt to TurnOnTuneInDropOut [5c 9c Jd Qd]
hashstack: folds
fernz666: folds
bothras: folds
vimalchotai001: calls $200
TurnOnTuneInDropOut: raises $800 to $1200
vimalchotai001: calls $800
*** FLOP *** [7s 9h 6h]
vimalchotai001: checks
TurnOnTuneInDropOut: checks
*** TURN *** [7s 9h 6h] [2h]
vimalchotai001: checks
TurnOnTuneInDropOut: checks
*** RIVER *** [7s 9h 6h 2h] [Ah]
vimalchotai001: checks
TurnOnTuneInDropOut: checks
*** SHOW DOWN ***
vimalchotai001: shows [As 8d Js 9d]
vimalchotai001 collected $2304 from pot
*** SUMMARY ***
Total pot $2400 | Rake $96
Board [7s 9h 6h 2h Ah]
Seat 1: fernz666 folded before Flop (didn't bet)
Seat 2: bothras (button) folded before Flop (didn't bet)
Seat 3: vimalchotai001 (small blind) showed [As 8d Js 9d] and won ($2304)
Seat 4: TurnOnTuneInDropOut (big blind)
Seat 5: hashstack folded before Flop (didn't bet)

PokerStars Hand #163848457: Omaha Pot Limit ($200/$400 USD) - 2020/10/24 06:23:53 ET
Table 'ADA874189191' 6-max Seat #3 is the button
Seat 1: fernz666 ($48000 in chips)
Seat 2: bothras ($35852 in chips)
Seat 3: vimalchotai001 ($29780 in chips)
Seat 4: TurnOnTuneInDropOut ($53666 in chips)
TurnOnTuneInDropOut: posts small blind $200
fernz666: posts big blind $400
*** HOLE CARDS ***
Dealt to TurnOnTuneInDropOut [8d 8c 4h Js]
bothras: folds
vimalchotai001: folds
TurnOnTuneInDropOut: folds
Uncalled bet ($200) returned to fernz666
fernz666 collected $400 from pot
fernz666: doesn't show hand
*** SUMMARY ***
Total pot $400 | Rake $0
Seat 1: fernz666 (big blind) collected ($400)
Seat 2: bothras folded before Flop (didn't bet)
Seat 3: vimalchotai001 (button) folded before Flop (didn't bet)
Seat 4: TurnOnTuneInDropOut (small blind) folded before Flop

PokerStars Hand #163848459: Omaha Pot Limit ($200/$400 USD) - 2020/10/24 06:24:53 ET
Table 'ADA874189191' 6-max Seat #1 is the button
Seat 1: fernz666 ($48000 in chips)
Seat 2: bothras ($36412 in chips)
Seat 3: vimalchotai001 ($29380 in chips)
Seat 4: TurnOnTuneInDropOut ($53466 in chips)
bothras: posts small blind $200
vimalchotai001: posts big blind $400
*** HOLE CARDS ***
Dealt to TurnOnTuneInDropOut [Ac 6h 3c Ks]
TurnOnTuneInDropOut: folds
fernz666: folds
bothras: calls $200
vimalchotai001: checks
*** FLOP *** [6d Kc Th]
bothras: bets $480
vimalchotai001: folds
Uncalled bet ($480) returned to bothras
bothras collected $768 from pot
bothras: doesn't show hand
*** SUMMARY ***
Total pot $800 | Rake $32
Board [6d Kc Th]
Seat 1: fernz666 (button) folded before Flop (didn't bet)
Seat 2: bothras (small blind) collected ($768)
Seat 3: vimalchotai001 (big blind) folded on the Flop
Seat 4: TurnOnTuneInDropOut folded before Flop (didn't bet)

PokerStars Hand #1922877784: Omaha Pot Limit ($200/$400 USD) - 2020/10/23 12:20:03 ET
Table 'ADA179504417' 6-max Seat #4 is the button
Seat 1: kaushal222 ($9309 in chips)
Seat 2: soundfsilenz ($90274 in chips)
Seat 3: TurnOnTuneInDropOut ($29400 in chips)
Seat 4: karanchawla09 ($18891 in chips)
Seat 5: PokerMessi ($91597 in chips)
Seat 6: slotmachine ($51871 in chips)
PokerMessi: posts small blind $200
slotmachine: posts big blind $400
*** HOLE CARDS ***
Dealt to TurnOnTuneInDropOut [4c 9d 5c 4h]
kaushal222: folds
soundfsilenz: folds
TurnOnTuneInDropOut: folds
karanchawla09: calls $400
PokerMessi: folds
slotmachine: checks
*** FLOP *** [As 3h 8c]
slotmachine: checks
karanchawla09: checks
*** TURN *** [As 3h 8c] [Jc]
slotmachine: checks
karanchawla09: checks
*** RIVER *** [As 3h 8c Jc] [8d]
slotmachine: checks
karanchawla09: bets $400
slotmachine: folds
Uncalled bet ($400) returned to karanchawla09
karanchawla09 collected $960 from pot
karanchawla09: doesn't show hand
*** SUMMARY ***
Total pot $1000 | Rake $40
Board [As 3h 8c Jc 8d]
Seat 1: kaushal222 folded before Flop (didn't bet)
Seat 2: soundfsilenz folded before Flop (didn't bet)
Seat 3: TurnOnTuneInDropOut folded before Flop (didn't bet)
Seat 4: karanchawla09 (button) collected ($960)
Seat 5: PokerMessi (small blind) folded before Flop
Seat 6: slotmachine (big blind) folded on the River

PokerStars Hand #1922877785: Omaha Pot Limit ($200/$400 USD) - 2020/10/23 12:20:56 ET
Table 'ADA179504417' 6-max Seat #5 is the button
Seat 1: kaushal222 ($9309 in chips)
Seat 2: soundfsilenz ($90274 in chips)
Seat 3: TurnOnTuneInDropOut ($29400 in chips)
Seat 4: karanchawla09 ($19451 in chips)
Seat 5: PokerMessi ($91397 in chips)
Seat 6: slotmachine ($51471 in chips)
slotmachine: posts small blind $200
kaushal222: posts big blind $400
*** HOLE CARDS ***
Dealt to TurnOnTuneInDropOut [Qh 8h Ks 6d]
soundfsilenz: folds
TurnOnTuneInDropOut: folds
karanchawla09: calls $400
PokerMessi: folds
slotmachine: folds
kaushal222: checks
*** FLOP *** [Td 3d As]
kaushal222: checks
karanchawla09: checks
*** TURN *** [Td 3d As] [4h]
kaushal222: checks
karanchawla09: checks
*** RIVER *** [Td 3d As 4h] [4c]
kaushal222: bets $400
karanchawla09: calls $400
*** SHOW DOWN ***
kaushal222: shows [9c 4s 7h Ac]
karanchawla09: mucks hand
kaushal222 collected $1728 from pot
*** SUMMARY ***
Total pot $1800 | Rake $72
Board [Td 3d As 4h 4c]
Seat 1: kaushal222 (big blind) showed [9c 4s 7h Ac] and won ($1728)
Seat 2: soundfsilenz folded before Flop (didn't bet)
Seat 3: TurnOnTuneInDropOut folded before Flop (didn't bet)
Seat 4: karanchawla09 mucked
Seat 5: PokerMessi (button) folded before Flop (didn't bet)
Seat 6: slotmachine (small blind) folded before Flop

PokerStars Hand #1922877786: Omaha Pot Limit ($200/$400 USD) - 2020/10/23 12:22:38 ET
Table 'ADA179504417' 6-max Seat #6 is the button
Seat 1: kaushal222 ($10237 in chips)
Seat 2: soundfsilenz ($90274 in chips)
Seat 3: TurnOnTuneInDropOut ($29400 in chips)
Seat 4: karanchawla09 ($18651 in chips)
Seat 5: PokerMessi ($91397 in chips)
Seat 6: slotmachine ($51271 in chips)
kaushal222: posts small blind $200
soundfsilenz: posts big blind $400
*** HOLE CARDS ***
Dealt to TurnOnTuneInDropOut [Qh 8s Jd 2c]
TurnOnTuneInDropOut: folds
karanchawla09: calls $400
PokerMessi: folds
slotmachine: folds
kaushal222: calls $200
soundfsilenz: checks
*** FLOP *** [Ts 6s Qs]
kaushal222: checks
soundfsilenz: checks
karanchawla09: bets $1200
kaushal222: folds
soundfsilenz: folds
Uncalled bet ($1200) returned to karanchawla09
karanchawla09 collected $1152 from pot
karanchawla09: doesn't show hand
*** SUMMARY ***
Total pot $1200 | Rake $48
Board [Ts 6s Qs]
Seat 1: kaushal222 (small blind) folded on the Flop
Seat 2: soundfsilenz (big blind) folded on the Flop
Seat 3: TurnOnTuneInDropOut folded before Flop (didn't bet)
Seat 4: karanchawla09 collected ($1152)
Seat 5: PokerMessi folded before Flop (didn't bet)
Seat 6: slotmachine (button) folded before Flop (didn't bet)

PokerStars Hand #1922877864: Omaha Pot Limit ($200/$400 USD) - 2020/10/23 13:43:38 ET
Table 'ADA179504417' 6-max Seat #2 is the button
Seat 1: ag2703 ($87187 in chips)
Seat 2: MadMonkey ($12161 in chips)
Seat 3: kimjongun ($73123 in chips)
Seat 4: TurnOnTuneInDropOut ($30000 in chips)
Seat 5: soundfsilenz ($44947 in chips)
Seat 6: slotmachine ($72776 in chips)
kimjongun: posts small blind $200
TurnOnTuneInDropOut: posts big blind $400
*** HOLE CARDS ***
Dealt to TurnOnTuneInDropOut [5d 2c 2d 5h]
soundfsilenz: folds
slotmachine: folds
ag2703: folds
MadMonkey: folds
kimjongun: folds
Uncalled bet ($200) returned to TurnOnTuneInDropOut
TurnOnTuneInDropOut collected $400 from pot
TurnOnTuneInDropOut: doesn't show hand
*** SUMMARY ***
Total pot $400 | Rake $0
Seat 1: ag2703 folded before Flop (didn't bet)
Seat 2: MadMonkey (button) folded before Flop (didn't bet)
Seat 3: kimjongun (small blind) folded before Flop
Seat 4: TurnOnTuneInDropOut (big blind) collected ($400)
Seat 5: soundfsilenz folded before Flop (didn't bet)
Seat 6: slotmachine folded before Flop (didn't bet)

PokerStars Hand #1922877867: Omaha Pot Limit ($200/$400 USD) - 2020/10/23 13:45:50 ET
Table 'ADA179504417' 6-max Seat #5 is the button
Seat 1: ag2703 ($86387 in chips)
Seat 2: MadMonkey ($13857 in chips)
Seat 3: kimjongun ($73523 in chips)
Seat 4: TurnOnTuneInDropOut ($30000 in chips)
Seat 5: soundfsilenz ($43947 in chips)
Seat 6: slotmachine ($72376 in chips)
slotmachine: posts small blind $200
ag2703: posts big blind $400
*** HOLE CARDS ***
Dealt to TurnOnTuneInDropOut [Qh Kh 4d 6d]
MadMonkey: folds
kimjongun: folds
TurnOnTuneInDropOut: raises $1000 to $1400
soundfsilenz: raises $3400 to $4800
slotmachine: folds
ag2703: calls $4400
TurnOnTuneInDropOut: folds
*** FLOP *** [4c 4h 6c]
ag2703: checks
soundfsilenz: bets $7504
ag2703: folds
Uncalled bet ($7504) returned to soundfsilenz
soundfsilenz collected $10751 from pot
soundfsilenz: doesn't show hand
*** SUMMARY ***
Total pot $11200 | Rake $449
Board [4c 4h 6c]
Seat 1: ag2703 (big blind) folded on the Flop
Seat 2: MadMonkey folded before Flop (didn't bet)
Seat 3: kimjongun folded before Flop (didn't bet)
Seat 4: TurnOnTuneInDropOut folded before Flop
Seat 5: soundfsilenz (button) collected ($10751)
Seat 6: slotmachine (small blind) folded before Flop

PokerStars Hand #1922877868: Omaha Pot Limit ($200/$400 USD) - 2020/10/23 13:47:19 ET
Table 'ADA179504417' 6-max Seat #6 is the button
Seat 1: ag2703 ($81587 in chips)
Seat 2: MadMonkey ($13857 in chips)
Seat 3: kimjongun ($73523 in chips)
Seat 4: TurnOnTuneInDropOut ($28600 in chips)
Seat 5: soundfsilenz ($49898 in chips)
Seat 6: slotmachine ($72176 in chips)
ag2703: posts small blind $200
MadMonkey: posts big blind $400
*** HOLE CARDS ***
Dealt to TurnOnTuneInDropOut [8h 3d Ac 2h]
kimjongun: raises $600 to $1000
TurnOnTuneInDropOut: folds
soundfsilenz: folds
slotmachine: calls $1000
ag2703: calls $800
MadMonkey: calls $600
*** FLOP *** [Td Jh 6s]
ag2703: checks
MadMonkey: bets $400
kimjongun: calls $400
slotmachine: calls $400
ag2703: raises $5600 to $6000
MadMonkey: folds
kimjongun: folds
slotmachine: folds
Uncalled bet ($5600) returned to ag2703
ag2703: shows [Js 5s 5c Ah]
ag2703 collected $5375 from pot
*** SUMMARY ***
Total pot $5600 | Rake $225
Board [Td Jh 6s]
Seat 1: ag2703 (small blind) collected ($5375)
Seat 2: MadMonkey (big blind) folded on the Flop
Seat 3: kimjongun folded on the Flop
Seat 4: TurnOnTuneInDropOut folded before Flop (didn't bet)
Seat 5: soundfsilenz folded before Flop (didn't bet)
Seat 6: slotmachine (button) folded on the Flop

PokerStars Hand #1922877869: Omaha Pot Limit ($200/$400 USD) - 2020/10/23 13:48:54 ET
Table 'ADA179504417' 6-max Seat #1 is the button
Seat 1: ag2703 ($85562 in chips)
Seat 2: MadMonkey ($12457 in chips)
Seat 3: kimjongun ($72123 in chips)
Seat 4: TurnOnTuneInDropOut ($28600 in chips)
Seat 5: soundfsilenz ($49898 in chips)
Seat 6: slotmachine ($70776 in chips)
MadMonkey: posts small blind $200
kimjongun: posts big blind $400
*** HOLE CARDS ***
Dealt to TurnOnTuneInDropOut [Ac 5h 6d 8c]
TurnOnTuneInDropOut: folds
soundfsilenz: raises $1000 to $1400
slotmachine: folds
ag2703: folds
MadMonkey: calls $1200
kimjongun: calls $1000
*** FLOP *** [9c 5d Kh]
MadMonkey: bets $4200
kimjongun: folds
soundfsilenz: raises $8568 to $12768
MadMonkey: calls $6857 and is all-in
Uncalled bet ($1711) returned to soundfsilenz
*** TURN *** [9c 5d Kh] [Ad]
*** RIVER *** [9c 5d Kh Ad] [Jd]
*** SHOW DOWN ***
MadMonkey: shows [9h Qc 9s 3h]
soundfsilenz: shows [Ks Th Jh Ts]
MadMonkey collected $25514 from pot
*** SUMMARY ***
Total pot $26314 | Rake $800
Board [9c 5d Kh Ad Jd]
Seat 1: ag2703 (button) folded before Flop (didn't bet)
Seat 2: MadMonkey (small blind) showed [9h Qc 9s 3h] and won ($25514)
Seat 3: kimjongun (big blind) folded on the Flop
Seat 4: TurnOnTuneInDropOut folded before Flop (didn't bet)
Seat 5: soundfsilenz showed [Ks Th Jh Ts] and lost
Seat 6: slotmachine folded before Flop (didn't bet)

PokerStars Hand #1922877870: Omaha Pot Limit ($200/$400 USD) - 2020/10/23 13:49:50 ET
Table 'ADA179504417' 6-max Seat #2 is the button
Seat 1: ag2703 ($85562 in chips)
Seat 2: MadMonkey ($25514 in chips)
Seat 3: kimjongun ($70723 in chips)
Seat 4: TurnOnTuneInDropOut ($28600 in chips)
Seat 5: soundfsilenz ($37441 in chips)
Seat 6: slotmachine ($70776 in chips)
kimjongun: posts small blind $200
TurnOnTuneInDropOut: posts big blind $400
*** HOLE CARDS ***
Dealt to TurnOnTuneInDropOut [9c Ad Qd 7d]
soundfsilenz: raises $1000 to $1400
slotmachine: folds
ag2703: folds
MadMonkey: folds
kimjongun: folds
TurnOnTuneInDropOut: folds
Uncalled bet ($1000) returned to soundfsilenz
soundfsilenz collected $1000 from pot
soundfsilenz: doesn't show hand
*** SUMMARY ***
Total pot $1000 | Rake $0
Seat 1: ag2703 folded before Flop (didn't bet)
Seat 2: MadMonkey (button) folded before Flop (didn't bet)
Seat 3: kimjongun (small blind) folded before Flop
Seat 4: TurnOnTuneInDropOut (big blind) folded before Flop
Seat 5: soundfsilenz collected ($1000)
Seat 6: slotmachine folded before Flop (didn't bet)

PokerStars Hand #1922877873: Omaha Pot Limit ($200/$400 USD) - 2020/10/23 13:52:01 ET
Table 'ADA179504417' 6-max Seat #5 is the button
Seat 1: ag2703 ($83272 in chips)
Seat 2: MadMonkey ($25514 in chips)
Seat 3: kimjongun ($73720 in chips)
Seat 4: TurnOnTuneInDropOut ($28000 in chips)
Seat 5: soundfsilenz ($37441 in chips)
Seat 6: slotmachine ($70376 in chips)
slotmachine: posts small blind $200
ag2703: posts big blind $400
*** HOLE CARDS ***
Dealt to TurnOnTuneInDropOut [Th 3d Jc Td]
MadMonkey: folds
kimjongun: folds
TurnOnTuneInDropOut: folds
soundfsilenz: folds
slotmachine: folds
Uncalled bet ($200) returned to ag2703
ag2703 collected $400 from pot
ag2703: doesn't show hand
*** SUMMARY ***
Total pot $400 | Rake $0
Seat 1: ag2703 (big blind) collected ($400)
Seat 2: MadMonkey folded before Flop (didn't bet)
Seat 3: kimjongun folded before Flop (didn't bet)
Seat 4: TurnOnTuneInDropOut folded before Flop (didn't bet)
Seat 5: soundfsilenz (button) folded before Flop (didn't bet)
Seat 6: slotmachine (small blind) folded before Flop

PokerStars Hand #1922877874: Omaha Pot Limit ($200/$400 USD) - 2020/10/23 13:52:27 ET
Table 'ADA179504417' 6-max Seat #6 is the button
Seat 1: ag2703 ($83472 in chips)
Seat 2: MadMonkey ($25514 in chips)
Seat 3: kimjongun ($73720 in chips)
Seat 4: TurnOnTuneInDropOut ($28000 in chips)
Seat 5: soundfsilenz ($37441 in chips)
Seat 6: slotmachine ($70176 in chips)
ag2703: posts small blind $200
MadMonkey: posts big blind $400
*** HOLE CARDS ***
Dealt to TurnOnTuneInDropOut [Qs Jd Th 5d]
kimjongun: folds
TurnOnTuneInDropOut: folds
soundfsilenz: raises $1000 to $1400
slotmachine: folds
ag2703: folds
MadMonkey: folds
Uncalled bet ($1000) returned to soundfsilenz
soundfsilenz collected $1000 from pot
soundfsilenz: doesn't show hand
*** SUMMARY ***
Total pot $1000 | Rake $0
Seat 1: ag2703 (small blind) folded before Flop
Seat 2: MadMonkey (big blind) folded before Flop
Seat 3: kimjongun folded before Flop (didn't bet)
Seat 4: TurnOnTuneInDropOut folded before Flop (didn't bet)
Seat 5: soundfsilenz collected ($1000)
Seat 6: slotmachine (button) folded before Flop (didn't bet)

PokerStars Hand #1922877875: Omaha Pot Limit ($200/$400 USD) - 2020/10/23 13:53:01 ET
Table 'ADA179504417' 6-max Seat #1 is the button
Seat 1: ag2703 ($83272 in chips)
Seat 2: MadMonkey ($25114 in chips)
Seat 3: kimjongun ($73720 in chips)
Seat 4: TurnOnTuneInDropOut ($28000 in chips)
Seat 5: soundfsilenz ($38041 in chips)
Seat 6: slotmachine ($70176 in chips)
MadMonkey: posts small blind $200
kimjongun: posts big blind $400
*** HOLE CARDS ***
Dealt to TurnOnTuneInDropOut [Jh 4h Ah 3s]
TurnOnTuneInDropOut: folds
soundfsilenz: folds
slotmachine: folds
ag2703: calls $400
MadMonkey: calls $200
kimjongun: checks
*** FLOP *** [9d 8s 4c]
MadMonkey: bets $400
kimjongun: folds
ag2703: calls $400
*** TURN *** [9d 8s 4c] [3d]
MadMonkey: checks
ag2703: checks
*** RIVER *** [9d 8s 4c 3d] [Kc]
MadMonkey: checks
ag2703: bets $2000
MadMonkey: folds
Uncalled bet ($2000) returned to ag2703
ag2703 collected $1920 from pot
ag2703: doesn't show hand
*** SUMMARY ***
Total pot $2000 | Rake $80
Board [9d 8s 4c 3d Kc]
Seat 1: ag2703 (button) collected ($1920)
Seat 2: MadMonkey (small blind) folded on the River
Seat 3: kimjongun (big blind) folded on the Flop
Seat 4: TurnOnTuneInDropOut folded before Flop (didn't bet)
Seat 5: soundfsilenz folded before Flop (didn't bet)
Seat 6: slotmachine folded before Flop (didn't bet)

PokerStars Hand #1922877876: Omaha Pot Limit ($200/$400 USD) - 2020/10/23 13:54:15 ET
Table 'ADA179504417' 6-max Seat #2 is the button
Seat 1: ag2703 ($84392 in chips)
Seat 2: MadMonkey ($24314 in chips)
Seat 3: kimjongun ($73320 in chips)
Seat 4: TurnOnTuneInDropOut ($28000 in chips)
Seat 5: soundfsilenz ($38041 in chips)
Seat 6: slotmachine ($70176 in chips)
kimjongun: posts small blind $200
TurnOnTuneInDropOut: posts big blind $400
*** HOLE CARDS ***
Dealt to TurnOnTuneInDropOut [6c Td Ac 8h]
soundfsilenz: raises $1000 to $1400
slotmachine: folds
ag2703: folds
MadMonkey: folds
kimjongun: folds
TurnOnTuneInDropOut: calls $1000
*** FLOP *** [5d Qs Ks]
TurnOnTuneInDropOut: checks
soundfsilenz: bets $2010
TurnOnTuneInDropOut: folds
Uncalled bet ($2010) returned to soundfsilenz
soundfsilenz collected $2880 from pot
soundfsilenz: doesn't show hand
*** SUMMARY ***
Total pot $3000 | Rake $120
Board [5d Qs Ks]
Seat 1: ag2703 folded before Flop (didn't bet)
Seat 2: MadMonkey (button) folded before Flop (didn't bet)
Seat 3: kimjongun (small blind) folded before Flop
Seat 4: TurnOnTuneInDropOut (big blind) folded on the Flop
Seat 5: soundfsilenz collected ($2880)
Seat 6: slotmachine folded before Flop (didn't bet)

PokerStars Hand #1922877877: Omaha Pot Limit ($200/$400 USD) - 2020/10/23 13:55:04 ET
Table 'ADA179504417' 6-max Seat #3 is the button
Seat 1: ag2703 ($84392 in chips)
Seat 2: MadMonkey ($24314 in chips)
Seat 3: kimjongun ($73120 in chips)
Seat 4: TurnOnTuneInDropOut ($26600 in chips)
Seat 5: soundfsilenz ($39521 in chips)
Seat 6: slotmachine ($70176 in chips)
TurnOnTuneInDropOut: posts small blind $200
soundfsilenz: posts big blind $400
*** HOLE CARDS ***
Dealt to TurnOnTuneInDropOut [4c 7c Jh 3h]
slotmachine: folds
ag2703: folds
MadMonkey: folds
kimjongun: folds
TurnOnTuneInDropOut: folds
Uncalled bet ($200) returned to soundfsilenz
soundfsilenz collected $400 from pot
soundfsilenz: doesn't show hand
*** SUMMARY ***
Total pot $400 | Rake $0
Seat 1: ag2703 folded before Flop (didn't bet)
Seat 2: MadMonkey folded before Flop (didn't bet)
Seat 3: kimjongun (button) folded before Flop (didn't bet)
Seat 4: TurnOnTuneInDropOut (small blind) folded before Flop
Seat 5: soundfsilenz (big blind) collected ($400)
Seat 6: slotmachine folded before Flop (didn't bet)

PokerStars Hand #1922877879: Omaha Pot Limit ($200/$400 USD) - 2020/10/23 13:56:30 ET
Table 'ADA179504417' 6-max Seat #5 is the button
Seat 1: ag2703 ($82592 in chips)
Seat 2: MadMonkey ($24314 in chips)
Seat 3: kimjongun ($73120 in chips)
Seat 4: TurnOnTuneInDropOut ($28632 in chips)
Seat 5: soundfsilenz ($39521 in chips)
Seat 6: slotmachine ($69776 in chips)
slotmachine: posts small blind $200
ag2703: posts big blind $400
*** HOLE CARDS ***
Dealt to TurnOnTuneInDropOut [7h 3d Ts Jh]
MadMonkey: folds
kimjongun: folds
TurnOnTuneInDropOut: folds
soundfsilenz: folds
slotmachine: folds
Uncalled bet ($200) returned to ag2703
ag2703 collected $400 from pot
ag2703: doesn't show hand
*** SUMMARY ***
Total pot $400 | Rake $0
Seat 1: ag2703 (big blind) collected ($400)
Seat 2: MadMonkey folded before Flop (didn't bet)
Seat 3: kimjongun folded before Flop (didn't bet)
Seat 4: TurnOnTuneInDropOut folded before Flop (didn't bet)
Seat 5: soundfsilenz (button) folded before Flop (didn't bet)
Seat 6: slotmachine (small blind) folded before Flop

PokerStars Hand #1922877880: Omaha Pot Limit ($200/$400 USD) - 2020/10/23 13:56:56 ET
Table 'ADA179504417' 6-max Seat #6 is the button
Seat 1: ag2703 ($82792 in chips)
Seat 2: MadMonkey ($24314 in chips)
Seat 3: kimjongun ($73120 in chips)
Seat 4: TurnOnTuneInDropOut ($28632 in chips)
Seat 5: soundfsilenz ($39521 in chips)
Seat 6: slotmachine ($69576 in chips)
ag2703: posts small blind $200
MadMonkey: posts big blind $400
*** HOLE CARDS ***
Dealt to TurnOnTuneInDropOut [Ts As 6d 4d]
kimjongun: folds
TurnOnTuneInDropOut: raises $1000 to $1400
soundfsilenz: folds
slotmachine: folds
ag2703: calls $1200
MadMonkey: folds
*** FLOP *** [Kd Jh 7d]
ag2703: checks
TurnOnTuneInDropOut: checks
*** TURN *** [Kd Jh 7d] [4c]
ag2703: checks
TurnOnTuneInDropOut: checks
*** RIVER *** [Kd Jh 7d 4c] [5h]
ag2703: bets $3200
TurnOnTuneInDropOut: folds
Uncalled bet ($3200) returned to ag2703
ag2703: shows [6h Th Td Kc]
ag2703 collected $3072 from pot
*** SUMMARY ***
Total pot $3200 | Rake $128
Board [Kd Jh 7d 4c 5h]
Seat 1: ag2703 (small blind) collected ($3072)
Seat 2: MadMonkey (big blind) folded before Flop
Seat 3: kimjongun folded before Flop (didn't bet)
Seat 4: TurnOnTuneInDropOut folded on the River
Seat 5: soundfsilenz folded before Flop (didn't bet)
Seat 6: slotmachine (button) folded before Flop (didn't bet)

PokerStars Hand #1922877881: Omaha Pot Limit ($200/$400 USD) - 2020/10/23 13:58:19 ET
Table 'ADA179504417' 6-max Seat #1 is the button
Seat 1: ag2703 ($84464 in chips)
Seat 2: MadMonkey ($23914 in chips)
Seat 3: kimjongun ($73120 in chips)
Seat 4: TurnOnTuneInDropOut ($27232 in chips)
Seat 5: soundfsilenz ($39521 in chips)
Seat 6: slotmachine ($69576 in chips)
MadMonkey: posts small blind $200
kimjongun: posts big blind $400
*** HOLE CARDS ***
Dealt to TurnOnTuneInDropOut [6h Jh 2s As]
TurnOnTuneInDropOut: folds
soundfsilenz: folds
slotmachine: folds
ag2703: raises $1000 to $1400
MadMonkey: calls $1200
kimjongun: calls $1000
*** FLOP *** [6d 4s Js]
MadMonkey: bets $2100
kimjongun: calls $2100
ag2703: raises $10500 to $12600
MadMonkey: folds
kimjongun: folds
Uncalled bet ($10500) returned to ag2703
ag2703 collected $10079 from pot
ag2703: doesn't show hand
*** SUMMARY ***
Total pot $10500 | Rake $421
Board [6d 4s Js]
Seat 1: ag2703 (button) collected ($10079)
Seat 2: MadMonkey (small blind) folded on the Flop
Seat 3: kimjongun (big blind) folded on the Flop
Seat 4: TurnOnTuneInDropOut folded before Flop (didn't bet)
Seat 5: soundfsilenz folded before Flop (didn't bet)
Seat 6: slotmachine folded before Flop (didn't bet)

PokerStars Hand #1922877885: Omaha Pot Limit ($200/$400 USD) - 2020/10/23 14:02:09 ET
Table 'ADA179504417' 6-max Seat #5 is the button
Seat 1: ag2703 ($89803 in chips)
Seat 2: MadMonkey ($20414 in chips)
Seat 3: kimjongun ($71652 in chips)
Seat 4: TurnOnTuneInDropOut ($27232 in chips)
Seat 5: soundfsilenz ($38921 in chips)
Seat 6: slotmachine ($69176 in chips)
slotmachine: posts small blind $200
ag2703: posts big blind $400
*** HOLE CARDS ***
Dealt to TurnOnTuneInDropOut [3h Js 9h 3c]
MadMonkey: raises $400 to $800
kimjongun: raises $2200 to $3000
TurnOnTuneInDropOut: folds
soundfsilenz: folds
slotmachine: folds
ag2703: calls $2600
MadMonkey: calls $2200
*** FLOP *** [Jd 6d 6s]
ag2703: checks
MadMonkey: checks
kimjongun: bets $3220
ag2703: calls $3220
MadMonkey: folds
*** TURN *** [Jd 6d 6s] [Qs]
ag2703: checks
kimjongun: checks
*** RIVER *** [Jd 6d 6s Qs] [8s]
ag2703: checks
kimjongun: checks
*** SHOW DOWN ***
ag2703: shows [7d 7c Ad 4c]
kimjongun: mucks hand
ag2703 collected $15013 from pot
*** SUMMARY ***
Total pot $15640 | Rake $627
Board [Jd 6d 6s Qs 8s]
Seat 1: ag2703 (big blind) showed [7d 7c Ad 4c] and won ($15013)
Seat 2: MadMonkey folded on the Flop
Seat 3: kimjongun mucked
Seat 4: TurnOnTuneInDropOut folded before Flop (didn't bet)
Seat 5: soundfsilenz (button) folded before Flop (didn't bet)
Seat 6: slotmachine (small blind) folded before Flop

PokerStars Hand #1922877886: Omaha Pot Limit ($200/$400 USD) - 2020/10/23 14:02:55 ET
Table 'ADA179504417' 6-max Seat #6 is the button
Seat 1: ag2703 ($98596 in chips)
Seat 2: MadMonkey ($17414 in chips)
Seat 3: kimjongun ($65432 in chips)
Seat 4: TurnOnTuneInDropOut ($27232 in chips)
Seat 5: soundfsilenz ($38921 in chips)
Seat 6: slotmachine ($68976 in chips)
ag2703: posts small blind $200
MadMonkey: posts big blind $400
*** HOLE CARDS ***
Dealt to TurnOnTuneInDropOut [Ts 6d Ad Th]
kimjongun: folds
TurnOnTuneInDropOut: raises $1000 to $1400
soundfsilenz: folds
slotmachine: calls $1400
ag2703: calls $1200
MadMonkey: folds
*** FLOP *** [Tc 4h 9s]
ag2703: checks
TurnOnTuneInDropOut: bets $4050
slotmachine: folds
ag2703: folds
Uncalled bet ($4050) returned to TurnOnTuneInDropOut
TurnOnTuneInDropOut collected $4416 from pot
TurnOnTuneInDropOut: doesn't show hand
*** SUMMARY ***
Total pot $4600 | Rake $184
Board [Tc 4h 9s]
Seat 1: ag2703 (small blind) folded on the Flop
Seat 2: MadMonkey (big blind) folded before Flop
Seat 3: kimjongun folded before Flop (didn't bet)
Seat 4: TurnOnTuneInDropOut collected ($4416)
Seat 5: soundfsilenz folded before Flop (didn't bet)
Seat 6: slotmachine (button) folded on the Flop

PokerStars Hand #1922877887: Omaha Pot Limit ($200/$400 USD) - 2020/10/23 14:03:44 ET
Table 'ADA179504417' 6-max Seat #1 is the button
Seat 1: ag2703 ($97196 in chips)
Seat 2: MadMonkey ($17014 in chips)
Seat 3: kimjongun ($65432 in chips)
Seat 4: TurnOnTuneInDropOut ($30248 in chips)
Seat 5: soundfsilenz ($38921 in chips)
Seat 6: slotmachine ($67576 in chips)
MadMonkey: posts small blind $200
kimjongun: posts big blind $400
*** HOLE CARDS ***
Dealt to TurnOnTuneInDropOut [5d 4d 9h 9c]
TurnOnTuneInDropOut: folds
soundfsilenz: folds
slotmachine: raises $1000 to $1400
ag2703: calls $1400
MadMonkey: folds
kimjongun: raises $4400 to $5800
slotmachine: calls $4400
ag2703: calls $4400
*** FLOP *** [Kc Th 7c]
kimjongun: checks
slotmachine: bets $11616
ag2703: calls $11616
kimjongun: folds
*** TURN *** [Kc Th 7c] [5s]
slotmachine: bets $33424
ag2703: folds
Uncalled bet ($33424) returned to slotmachine
slotmachine collected $40032 from pot
slotmachine: doesn't show hand
*** SUMMARY ***
Total pot $40832 | Rake $800
Board [Kc Th 7c 5s]
Seat 1: ag2703 (button) folded on the Turn
Seat 2: MadMonkey (small blind) folded before Flop
Seat 3: kimjongun (big blind) folded on the Flop
Seat 4: TurnOnTuneInDropOut folded before Flop (didn't bet)
Seat 5: soundfsilenz folded before Flop (didn't bet)
Seat 6: slotmachine collected ($40032)

PokerStars Hand #1922877894: Omaha Pot Limit ($200/$400 USD) - 2020/10/23 14:11:04 ET
Table 'ADA179504417' 6-max Seat #3 is the button
Seat 1: ag2703 ($78190 in chips)
Seat 2: MadMonkey ($16774 in chips)
Seat 3: kimjongun ($63801 in chips)
Seat 4: TurnOnTuneInDropOut ($29848 in chips)
Seat 5: soundfsilenz ($37521 in chips)
Seat 6: slotmachine ($88800 in chips)
TurnOnTuneInDropOut: posts small blind $200
soundfsilenz: posts big blind $400
*** HOLE CARDS ***
Dealt to TurnOnTuneInDropOut [9d 9h 9s Ad]
slotmachine: raises $1000 to $1400
ag2703: folds
MadMonkey: calls $1400
kimjongun: calls $1400
TurnOnTuneInDropOut: folds
soundfsilenz: folds
*** FLOP *** [8c 2c Js]
slotmachine: checks
MadMonkey: checks
kimjongun: bets $2400
slotmachine: folds
MadMonkey: folds
Uncalled bet ($2400) returned to kimjongun
kimjongun collected $4608 from pot
kimjongun: doesn't show hand
*** SUMMARY ***
Total pot $4800 | Rake $192
Board [8c 2c Js]
Seat 1: ag2703 folded before Flop (didn't bet)
Seat 2: MadMonkey folded on the Flop
Seat 3: kimjongun (button) collected ($4608)
Seat 4: TurnOnTuneInDropOut (small blind) folded before Flop
Seat 5: soundfsilenz (big blind) folded before Flop
Seat 6: slotmachine folded on the Flop

PokerStars Hand #1922877896: Omaha Pot Limit ($200/$400 USD) - 2020/10/23 14:13:26 ET
Table 'ADA179504417' 6-max Seat #5 is the button
Seat 1: ag2703 ($72190 in chips)
Seat 2: MadMonkey ($21469 in chips)
Seat 3: kimjongun ($67009 in chips)
Seat 4: TurnOnTuneInDropOut ($29648 in chips)
Seat 5: soundfsilenz ($36921 in chips)
Seat 6: slotmachine ($87000 in chips)
slotmachine: posts small blind $200
ag2703: posts big blind $400
*** HOLE CARDS ***
Dealt to TurnOnTuneInDropOut [Kh 4s 3c As]
MadMonkey: folds
kimjongun: folds
TurnOnTuneInDropOut: raises $1000 to $1400
soundfsilenz: calls $1400
slotmachine: folds
ag2703: calls $1000
*** FLOP *** [9h Ad Qh]
ag2703: checks
TurnOnTuneInDropOut: bets $2904
soundfsilenz: calls $2904
ag2703: calls $2904
*** TURN *** [9h Ad Qh] [Jd]
ag2703: checks
TurnOnTuneInDropOut: checks
soundfsilenz: checks
*** RIVER *** [9h Ad Qh Jd] [7s]
ag2703: checks
TurnOnTuneInDropOut: checks
soundfsilenz: checks
*** SHOW DOWN ***
ag2703: shows [Ac 5d Qd 5s]
soundfsilenz: mucks hand
ag2703 collected $12586 from pot
*** SUMMARY ***
Total pot $13112 | Rake $526
Board [9h Ad Qh Jd 7s]
Seat 1: ag2703 (big blind) showed [Ac 5d Qd 5s] and won ($12586)
Seat 2: MadMonkey folded before Flop (didn't bet)
Seat 3: kimjongun folded before Flop (didn't bet)
Seat 4: TurnOnTuneInDropOut
Seat 5: soundfsilenz (button) mucked
Seat 6: slotmachine (small blind) folded before Flop

PokerStars Hand #1922877897: Omaha Pot Limit ($200/$400 USD) - 2020/10/23 14:15:12 ET
Table 'ADA179504417' 6-max Seat #6 is the button
Seat 1: ag2703 ($80472 in chips)
Seat 2: MadMonkey ($21469 in chips)
Seat 3: kimjongun ($67009 in chips)
Seat 4: TurnOnTuneInDropOut ($25344 in chips)
Seat 5: soundfsilenz ($32617 in chips)
Seat 6: slotmachine ($86800 in chips)
ag2703: posts small blind $200
MadMonkey: posts big blind $400
*** HOLE CARDS ***
Dealt to TurnOnTuneInDropOut [4d 7s 4h Jd]
kimjongun: folds
TurnOnTuneInDropOut: folds
soundfsilenz: raises $1000 to $1400
slotmachine: folds
ag2703: folds
MadMonkey: folds
Uncalled bet ($1000) returned to soundfsilenz
soundfsilenz collected $1000 from pot
soundfsilenz: doesn't show hand
*** SUMMARY ***
Total pot $1000 | Rake $0
Seat 1: ag2703 (small blind) folded before Flop
Seat 2: MadMonkey (big blind) folded before Flop
Seat 3: kimjongun folded before Flop (didn't bet)
Seat 4: TurnOnTuneInDropOut folded before Flop (didn't bet)
Seat 5: soundfsilenz collected ($1000)
Seat 6: slotmachine (button) folded before Flop (didn't bet)

PokerStars Hand #1922877898: Omaha Pot Limit ($200/$400 USD) - 2020/10/23 14:15:58 ET
Table 'ADA179504417' 6-max Seat #1 is the button
Seat 1: ag2703 ($80272 in chips)
Seat 2: MadMonkey ($21069 in chips)
Seat 3: kimjongun ($67009 in chips)
Seat 4: TurnOnTuneInDropOut ($48000 in chips)
Seat 5: soundfsilenz ($33217 in chips)
Seat 6: slotmachine ($86800 in chips)
MadMonkey: posts small blind $200
kimjongun: posts big blind $400
*** HOLE CARDS ***
Dealt to TurnOnTuneInDropOut [Kc Qc Jh Qh]
TurnOnTuneInDropOut: raises $1000 to $1400
soundfsilenz: folds
slotmachine: calls $1400
ag2703: folds
MadMonkey: folds
kimjongun: folds
*** FLOP *** [9h Kd 7h]
TurnOnTuneInDropOut: checks
slotmachine: bets $3400
TurnOnTuneInDropOut: calls $3400
*** TURN *** [9h Kd 7h] [Js]
TurnOnTuneInDropOut: checks
slotmachine: bets $5100
TurnOnTuneInDropOut: raises $13425 to $18525
slotmachine: calls $13425
*** RIVER *** [9h Kd 7h Js] [7d]
TurnOnTuneInDropOut: checks
slotmachine: bets $35438
TurnOnTuneInDropOut: folds
Uncalled bet ($35438) returned to slotmachine
slotmachine collected $46450 from pot
slotmachine: doesn't show hand
*** SUMMARY ***
Total pot $47250 | Rake $800
Board [9h Kd 7h Js 7d]
Seat 1: ag2703 (button) folded before Flop (didn't bet)
Seat 2: MadMonkey (small blind) folded before Flop
Seat 3: kimjongun (big blind) folded before Flop
Seat 4: TurnOnTuneInDropOut folded on the River
Seat 5: soundfsilenz folded before Flop (didn't bet)
Seat 6: slotmachine collected ($46450)

PokerStars Hand #1922877904: Omaha Pot Limit ($200/$400 USD) - 2020/10/23 14:23:44 ET
Table 'ADA179504417' 6-max Seat #2 is the button
Seat 1: ag2703 ($74572 in chips)
Seat 2: MadMonkey ($25040 in chips)
Seat 3: kimjongun ($66009 in chips)
Seat 4: TurnOnTuneInDropOut ($48000 in chips)
Seat 5: soundfsilenz ($35376 in chips)
Seat 6: slotmachine ($109325 in chips)
kimjongun: posts small blind $200
TurnOnTuneInDropOut: posts big blind $400
*** HOLE CARDS ***
Dealt to TurnOnTuneInDropOut [5h Tc As Js]
soundfsilenz: folds
slotmachine: raises $1000 to $1400
ag2703: folds
MadMonkey: calls $1400
kimjongun: folds
TurnOnTuneInDropOut: calls $1000
*** FLOP *** [3s 6c Qc]
TurnOnTuneInDropOut: checks
slotmachine: checks
MadMonkey: checks
*** TURN *** [3s 6c Qc] [2c]
TurnOnTuneInDropOut: checks
slotmachine: checks
MadMonkey: checks
*** RIVER *** [3s 6c Qc 2c] [Kc]
TurnOnTuneInDropOut: checks
slotmachine: checks
MadMonkey: checks
*** SHOW DOWN ***
slotmachine: mucks hand
MadMonkey: shows [Ks 7c 7d Kd]
MadMonkey collected $4224 from pot
*** SUMMARY ***
Total pot $4400 | Rake $176
Board [3s 6c Qc 2c Kc]
Seat 1: ag2703 folded before Flop (didn't bet)
Seat 2: MadMonkey (button) showed [Ks 7c 7d Kd] and won ($4224)
Seat 3: kimjongun (small blind) folded before Flop
Seat 4: TurnOnTuneInDropOut (big blind)
Seat 5: soundfsilenz folded before Flop (didn't bet)
Seat 6: slotmachine mucked

PokerStars Hand #1922877906: Omaha Pot Limit ($200/$400 USD) - 2020/10/23 14:26:23 ET
Table 'ADA179504417' 6-max Seat #4 is the button
Seat 1: ag2703 ($75132 in chips)
Seat 3: kimjongun ($65809 in chips)
Seat 4: TurnOnTuneInDropOut ($46400 in chips)
Seat 5: soundfsilenz ($34976 in chips)
Seat 6: slotmachine ($107925 in chips)
soundfsilenz: posts small blind $200
slotmachine: posts big blind $400
*** HOLE CARDS ***
Dealt to TurnOnTuneInDropOut [9s 9c Th Tc]
ag2703: raises $400 to $800
kimjongun: folds
TurnOnTuneInDropOut: raises $2200 to $3000
soundfsilenz: folds
slotmachine: folds
ag2703: calls $2200
*** FLOP *** [7h 2s Kh]
ag2703: checks
TurnOnTuneInDropOut: bets $3300
ag2703: calls $3300
*** TURN *** [7h 2s Kh] [Td]
ag2703: checks
TurnOnTuneInDropOut: bets $13200
ag2703: folds
Uncalled bet ($13200) returned to TurnOnTuneInDropOut
TurnOnTuneInDropOut collected $12671 from pot
TurnOnTuneInDropOut: doesn't show hand
*** SUMMARY ***
Total pot $13200 | Rake $529
Board [7h 2s Kh Td]
Seat 1: ag2703 folded on the Turn
Seat 3: kimjongun folded before Flop (didn't bet)
Seat 4: TurnOnTuneInDropOut (button) collected ($12671)
Seat 5: soundfsilenz (small blind) folded before Flop
Seat 6: slotmachine (big blind) folded before Flop

PokerStars Hand #1922877907: Omaha Pot Limit ($200/$400 USD) - 2020/10/23 14:27:24 ET
Table 'ADA179504417' 6-max Seat #5 is the button
Seat 1: ag2703 ($68832 in chips)
Seat 4: TurnOnTuneInDropOut ($52771 in chips)
Seat 5: soundfsilenz ($34776 in chips)
Seat 6: slotmachine ($107525 in chips)
slotmachine: posts small blind $200
ag2703: posts big blind $400
*** HOLE CARDS ***
Dealt to TurnOnTuneInDropOut [8c 4d 8s Tc]
TurnOnTuneInDropOut: folds
soundfsilenz: folds
slotmachine: raises $800 to $1200
ag2703: calls $800
*** FLOP *** [8d 6c 7h]
slotmachine: checks
ag2703: bets $2400
slotmachine: folds
Uncalled bet ($2400) returned to ag2703
ag2703 collected $2304 from pot
ag2703: doesn't show hand
*** SUMMARY ***
Total pot $2400 | Rake $96
Board [8d 6c 7h]
Seat 1: ag2703 (big blind) collected ($2304)
Seat 4: TurnOnTuneInDropOut folded before Flop (didn't bet)
Seat 5: soundfsilenz (button) folded before Flop (didn't bet)
Seat 6: slotmachine (small blind) folded on the Flop

PokerStars Hand #1922877908: Omaha Pot Limit ($200/$400 USD) - 2020/10/23 14:28:02 ET
Table 'ADA179504417' 6-max Seat #6 is the button
Seat 1: ag2703 ($69936 in chips)
Seat 2: CarlJung ($12000 in chips)
Seat 4: TurnOnTuneInDropOut ($52771 in chips)
Seat 5: soundfsilenz ($34776 in chips)
Seat 6: slotmachine ($106325 in chips)
ag2703: posts small blind $200
CarlJung: posts big blind $400
*** HOLE CARDS ***
Dealt to TurnOnTuneInDropOut [8h 9c 3c 3s]
TurnOnTuneInDropOut: folds
soundfsilenz: folds
slotmachine: raises $1000 to $1400
ag2703: folds
CarlJung: calls $1000
*** FLOP *** [8d 6h 9s]
CarlJung: checks
slotmachine: bets $1980
CarlJung: folds
Uncalled bet ($1980) returned to slotmachine
slotmachine collected $2880 from pot
slotmachine: doesn't show hand
*** SUMMARY ***
Total pot $3000 | Rake $120
Board [8d 6h 9s]
Seat 1: ag2703 (small blind) folded before Flop
Seat 2: CarlJung (big blind) folded on the Flop
Seat 4: TurnOnTuneInDropOut folded before Flop (didn't bet)
Seat 5: soundfsilenz folded before Flop (didn't bet)
Seat 6: slotmachine (button) collected ($2880)

PokerStars Hand #1922877909: Omaha Pot Limit ($200/$400 USD) - 2020/10/23 14:28:45 ET
Table 'ADA179504417' 6-max Seat #1 is the button
Seat 1: ag2703 ($69736 in chips)
Seat 2: CarlJung ($10600 in chips)
Seat 3: kimjongun ($65809 in chips)
Seat 4: TurnOnTuneInDropOut ($52771 in chips)
Seat 5: soundfsilenz ($34776 in chips)
Seat 6: slotmachine ($107805 in chips)
CarlJung: posts small blind $200
kimjongun: posts big blind $400
*** HOLE CARDS ***
Dealt to TurnOnTuneInDropOut [As 9s Kh Ah]
TurnOnTuneInDropOut: raises $1000 to $1400
soundfsilenz: folds
slotmachine: folds
ag2703: calls $1400
CarlJung: folds
kimjongun: folds
*** FLOP *** [Jc Ad 3h]
TurnOnTuneInDropOut: bets $2550
ag2703: folds
Uncalled bet ($2550) returned to TurnOnTuneInDropOut
TurnOnTuneInDropOut collected $3264 from pot
TurnOnTuneInDropOut: doesn't show hand
*** SUMMARY ***
Total pot $3400 | Rake $136
Board [Jc Ad 3h]
Seat 1: ag2703 (button) folded on the Flop
Seat 2: CarlJung (small blind) folded before Flop
Seat 3: kimjongun (big blind) folded before Flop
Seat 4: TurnOnTuneInDropOut collected ($3264)
Seat 5: soundfsilenz folded before Flop (didn't bet)
Seat 6: slotmachine folded before Flop (didn't bet)

PokerStars Hand #1922877910: Omaha Pot Limit ($200/$400 USD) - 2020/10/23 14:29:30 ET
Table 'ADA179504417' 6-max Seat #2 is the button
Seat 1: ag2703 ($68336 in chips)
Seat 2: CarlJung ($10400 in chips)
Seat 3: kimjongun ($65409 in chips)
Seat 4: TurnOnTuneInDropOut ($54635 in chips)
Seat 5: soundfsilenz ($34776 in chips)
Seat 6: slotmachine ($107805 in chips)
kimjongun: posts small blind $200
TurnOnTuneInDropOut: posts big blind $400
*** HOLE CARDS ***
Dealt to TurnOnTuneInDropOut [2d Ts 9h Td]
soundfsilenz: folds
slotmachine: raises $1000 to $1400
ag2703: folds
CarlJung: folds
kimjongun: folds
TurnOnTuneInDropOut: folds
Uncalled bet ($1000) returned to slotmachine
slotmachine collected $1000 from pot
slotmachine: doesn't show hand
*** SUMMARY ***
Total pot $1000 | Rake $0
Seat 1: ag2703 folded before Flop (didn't bet)
Seat 2: CarlJung (button) folded before Flop (didn't bet)
Seat 3: kimjongun (small blind) folded before Flop
Seat 4: TurnOnTuneInDropOut (big blind) folded before Flop
Seat 5: soundfsilenz folded before Flop (didn't bet)
Seat 6: slotmachine collected ($1000)

PokerStars Hand #1922877911: Omaha Pot Limit ($200/$400 USD) - 2020/10/23 14:30:03 ET
Table 'ADA179504417' 6-max Seat #3 is the button
Seat 1: ag2703 ($68336 in chips)
Seat 2: CarlJung ($10400 in chips)
Seat 3: kimjongun ($65209 in chips)
Seat 4: TurnOnTuneInDropOut ($54235 in chips)
Seat 5: soundfsilenz ($34776 in chips)
Seat 6: slotmachine ($108405 in chips)
TurnOnTuneInDropOut: posts small blind $200
soundfsilenz: posts big blind $400
*** HOLE CARDS ***
Dealt to TurnOnTuneInDropOut [2h 2d 4d 8s]
slotmachine: raises $1000 to $1400
ag2703: folds
CarlJung: folds
kimjongun: folds
TurnOnTuneInDropOut: folds
soundfsilenz: folds
Uncalled bet ($1000) returned to slotmachine
slotmachine collected $1000 from pot
slotmachine: doesn't show hand
*** SUMMARY ***
Total pot $1000 | Rake $0
Seat 1: ag2703 folded before Flop (didn't bet)
Seat 2: CarlJung folded before Flop (didn't bet)
Seat 3: kimjongun (button) folded before Flop (didn't bet)
Seat 4: TurnOnTuneInDropOut (small blind) folded before Flop
Seat 5: soundfsilenz (big blind) folded before Flop
Seat 6: slotmachine collected ($1000)

PokerStars Hand #1922877913: Omaha Pot Limit ($200/$400 USD) - 2020/10/23 14:31:55 ET
Table 'ADA179504417' 6-max Seat #5 is the button
Seat 1: ag2703 ($66536 in chips)
Seat 2: CarlJung ($10400 in chips)
Seat 3: kimjongun ($65209 in chips)
Seat 4: TurnOnTuneInDropOut ($56267 in chips)
Seat 5: soundfsilenz ($34176 in chips)
Seat 6: slotmachine ($108605 in chips)
slotmachine: posts small blind $200
ag2703: posts big blind $400
*** HOLE CARDS ***
Dealt to TurnOnTuneInDropOut [7s 8d 6c 4d]
CarlJung: folds
kimjongun: folds
TurnOnTuneInDropOut: folds
soundfsilenz: raises $1000 to $1400
slotmachine: folds
ag2703: calls $1000
*** FLOP *** [Qs 7h 8h]
ag2703: checks
soundfsilenz: bets $2010
ag2703: calls $2010
*** TURN *** [Qs 7h 8h] [Qc]
ag2703: checks
soundfsilenz: checks
*** RIVER *** [Qs 7h 8h Qc] [9c]
ag2703: bets $7020
soundfsilenz: folds
Uncalled bet ($7020) returned to ag2703
ag2703 collected $6738 from pot
ag2703: doesn't show hand
*** SUMMARY ***
Total pot $7020 | Rake $282
Board [Qs 7h 8h Qc 9c]
Seat 1: ag2703 (big blind) collected ($6738)
Seat 2: CarlJung folded before Flop (didn't bet)
Seat 3: kimjongun folded before Flop (didn't bet)
Seat 4: TurnOnTuneInDropOut folded before Flop (didn't bet)
Seat 5: soundfsilenz (button) folded on the River
Seat 6: slotmachine (small blind) folded before Flop

PokerStars Hand #1922877914: Omaha Pot Limit ($200/$400 USD) - 2020/10/23 14:33:32 ET
Table 'ADA179504417' 6-max Seat #6 is the button
Seat 1: ag2703 ($69864 in chips)
Seat 2: CarlJung ($10400 in chips)
Seat 3: kimjongun ($65209 in chips)
Seat 4: TurnOnTuneInDropOut ($56267 in chips)
Seat 5: soundfsilenz ($30766 in chips)
Seat 6: slotmachine ($108405 in chips)
ag2703: posts small blind $200
CarlJung: posts big blind $400
*** HOLE CARDS ***
Dealt to TurnOnTuneInDropOut [5d 5s 8h Ad]
kimjongun: folds
TurnOnTuneInDropOut: folds
soundfsilenz: folds
slotmachine: raises $1000 to $1400
ag2703: folds
CarlJung: calls $1000
*** FLOP *** [Td 6h Ac]
CarlJung: checks
slotmachine: checks
*** TURN *** [Td 6h Ac] [Ah]
CarlJung: checks
slotmachine: checks
*** RIVER *** [Td 6h Ac Ah] [4h]
CarlJung: bets $1590
slotmachine: folds
Uncalled bet ($1590) returned to CarlJung
CarlJung collected $2880 from pot
CarlJung: doesn't show hand
*** SUMMARY ***
Total pot $3000 | Rake $120
Board [Td 6h Ac Ah 4h]
Seat 1: ag2703 (small blind) folded before Flop
Seat 2: CarlJung (big blind) collected ($2880)
Seat 3: kimjongun folded before Flop (didn't bet)
Seat 4: TurnOnTuneInDropOut folded before Flop (didn't bet)
Seat 5: soundfsilenz folded before Flop (didn't bet)
Seat 6: slotmachine (button) folded on the River

PokerStars Hand #1922877915: Omaha Pot Limit ($200/$400 USD) - 2020/10/23 14:34:49 ET
Table 'ADA179504417' 6-max Seat #1 is the button
Seat 1: ag2703 ($69664 in chips)
Seat 2: CarlJung ($11880 in chips)
Seat 3: kimjongun ($65209 in chips)
Seat 4: TurnOnTuneInDropOut ($56267 in chips)
Seat 5: soundfsilenz ($30766 in chips)
Seat 6: slotmachine ($107005 in chips)
CarlJung: posts small blind $200
kimjongun: posts big blind $400
*** HOLE CARDS ***
Dealt to TurnOnTuneInDropOut [Kc As Jh 3h]
TurnOnTuneInDropOut: folds
soundfsilenz: folds
slotmachine: folds
ag2703: raises $1000 to $1400
CarlJung: folds
kimjongun: folds
Uncalled bet ($1000) returned to ag2703
ag2703 collected $1000 from pot
ag2703: doesn't show hand
*** SUMMARY ***
Total pot $1000 | Rake $0
Seat 1: ag2703 (button) collected ($1000)
Seat 2: CarlJung (small blind) folded before Flop
Seat 3: kimjongun (big blind) folded before Flop
Seat 4: TurnOnTuneInDropOut folded before Flop (didn't bet)
Seat 5: soundfsilenz folded before Flop (didn't bet)
Seat 6: slotmachine folded before Flop (didn't bet)

PokerStars Hand #1922877916: Omaha Pot Limit ($200/$400 USD) - 2020/10/23 14:35:23 ET
Table 'ADA179504417' 6-max Seat #2 is the button
Seat 1: ag2703 ($70264 in chips)
Seat 2: CarlJung ($11680 in chips)
Seat 3: kimjongun ($64809 in chips)
Seat 4: TurnOnTuneInDropOut ($56267 in chips)
Seat 5: soundfsilenz ($30766 in chips)
Seat 6: slotmachine ($107005 in chips)
kimjongun: posts small blind $200
TurnOnTuneInDropOut: posts big blind $400
*** HOLE CARDS ***
Dealt to TurnOnTuneInDropOut [8h Ks Jc Th]
soundfsilenz: raises $1000 to $1400
slotmachine: calls $1400
ag2703: folds
CarlJung: folds
kimjongun: folds
TurnOnTuneInDropOut: folds
*** FLOP *** [Ts 6d 9d]
soundfsilenz: checks
slotmachine: bets $1700
soundfsilenz: folds
Uncalled bet ($1700) returned to slotmachine
slotmachine collected $3264 from pot
slotmachine: doesn't show hand
*** SUMMARY ***
Total pot $3400 | Rake $136
Board [Ts 6d 9d]
Seat 1: ag2703 folded before Flop (didn't bet)
Seat 2: CarlJung (button) folded before Flop (didn't bet)
Seat 3: kimjongun (small blind) folded before Flop
Seat 4: TurnOnTuneInDropOut (big blind) folded before Flop
Seat 5: soundfsilenz folded on the Flop
Seat 6: slotmachine collected ($3264)

PokerStars Hand #1922877918: Omaha Pot Limit ($200/$400 USD) - 2020/10/23 14:38:18 ET
Table 'ADA179504417' 6-max Seat #4 is the button
Seat 1: ag2703 ($69864 in chips)
Seat 2: CarlJung ($11680 in chips)
Seat 3: kimjongun ($64609 in chips)
Seat 4: TurnOnTuneInDropOut ($55667 in chips)
Seat 5: soundfsilenz ($29926 in chips)
Seat 6: slotmachine ($108869 in chips)
soundfsilenz: posts small blind $200
slotmachine: posts big blind $400
*** HOLE CARDS ***
Dealt to TurnOnTuneInDropOut [Ah 5c 5d 9h]
ag2703: raises $1000 to $1400
CarlJung: folds
kimjongun: folds
TurnOnTuneInDropOut: folds
soundfsilenz: calls $1200
slotmachine: folds
*** FLOP *** [Kh Qs Th]
soundfsilenz: checks
ag2703: checks
*** TURN *** [Kh Qs Th] [Qd]
soundfsilenz: bets $1728
ag2703: calls $1728
*** RIVER *** [Kh Qs Th Qd] [4h]
soundfsilenz: checks
ag2703: bets $6656
soundfsilenz: folds
Uncalled bet ($6656) returned to ag2703
ag2703 collected $6389 from pot
ag2703: doesn't show hand
*** SUMMARY ***
Total pot $6656 | Rake $267
Board [Kh Qs Th Qd 4h]
Seat 1: ag2703 collected ($6389)
Seat 2: CarlJung folded before Flop (didn't bet)
Seat 3: kimjongun folded before Flop (didn't bet)
Seat 4: TurnOnTuneInDropOut (button) folded before Flop (didn't bet)
Seat 5: soundfsilenz (small blind) folded on the River
Seat 6: slotmachine (big blind) folded before Flop

PokerStars Hand #1922877919: Omaha Pot Limit ($200/$400 USD) - 2020/10/23 14:39:56 ET
Table 'ADA179504417' 6-max Seat #5 is the button
Seat 1: ag2703 ($73125 in chips)
Seat 2: CarlJung ($11680 in chips)
Seat 3: kimjongun ($64609 in chips)
Seat 4: TurnOnTuneInDropOut ($55667 in chips)
Seat 5: soundfsilenz ($26798 in chips)
Seat 6: slotmachine ($108469 in chips)
slotmachine: posts small blind $200
ag2703: posts big blind $400
*** HOLE CARDS ***
Dealt to TurnOnTuneInDropOut [Th 2d 8c 7c]
CarlJung: raises $1000 to $1400
kimjongun: folds
TurnOnTuneInDropOut: folds
soundfsilenz: folds
slotmachine: folds
ag2703: folds
Uncalled bet ($1000) returned to CarlJung
CarlJung collected $1000 from pot
CarlJung: doesn't show hand
*** SUMMARY ***
Total pot $1000 | Rake $0
Seat 1: ag2703 (big blind) folded before Flop
Seat 2: CarlJung collected ($1000)
Seat 3: kimjongun folded before Flop (didn't bet)
Seat 4: TurnOnTuneInDropOut folded before Flop (didn't bet)
Seat 5: soundfsilenz (button) folded before Flop (didn't bet)
Seat 6: slotmachine (small blind) folded before Flop

PokerStars Hand #1922877920: Omaha Pot Limit ($200/$400 USD) - 2020/10/23 14:40:29 ET
Table 'ADA179504417' 6-max Seat #6 is the button
Seat 1: ag2703 ($72725 in chips)
Seat 2: CarlJung ($12280 in chips)
Seat 3: kimjongun ($64609 in chips)
Seat 4: TurnOnTuneInDropOut ($55667 in chips)
Seat 5: soundfsilenz ($26798 in chips)
Seat 6: slotmachine ($108269 in chips)
ag2703: posts small blind $200
CarlJung: posts big blind $400
*** HOLE CARDS ***
Dealt to TurnOnTuneInDropOut [9c 4h Ts 8c]
kimjongun: raises $600 to $1000
TurnOnTuneInDropOut: folds
soundfsilenz: folds
slotmachine: raises $2600 to $3600
ag2703: calls $3400
CarlJung: folds
kimjongun: calls $2600
*** FLOP *** [9s 7c 7d]
ag2703: checks
kimjongun: checks
slotmachine: bets $3696
ag2703: folds
kimjongun: raises $10015 to $13711
slotmachine: calls $10015
*** TURN *** [9s 7c 7d] [8s]
kimjongun: bets $13518
slotmachine: calls $13518
*** RIVER *** [9s 7c 7d 8s] [8h]
kimjongun: bets $33780 and is all-in
slotmachine: folds
Uncalled bet ($33780) returned to kimjongun
kimjongun collected $64858 from pot
kimjongun: doesn't show hand
*** SUMMARY ***
Total pot $65658 | Rake $800
Board [9s 7c 7d 8s 8h]
Seat 1: ag2703 (small blind) folded on the Flop
Seat 2: CarlJung (big blind) folded before Flop
Seat 3: kimjongun collected ($64858)
Seat 4: TurnOnTuneInDropOut folded before Flop (didn't bet)
Seat 5: soundfsilenz folded before Flop (didn't bet)
Seat 6: slotmachine (button) folded on the River

PokerStars Hand #1922877921: Omaha Pot Limit ($200/$400 USD) - 2020/10/23 14:43:01 ET
Table 'ADA179504417' 6-max Seat #1 is the button
Seat 1: ag2703 ($69125 in chips)
Seat 2: CarlJung ($11880 in chips)
Seat 3: kimjongun ($98638 in chips)
Seat 4: TurnOnTuneInDropOut ($55667 in chips)
Seat 5: soundfsilenz ($42000 in chips)
Seat 6: slotmachine ($77440 in chips)
CarlJung: posts small blind $200
kimjongun: posts big blind $400
*** HOLE CARDS ***
Dealt to TurnOnTuneInDropOut [Ks 3c 7s 5c]
TurnOnTuneInDropOut: folds
soundfsilenz: raises $1000 to $1400
slotmachine: folds
ag2703: folds
CarlJung: calls $1200
kimjongun: raises $4200 to $5600
soundfsilenz: calls $4200
CarlJung: calls $4200
*** FLOP *** [6h Jh Ad]
CarlJung: bets $6280 and is all-in
kimjongun: calls $6280
soundfsilenz: folds
*** TURN *** [6h Jh Ad] [9s]
*** RIVER *** [6h Jh Ad 9s] [2c]
*** SHOW DOWN ***
CarlJung: shows [Ah Jd Td 9c]
kimjongun: shows [Kh Qs As 2h]
CarlJung collected $28560 from pot
*** SUMMARY ***
Total pot $29360 | Rake $800
Board [6h Jh Ad 9s 2c]
Seat 1: ag2703 (button) folded before Flop (didn't bet)
Seat 2: CarlJung (small blind) showed [Ah Jd Td 9c] and won ($28560)
Seat 3: kimjongun (big blind) showed [Kh Qs As 2h] and lost
Seat 4: TurnOnTuneInDropOut folded before Flop (didn't bet)
Seat 5: soundfsilenz folded on the Flop
Seat 6: slotmachine folded before Flop (didn't bet)

PokerStars Hand #1922878042: Omaha Pot Limit ($200/$400 USD) - 2020/10/23 16:34:53 ET
Table 'ADA179504417' 6-max Seat #1 is the button
Seat 1: ag2703 ($24783 in chips)
Seat 2: singlajimitesh ($44087 in chips)
Seat 3: TurnOnTuneInDropOut ($30000 in chips)
Seat 4: craftplayer ($29172 in chips)
singlajimitesh: posts small blind $200
TurnOnTuneInDropOut: posts big blind $400
*** HOLE CARDS ***
Dealt to TurnOnTuneInDropOut [Th 3d Ac 4c]
craftplayer: raises $400 to $800
ag2703: folds
singlajimitesh: calls $600
TurnOnTuneInDropOut: calls $400
*** FLOP *** [Td 3s 3h]
singlajimitesh: checks
TurnOnTuneInDropOut: checks
craftplayer: checks
*** TURN *** [Td 3s 3h] [2h]
singlajimitesh: bets $1200
TurnOnTuneInDropOut: calls $1200
craftplayer: folds
*** RIVER *** [Td 3s 3h 2h] [5s]
singlajimitesh: checks
TurnOnTuneInDropOut: bets $4800
singlajimitesh: folds
Uncalled bet ($4800) returned to TurnOnTuneInDropOut
TurnOnTuneInDropOut collected $4608 from pot
TurnOnTuneInDropOut: doesn't show hand
*** SUMMARY ***
Total pot $4800 | Rake $192
Board [Td 3s 3h 2h 5s]
Seat 1: ag2703 (button) folded before Flop (didn't bet)
Seat 2: singlajimitesh (small blind) folded on the River
Seat 3: TurnOnTuneInDropOut (big blind) collected ($4608)
Seat 4: craftplayer folded on the Turn

PokerStars Hand #1922878048: Omaha Pot Limit ($200/$400 USD) - 2020/10/23 16:41:30 ET
Table 'ADA179504417' 6-max Seat #3 is the button
Seat 1: ag2703 ($9868 in chips)
Seat 2: singlajimitesh ($60469 in chips)
Seat 3: TurnOnTuneInDropOut ($48000 in chips)
Seat 4: craftplayer ($75784 in chips)
craftplayer: posts small blind $200
ag2703: posts big blind $400
*** HOLE CARDS ***
Dealt to TurnOnTuneInDropOut [5s Jc Kh Kc]
singlajimitesh: raises $400 to $800
TurnOnTuneInDropOut: raises $2200 to $3000
craftplayer: folds
ag2703: folds
singlajimitesh: calls $2200
*** FLOP *** [6d Jd 7s]
singlajimitesh: checks
TurnOnTuneInDropOut: checks
*** TURN *** [6d Jd 7s] [3d]
singlajimitesh: checks
TurnOnTuneInDropOut: checks
*** RIVER *** [6d Jd 7s 3d] [4d]
singlajimitesh: bets $3300
TurnOnTuneInDropOut: folds
Uncalled bet ($3300) returned to singlajimitesh
singlajimitesh collected $6335 from pot
singlajimitesh: doesn't show hand
*** SUMMARY ***
Total pot $6600 | Rake $265
Board [6d Jd 7s 3d 4d]
Seat 1: ag2703 (big blind) folded before Flop
Seat 2: singlajimitesh collected ($6335)
Seat 3: TurnOnTuneInDropOut (button) folded on the River
Seat 4: craftplayer (small blind) folded before Flop

PokerStars Hand #1922878049: Omaha Pot Limit ($200/$400 USD) - 2020/10/23 16:42:24 ET
Table 'ADA179504417' 6-max Seat #4 is the button
Seat 1: ag2703 ($9468 in chips)
Seat 2: singlajimitesh ($63804 in chips)
Seat 3: TurnOnTuneInDropOut ($45000 in chips)
Seat 4: craftplayer ($75584 in chips)
ag2703: posts small blind $200
singlajimitesh: posts big blind $400
*** HOLE CARDS ***
Dealt to TurnOnTuneInDropOut [Kc 5c Td 5h]
TurnOnTuneInDropOut: folds
craftplayer: raises $1000 to $1400
ag2703: folds
singlajimitesh: raises $3000 to $4400
craftplayer: calls $3000
*** FLOP *** [Qs Tc 9c]
singlajimitesh: checks
craftplayer: bets $4500
singlajimitesh: calls $4500
*** TURN *** [Qs Tc 9c] [9d]
singlajimitesh: checks
craftplayer: bets $9000
singlajimitesh: calls $9000
*** RIVER *** [Qs Tc 9c 9d] [7h]
singlajimitesh: checks
craftplayer: bets $27000
singlajimitesh: folds
Uncalled bet ($27000) returned to craftplayer
craftplayer collected $35200 from pot
craftplayer: doesn't show hand
*** SUMMARY ***
Total pot $36000 | Rake $800
Board [Qs Tc 9c 9d 7h]
Seat 1: ag2703 (small blind) folded before Flop
Seat 2: singlajimitesh (big blind) folded on the River
Seat 3: TurnOnTuneInDropOut folded before Flop (didn't bet)
Seat 4: craftplayer (button) collected ($35200)

PokerStars Hand #1922878050: Omaha Pot Limit ($200/$400 USD) - 2020/10/23 16:43:44 ET
Table 'ADA179504417' 6-max Seat #1 is the button
Seat 1: ag2703 ($9268 in chips)
Seat 2: singlajimitesh ($45904 in chips)
Seat 3: TurnOnTuneInDropOut ($48000 in chips)
Seat 4: craftplayer ($92884 in chips)
singlajimitesh: posts small blind $200
TurnOnTuneInDropOut: posts big blind $400
*** HOLE CARDS ***
Dealt to TurnOnTuneInDropOut [5s Qh Qd 2d]
craftplayer: raises $400 to $800
ag2703: calls $800
singlajimitesh: raises $2800 to $3600
TurnOnTuneInDropOut: folds
craftplayer: calls $2800
ag2703: folds
*** FLOP *** [4c 2h 7d]
singlajimitesh: checks
craftplayer: checks
*** TURN *** [4c 2h 7d] [Ts]
singlajimitesh: checks
craftplayer: checks
*** RIVER *** [4c 2h 7d Ts] [3d]
singlajimitesh: checks
craftplayer: checks
*** SHOW DOWN ***
singlajimitesh: shows [Ah Kd 9h Ks]
craftplayer: mucks hand
singlajimitesh collected $8063 from pot
*** SUMMARY ***
Total pot $8400 | Rake $337
Board [4c 2h 7d Ts 3d]
Seat 1: ag2703 (button) folded before Flop
Seat 2: singlajimitesh (small blind) showed [Ah Kd 9h Ks] and won ($8063)
Seat 3: TurnOnTuneInDropOut (big blind) folded before Flop
Seat 4: craftplayer mucked

PokerStars Hand #1922878052: Omaha Pot Limit ($200/$400 USD) - 2020/10/23 16:45:14 ET
Table 'ADA179504417' 6-max Seat #3 is the button
Seat 1: ag2703 ($8468 in chips)
Seat 2: singlajimitesh ($48967 in chips)
Seat 3: TurnOnTuneInDropOut ($47400 in chips)
Seat 4: craftplayer ($90764 in chips)
craftplayer: posts small blind $200
ag2703: posts big blind $400
*** HOLE CARDS ***
Dealt to TurnOnTuneInDropOut [2s 3h 9c 8h]
singlajimitesh: raises $1000 to $1400
TurnOnTuneInDropOut: folds
craftplayer: folds
ag2703: folds
Uncalled bet ($1000) returned to singlajimitesh
singlajimitesh collected $1000 from pot
singlajimitesh: doesn't show hand
*** SUMMARY ***
Total pot $1000 | Rake $0
Seat 1: ag2703 (big blind) folded before Flop
Seat 2: singlajimitesh collected ($1000)
Seat 3: TurnOnTuneInDropOut (button) folded before Flop (didn't bet)
Seat 4: craftplayer (small blind) folded before Flop

PokerStars Hand #1922878053: Omaha Pot Limit ($200/$400 USD) - 2020/10/23 16:45:30 ET
Table 'ADA179504417' 6-max Seat #4 is the button
Seat 1: ag2703 ($8068 in chips)
Seat 2: singlajimitesh ($49567 in chips)
Seat 3: TurnOnTuneInDropOut ($47400 in chips)
Seat 4: craftplayer ($90564 in chips)
ag2703: posts small blind $200
singlajimitesh: posts big blind $400
*** HOLE CARDS ***
Dealt to TurnOnTuneInDropOut [8c 2s 3c Jd]
TurnOnTuneInDropOut: folds
craftplayer: raises $1000 to $1400
ag2703: folds
singlajimitesh: calls $1000
*** FLOP *** [Js 5s Kc]
singlajimitesh: checks
craftplayer: bets $1500
singlajimitesh: folds
Uncalled bet ($1500) returned to craftplayer
craftplayer collected $2880 from pot
craftplayer: doesn't show hand
*** SUMMARY ***
Total pot $3000 | Rake $120
Board [Js 5s Kc]
Seat 1: ag2703 (small blind) folded before Flop
Seat 2: singlajimitesh (big blind) folded on the Flop
Seat 3: TurnOnTuneInDropOut folded before Flop (didn't bet)
Seat 4: craftplayer (button) collected ($2880)

PokerStars Hand #1922878054: Omaha Pot Limit ($200/$400 USD) - 2020/10/23 16:46:07 ET
Table 'ADA179504417' 6-max Seat #2 is the button
Seat 2: singlajimitesh ($48167 in chips)
Seat 3: TurnOnTuneInDropOut ($47400 in chips)
Seat 4: craftplayer ($92044 in chips)
TurnOnTuneInDropOut: posts small blind $200
craftplayer: posts big blind $400
*** HOLE CARDS ***
Dealt to TurnOnTuneInDropOut [7h Ks 6s 4h]
singlajimitesh: raises $1000 to $1400
TurnOnTuneInDropOut: folds
craftplayer: calls $1000
*** FLOP *** [4c 3c 5s]
craftplayer: checks
singlajimitesh: bets $3000
craftplayer: raises $9000 to $12000
singlajimitesh: folds
Uncalled bet ($9000) returned to craftplayer
craftplayer collected $8639 from pot
craftplayer: doesn't show hand
*** SUMMARY ***
Total pot $9000 | Rake $361
Board [4c 3c 5s]
Seat 2: singlajimitesh (button) folded on the Flop
Seat 3: TurnOnTuneInDropOut (small blind) folded before Flop
Seat 4: craftplayer (big blind) collected ($8639)

PokerStars Hand #1922878056: Omaha Pot Limit ($200/$400 USD) - 2020/10/23 16:47:59 ET
Table 'ADA179504417' 6-max Seat #4 is the button
Seat 2: singlajimitesh ($43367 in chips)
Seat 3: TurnOnTuneInDropOut ($54390 in chips)
Seat 4: craftplayer ($88883 in chips)
singlajimitesh: posts small blind $200
TurnOnTuneInDropOut: posts big blind $400
*** HOLE CARDS ***
Dealt to TurnOnTuneInDropOut [9s Js Kh 3d]
craftplayer: raises $1000 to $1400
singlajimitesh: calls $1200
TurnOnTuneInDropOut: folds
*** FLOP *** [Jd 6d Ts]
singlajimitesh: checks
craftplayer: checks
*** TURN *** [Jd 6d Ts] [4d]
singlajimitesh: checks
craftplayer: bets $2400
singlajimitesh: folds
Uncalled bet ($2400) returned to craftplayer
craftplayer collected $3072 from pot
craftplayer: doesn't show hand
*** SUMMARY ***
Total pot $3200 | Rake $128
Board [Jd 6d Ts 4d]
Seat 2: singlajimitesh (small blind) folded on the Turn
Seat 3: TurnOnTuneInDropOut (big blind) folded before Flop
Seat 4: craftplayer (button) collected ($3072)

PokerStars Hand #1922878057: Omaha Pot Limit ($200/$400 USD) - 2020/10/23 16:48:55 ET
Table 'ADA179504417' 6-max Seat #2 is the button
Seat 2: singlajimitesh ($41967 in chips)
Seat 3: TurnOnTuneInDropOut ($53990 in chips)
Seat 4: craftplayer ($90555 in chips)
TurnOnTuneInDropOut: posts small blind $200
craftplayer: posts big blind $400
*** HOLE CARDS ***
Dealt to TurnOnTuneInDropOut [2c 9s 5c Kc]
singlajimitesh: raises $1000 to $1400
TurnOnTuneInDropOut: folds
craftplayer: calls $1000
*** FLOP *** [Kd 7c 7h]
craftplayer: checks
singlajimitesh: bets $1500
craftplayer: folds
Uncalled bet ($1500) returned to singlajimitesh
singlajimitesh collected $2880 from pot
singlajimitesh: doesn't show hand
*** SUMMARY ***
Total pot $3000 | Rake $120
Board [Kd 7c 7h]
Seat 2: singlajimitesh (button) collected ($2880)
Seat 3: TurnOnTuneInDropOut (small blind) folded before Flop
Seat 4: craftplayer (big blind) folded on the Flop

PokerStars Hand #1922878058: Omaha Pot Limit ($200/$400 USD) - 2020/10/23 16:49:49 ET
Table 'ADA179504417' 6-max Seat #3 is the button
Seat 2: singlajimitesh ($43447 in chips)
Seat 3: TurnOnTuneInDropOut ($53790 in chips)
Seat 4: craftplayer ($89155 in chips)
craftplayer: posts small blind $200
singlajimitesh: posts big blind $400
*** HOLE CARDS ***
Dealt to TurnOnTuneInDropOut [3h Qd 8h Qs]
TurnOnTuneInDropOut: raises $1000 to $1400
craftplayer: folds
singlajimitesh: calls $1000
*** FLOP *** [2d 2s 5c]
singlajimitesh: checks
TurnOnTuneInDropOut: bets $990
singlajimitesh: calls $990
*** TURN *** [2d 2s 5c] [3c]
singlajimitesh: checks
TurnOnTuneInDropOut: checks
*** RIVER *** [2d 2s 5c 3c] [2h]
singlajimitesh: bets $2490
TurnOnTuneInDropOut: calls $2490
*** SHOW DOWN ***
singlajimitesh: shows [5h Kh Qh Kc]
singlajimitesh collected $9561 from pot
*** SUMMARY ***
Total pot $9960 | Rake $399
Board [2d 2s 5c 3c 2h]
Seat 2: singlajimitesh (big blind) showed [5h Kh Qh Kc] and won ($9561)
Seat 3: TurnOnTuneInDropOut (button)
Seat 4: craftplayer (small blind) folded before Flop

PokerStars Hand #1922878059: Omaha Pot Limit ($200/$400 USD) - 2020/10/23 16:50:39 ET
Table 'ADA179504417' 6-max Seat #4 is the button
Seat 2: singlajimitesh ($48128 in chips)
Seat 3: TurnOnTuneInDropOut ($48910 in chips)
Seat 4: craftplayer ($88955 in chips)
singlajimitesh: posts small blind $200
TurnOnTuneInDropOut: posts big blind $400
*** HOLE CARDS ***
Dealt to TurnOnTuneInDropOut [8h Kd 9s 4c]
craftplayer: raises $400 to $800
singlajimitesh: raises $2000 to $2800
TurnOnTuneInDropOut: folds
craftplayer: calls $2000
*** FLOP *** [Js Qc Qd]
singlajimitesh: checks
craftplayer: bets $3000
singlajimitesh: calls $3000
*** TURN *** [Js Qc Qd] [5s]
singlajimitesh: checks
craftplayer: bets $6800
singlajimitesh: calls $6800
*** RIVER *** [Js Qc Qd 5s] [2c]
singlajimitesh: checks
craftplayer: bets $19200
singlajimitesh: calls $19200
*** SHOW DOWN ***
singlajimitesh: mucks hand
craftplayer: shows [9h Jc Qh 2s]
craftplayer collected $63300 from pot
*** SUMMARY ***
Total pot $64000 | Rake $700
Board [Js Qc Qd 5s 2c]
Seat 2: singlajimitesh (small blind) mucked
Seat 3: TurnOnTuneInDropOut (big blind) folded before Flop
Seat 4: craftplayer (button) showed [9h Jc Qh 2s] and won ($63300)

PokerStars Hand #1922878060: Omaha Pot Limit ($200/$400 USD) - 2020/10/23 16:51:33 ET
Table 'ADA179504417' 6-max Seat #2 is the button
Seat 2: singlajimitesh ($16328 in chips)
Seat 3: TurnOnTuneInDropOut ($48510 in chips)
Seat 4: craftplayer ($120455 in chips)
TurnOnTuneInDropOut: posts small blind $200
craftplayer: posts big blind $400
*** HOLE CARDS ***
Dealt to TurnOnTuneInDropOut [3h 2s Ah 5d]
singlajimitesh: raises $1000 to $1400
TurnOnTuneInDropOut: folds
craftplayer: calls $1000
*** FLOP *** [Ad 6h Th]
craftplayer: checks
singlajimitesh: checks
*** TURN *** [Ad 6h Th] [Kd]
craftplayer: bets $2250
singlajimitesh: calls $2250
*** RIVER *** [Ad 6h Th Kd] [Qd]
craftplayer: checks
singlajimitesh: checks
*** SHOW DOWN ***
craftplayer: shows [Qc 2c Kc Jd]
singlajimitesh: mucks hand
craftplayer collected $7199 from pot
*** SUMMARY ***
Total pot $7500 | Rake $301
Board [Ad 6h Th Kd Qd]
Seat 2: singlajimitesh (button) mucked
Seat 3: TurnOnTuneInDropOut (small blind) folded before Flop
Seat 4: craftplayer (big blind) showed [Qc 2c Kc Jd] and won ($7199)

PokerStars Hand #1922878061: Omaha Pot Limit ($200/$400 USD) - 2020/10/23 16:52:08 ET
Table 'ADA179504417' 6-max Seat #3 is the button
Seat 2: singlajimitesh ($12678 in chips)
Seat 3: TurnOnTuneInDropOut ($48310 in chips)
Seat 4: craftplayer ($124004 in chips)
craftplayer: posts small blind $200
singlajimitesh: posts big blind $400
*** HOLE CARDS ***
Dealt to TurnOnTuneInDropOut [7d 4c As Qc]
TurnOnTuneInDropOut: raises $1000 to $1400
craftplayer: calls $1200
singlajimitesh: raises $4200 to $5600
TurnOnTuneInDropOut: folds
craftplayer: calls $4200
*** FLOP *** [Th 8d Jc]
craftplayer: checks
singlajimitesh: bets $7078 and is all-in
craftplayer: calls $7078
*** TURN *** [Th 8d Jc] [7h]
*** RIVER *** [Th 8d Jc 7h] [Js]
*** SHOW DOWN ***
craftplayer: shows [Ts Td 7c 9d]
singlajimitesh: shows [Ac 3h Kh Tc]
craftplayer collected $26056 from pot
*** SUMMARY ***
Total pot $26756 | Rake $700
Board [Th 8d Jc 7h Js]
Seat 2: singlajimitesh (big blind) showed [Ac 3h Kh Tc] and lost
Seat 3: TurnOnTuneInDropOut (button) folded before Flop
Seat 4: craftplayer (small blind) showed [Ts Td 7c 9d] and won ($26056)

PokerStars Hand #1740871411: Omaha Pot Limit ($200/$400 USD) - 2020/10/23 12:35:57 ET
Table 'ADA409467368' 6-max Seat #5 is the button
Seat 2: Sam565 ($9168 in chips)
Seat 3: TurnOnTuneInDropOut ($30000 in chips)
Seat 4: ag2703 ($27020 in chips)
Seat 5: slotmachine ($56542 in chips)
Sam565: posts small blind $200
TurnOnTuneInDropOut: posts big blind $400
*** HOLE CARDS ***
Dealt to TurnOnTuneInDropOut [Jc 3d Qh Jd]
ag2703: raises $400 to $800
slotmachine: folds
Sam565: raises $2000 to $2800
TurnOnTuneInDropOut: folds
ag2703: calls $2000
*** FLOP *** [Kd 7h Kh]
Sam565: bets $6000
ag2703: folds
Uncalled bet ($6000) returned to Sam565
Sam565 collected $5759 from pot
Sam565: doesn't show hand
*** SUMMARY ***
Total pot $6000 | Rake $241
Board [Kd 7h Kh]
Seat 2: Sam565 (small blind) collected ($5759)
Seat 3: TurnOnTuneInDropOut (big blind) folded before Flop
Seat 4: ag2703 folded on the Flop
Seat 5: slotmachine (button) folded before Flop (didn't bet)

PokerStars Hand #1740871412: Omaha Pot Limit ($200/$400 USD) - 2020/10/23 12:36:48 ET
Table 'ADA409467368' 6-max Seat #2 is the button
Seat 2: Sam565 ($12127 in chips)
Seat 3: TurnOnTuneInDropOut ($29600 in chips)
Seat 4: ag2703 ($24220 in chips)
Seat 5: slotmachine ($56542 in chips)
TurnOnTuneInDropOut: posts small blind $200
ag2703: posts big blind $400
*** HOLE CARDS ***
Dealt to TurnOnTuneInDropOut [2h Qd Qc 9h]
slotmachine: raises $1000 to $1400
Sam565: calls $1400
TurnOnTuneInDropOut: folds
ag2703: folds
*** FLOP *** [4s 7c 8h]
slotmachine: checks
Sam565: bets $3400
slotmachine: folds
Uncalled bet ($3400) returned to Sam565
Sam565 collected $3264 from pot
Sam565: doesn't show hand
*** SUMMARY ***
Total pot $3400 | Rake $136
Board [4s 7c 8h]
Seat 2: Sam565 (button) collected ($3264)
Seat 3: TurnOnTuneInDropOut (small blind) folded before Flop
Seat 4: ag2703 (big blind) folded before Flop
Seat 5: slotmachine folded on the Flop

PokerStars Hand #1740871414: Omaha Pot Limit ($200/$400 USD) - 2020/10/23 12:39:05 ET
Table 'ADA409467368' 6-max Seat #4 is the button
Seat 2: Sam565 ($16607 in chips)
Seat 3: TurnOnTuneInDropOut ($46200 in chips)
Seat 4: ag2703 ($23620 in chips)
Seat 5: slotmachine ($54742 in chips)
Seat 6: Shr181 ($34327 in chips)
slotmachine: posts small blind $200
Shr181: posts big blind $400
*** HOLE CARDS ***
Dealt to TurnOnTuneInDropOut [Tc 7h Kd 7d]
Sam565: folds
TurnOnTuneInDropOut: folds
ag2703: folds
slotmachine: folds
Uncalled bet ($200) returned to Shr181
Shr181 collected $400 from pot
Shr181: doesn't show hand
*** SUMMARY ***
Total pot $400 | Rake $0
Seat 2: Sam565 folded before Flop (didn't bet)
Seat 3: TurnOnTuneInDropOut folded before Flop (didn't bet)
Seat 4: ag2703 (button) folded before Flop (didn't bet)
Seat 5: slotmachine (small blind) folded before Flop
Seat 6: Shr181 (big blind) collected ($400)

PokerStars Hand #1740871415: Omaha Pot Limit ($200/$400 USD) - 2020/10/23 12:39:30 ET
Table 'ADA409467368' 6-max Seat #5 is the button
Seat 2: Sam565 ($16607 in chips)
Seat 3: TurnOnTuneInDropOut ($46200 in chips)
Seat 4: ag2703 ($23620 in chips)
Seat 5: slotmachine ($54542 in chips)
Seat 6: Shr181 ($34527 in chips)
Shr181: posts small blind $200
Sam565: posts big blind $400
*** HOLE CARDS ***
Dealt to TurnOnTuneInDropOut [Qd 9h 9s 2h]
TurnOnTuneInDropOut: folds
ag2703: folds
slotmachine: raises $1000 to $1400
Shr181: calls $1200
Sam565: calls $1000
*** FLOP *** [5s 5h 4s]
Shr181: checks
Sam565: checks
slotmachine: bets $1386
Shr181: calls $1386
Sam565: folds
*** TURN *** [5s 5h 4s] [2c]
Shr181: bets $1200
slotmachine: calls $1200
*** RIVER *** [5s 5h 4s 2c] [Jd]
Shr181: checks
slotmachine: checks
*** SHOW DOWN ***
Shr181: mucks hand
slotmachine: shows [2s Ah Ad 4d]
slotmachine collected $8996 from pot
*** SUMMARY ***
Total pot $9372 | Rake $376
Board [5s 5h 4s 2c Jd]
Seat 2: Sam565 (big blind) folded on the Flop
Seat 3: TurnOnTuneInDropOut folded before Flop (didn't bet)
Seat 4: ag2703 folded before Flop (didn't bet)
Seat 5: slotmachine (button) showed [2s Ah Ad 4d] and won ($8996)
Seat 6: Shr181 (small blind) mucked

PokerStars Hand #228844228: Omaha Pot Limit ($200/$400 USD) - 2020/10/23 13:31:41 ET
Table 'ADA409467368' 6-max Seat #5 is the button
Seat 1: soundfsilenz ($47568 in chips)
Seat 2: Aksxone ($8924 in chips)
Seat 3: kimjongun ($32488 in chips)
Seat 4: ag2703 ($55841 in chips)
Seat 5: slotmachine ($62066 in chips)
Seat 6: TurnOnTuneInDropOut ($29600 in chips)
TurnOnTuneInDropOut: posts small blind $200
soundfsilenz: posts big blind $400
*** HOLE CARDS ***
Dealt to TurnOnTuneInDropOut [3s 6c Ks Jd]
Aksxone: raises $800 to $1200
kimjongun: folds
ag2703: folds
slotmachine: raises $3000 to $4200
TurnOnTuneInDropOut: folds
soundfsilenz: folds
Aksxone: calls $3000
*** FLOP *** [Js 7s 8c]
Aksxone: bets $4724 and is all-in
slotmachine: calls $4724
*** TURN *** [Js 7s 8c] [9h]
*** RIVER *** [Js 7s 8c 9h] [9d]
*** SHOW DOWN ***
Aksxone: shows [2s 5d 7h 7d]
slotmachine: shows [Qd 2c Qc As]
Aksxone collected $17708 from pot
*** SUMMARY ***
Total pot $18448 | Rake $740
Board [Js 7s 8c 9h 9d]
Seat 1: soundfsilenz (big blind) folded before Flop
Seat 2: Aksxone showed [2s 5d 7h 7d] and won ($17708)
Seat 3: kimjongun folded before Flop (didn't bet)
Seat 4: ag2703 folded before Flop (didn't bet)
Seat 5: slotmachine (button) showed [Qd 2c Qc As] and lost
Seat 6: TurnOnTuneInDropOut (small blind) folded before Flop

PokerStars Hand #228844229: Omaha Pot Limit ($200/$400 USD) - 2020/10/23 13:32:26 ET
Table 'ADA409467368' 6-max Seat #6 is the button
Seat 1: soundfsilenz ($47168 in chips)
Seat 2: Aksxone ($17708 in chips)
Seat 3: kimjongun ($32488 in chips)
Seat 4: ag2703 ($55841 in chips)
Seat 5: slotmachine ($53142 in chips)
Seat 6: TurnOnTuneInDropOut ($29400 in chips)
soundfsilenz: posts small blind $200
Aksxone: posts big blind $400
*** HOLE CARDS ***
Dealt to TurnOnTuneInDropOut [Qs 4c Ad 7h]
kimjongun: raises $600 to $1000
ag2703: folds
slotmachine: raises $2600 to $3600
TurnOnTuneInDropOut: folds
soundfsilenz: folds
Aksxone: folds
kimjongun: calls $2600
*** FLOP *** [7s Tc 8s]
kimjongun: checks
slotmachine: checks
*** TURN *** [7s Tc 8s] [Kd]
kimjongun: bets $5148
slotmachine: calls $5148
*** RIVER *** [7s Tc 8s Kd] [8d]
kimjongun: bets $18096
slotmachine: calls $18096
*** SHOW DOWN ***
kimjongun: mucks hand
slotmachine: shows [9h 5c Kh 7c]
slotmachine collected $53488 from pot
*** SUMMARY ***
Total pot $54288 | Rake $800
Board [7s Tc 8s Kd 8d]
Seat 1: soundfsilenz (small blind) folded before Flop
Seat 2: Aksxone (big blind) folded before Flop
Seat 3: kimjongun mucked
Seat 4: ag2703 folded before Flop (didn't bet)
Seat 5: slotmachine showed [9h 5c Kh 7c] and won ($53488)
Seat 6: TurnOnTuneInDropOut (button) folded before Flop (didn't bet)

PokerStars Hand #228844230: Omaha Pot Limit ($200/$400 USD) - 2020/10/23 13:34:03 ET
Table 'ADA409467368' 6-max Seat #1 is the button
Seat 1: soundfsilenz ($46968 in chips)
Seat 2: Aksxone ($17308 in chips)
Seat 3: kimjongun ($30000 in chips)
Seat 4: ag2703 ($55841 in chips)
Seat 5: slotmachine ($79786 in chips)
Seat 6: TurnOnTuneInDropOut ($29400 in chips)
Aksxone: posts small blind $200
kimjongun: posts big blind $400
*** HOLE CARDS ***
Dealt to TurnOnTuneInDropOut [6h Ts Ks Ad]
ag2703: folds
slotmachine: folds
TurnOnTuneInDropOut: raises $1000 to $1400
soundfsilenz: raises $3400 to $4800
Aksxone: folds
kimjongun: calls $4400
TurnOnTuneInDropOut: folds
*** FLOP *** [7d 8c 3c]
kimjongun: checks
soundfsilenz: bets $7504
kimjongun: calls $7504
*** TURN *** [7d 8c 3c] [3d]
kimjongun: bets $17696 and is all-in
soundfsilenz: calls $17696
*** RIVER *** [7d 8c 3c 3d] [8d]
*** SHOW DOWN ***
kimjongun: shows [7h Th Qd Kd]
soundfsilenz: shows [Qc Jh Ac Td]
kimjongun collected $60800 from pot
*** SUMMARY ***
Total pot $61600 | Rake $800
Board [7d 8c 3c 3d 8d]
Seat 1: soundfsilenz (button) showed [Qc Jh Ac Td] and lost
Seat 2: Aksxone (small blind) folded before Flop
Seat 3: kimjongun (big blind) showed [7h Th Qd Kd] and won ($60800)
Seat 4: ag2703 folded before Flop (didn't bet)
Seat 5: slotmachine folded before Flop (didn't bet)
Seat 6: TurnOnTuneInDropOut folded before Flop

PokerStars Hand #228844231: Omaha Pot Limit ($200/$400 USD) - 2020/10/23 13:35:24 ET
Table 'ADA409467368' 6-max Seat #2 is the button
Seat 1: soundfsilenz ($16968 in chips)
Seat 2: Aksxone ($17108 in chips)
Seat 3: kimjongun ($60800 in chips)
Seat 4: ag2703 ($55841 in chips)
Seat 5: slotmachine ($79786 in chips)
Seat 6: TurnOnTuneInDropOut ($28000 in chips)
kimjongun: posts small blind $200
ag2703: posts big blind $400
*** HOLE CARDS ***
Dealt to TurnOnTuneInDropOut [Kd 3s 8h 7c]
slotmachine: folds
TurnOnTuneInDropOut: folds
soundfsilenz: folds
Aksxone: folds
kimjongun: folds
Uncalled bet ($200) returned to ag2703
ag2703 collected $400 from pot
ag2703: doesn't show hand
*** SUMMARY ***
Total pot $400 | Rake $0
Seat 1: soundfsilenz folded before Flop (didn't bet)
Seat 2: Aksxone (button) folded before Flop (didn't bet)
Seat 3: kimjongun (small blind) folded before Flop
Seat 4: ag2703 (big blind) collected ($400)
Seat 5: slotmachine folded before Flop (didn't bet)
Seat 6: TurnOnTuneInDropOut folded before Flop (didn't bet)

PokerStars Hand #228844232: Omaha Pot Limit ($200/$400 USD) - 2020/10/23 13:35:43 ET
Table 'ADA409467368' 6-max Seat #3 is the button
Seat 1: soundfsilenz ($28969 in chips)
Seat 2: Aksxone ($17108 in chips)
Seat 3: kimjongun ($60600 in chips)
Seat 4: ag2703 ($56041 in chips)
Seat 5: slotmachine ($79786 in chips)
Seat 6: TurnOnTuneInDropOut ($28000 in chips)
ag2703: posts small blind $200
slotmachine: posts big blind $400
*** HOLE CARDS ***
Dealt to TurnOnTuneInDropOut [9h 4d 2d 7c]
TurnOnTuneInDropOut: folds
soundfsilenz: raises $1000 to $1400
Aksxone: calls $1400
kimjongun: folds
ag2703: folds
slotmachine: folds
*** FLOP *** [Tc Qc 2s]
soundfsilenz: bets $2278
Aksxone: folds
Uncalled bet ($2278) returned to soundfsilenz
soundfsilenz collected $3264 from pot
soundfsilenz: doesn't show hand
*** SUMMARY ***
Total pot $3400 | Rake $136
Board [Tc Qc 2s]
Seat 1: soundfsilenz collected ($3264)
Seat 2: Aksxone folded on the Flop
Seat 3: kimjongun (button) folded before Flop (didn't bet)
Seat 4: ag2703 (small blind) folded before Flop
Seat 5: slotmachine (big blind) folded before Flop
Seat 6: TurnOnTuneInDropOut folded before Flop (didn't bet)

PokerStars Hand #228844233: Omaha Pot Limit ($200/$400 USD) - 2020/10/23 13:36:22 ET
Table 'ADA409467368' 6-max Seat #4 is the button
Seat 1: soundfsilenz ($30833 in chips)
Seat 2: Aksxone ($15708 in chips)
Seat 3: kimjongun ($60600 in chips)
Seat 4: ag2703 ($55841 in chips)
Seat 5: slotmachine ($79386 in chips)
Seat 6: TurnOnTuneInDropOut ($28000 in chips)
slotmachine: posts small blind $200
TurnOnTuneInDropOut: posts big blind $400
*** HOLE CARDS ***
Dealt to TurnOnTuneInDropOut [Qs Jc 3d Ad]
soundfsilenz: folds
Aksxone: raises $1000 to $1400
kimjongun: folds
ag2703: folds
slotmachine: folds
TurnOnTuneInDropOut: calls $1000
*** FLOP *** [7h 7s Kd]
TurnOnTuneInDropOut: checks
Aksxone: checks
*** TURN *** [7h 7s Kd] [3c]
TurnOnTuneInDropOut: checks
Aksxone: checks
*** RIVER *** [7h 7s Kd 3c] [Qc]
TurnOnTuneInDropOut: checks
Aksxone: bets $3000
TurnOnTuneInDropOut: calls $3000
*** SHOW DOWN ***
TurnOnTuneInDropOut: shows [Qs Jc 3d Ad]
Aksxone: mucks hand
TurnOnTuneInDropOut collected $8639 from pot
*** SUMMARY ***
Total pot $9000 | Rake $361
Board [7h 7s Kd 3c Qc]
Seat 1: soundfsilenz folded before Flop (didn't bet)
Seat 2: Aksxone mucked
Seat 3: kimjongun folded before Flop (didn't bet)
Seat 4: ag2703 (button) folded before Flop (didn't bet)
Seat 5: slotmachine (small blind) folded before Flop
Seat 6: TurnOnTuneInDropOut (big blind) showed [Qs Jc 3d Ad] and won ($8639)

PokerStars Hand #228844235: Omaha Pot Limit ($200/$400 USD) - 2020/10/23 13:38:20 ET
Table 'ADA409467368' 6-max Seat #6 is the button
Seat 1: soundfsilenz ($42434 in chips)
Seat 2: Aksxone ($10908 in chips)
Seat 3: kimjongun ($60600 in chips)
Seat 4: ag2703 ($55841 in chips)
Seat 5: slotmachine ($80186 in chips)
Seat 6: TurnOnTuneInDropOut ($32039 in chips)
soundfsilenz: posts small blind $200
Aksxone: posts big blind $400
*** HOLE CARDS ***
Dealt to TurnOnTuneInDropOut [Qh 6h 2c Jh]
kimjongun: folds
ag2703: raises $400 to $800
slotmachine: raises $2200 to $3000
TurnOnTuneInDropOut: folds
soundfsilenz: folds
Aksxone: calls $2600
ag2703: calls $2200
*** FLOP *** [Qs Qc As]
Aksxone: checks
ag2703: checks
slotmachine: checks
*** TURN *** [Qs Qc As] [Jd]
Aksxone: bets $4600
ag2703: folds
slotmachine: folds
Uncalled bet ($4600) returned to Aksxone
Aksxone collected $8831 from pot
Aksxone: doesn't show hand
*** SUMMARY ***
Total pot $9200 | Rake $369
Board [Qs Qc As Jd]
Seat 1: soundfsilenz (small blind) folded before Flop
Seat 2: Aksxone (big blind) collected ($8831)
Seat 3: kimjongun folded before Flop (didn't bet)
Seat 4: ag2703 folded on the Turn
Seat 5: slotmachine folded on the Turn
Seat 6: TurnOnTuneInDropOut (button) folded before Flop (didn't bet)

PokerStars Hand #228844236: Omaha Pot Limit ($200/$400 USD) - 2020/10/23 13:39:53 ET
Table 'ADA409467368' 6-max Seat #1 is the button
Seat 1: soundfsilenz ($42234 in chips)
Seat 2: Aksxone ($16739 in chips)
Seat 3: kimjongun ($60600 in chips)
Seat 4: ag2703 ($52841 in chips)
Seat 5: slotmachine ($77186 in chips)
Seat 6: TurnOnTuneInDropOut ($32039 in chips)
Aksxone: posts small blind $200
kimjongun: posts big blind $400
*** HOLE CARDS ***
Dealt to TurnOnTuneInDropOut [3d 7c 2c 7h]
ag2703: folds
slotmachine: raises $1000 to $1400
TurnOnTuneInDropOut: folds
soundfsilenz: calls $1400
Aksxone: raises $4600 to $6000
kimjongun: folds
slotmachine: raises $13800 to $19800
soundfsilenz: folds
Aksxone: calls $10739 and is all-in
Uncalled bet ($3061) returned to slotmachine
*** FLOP *** [3h Js 2d]
*** TURN *** [3h Js 2d] [5c]
*** RIVER *** [3h Js 2d 5c] [Ts]
*** SHOW DOWN ***
Aksxone: shows [Kh Qc As Kd]
slotmachine: shows [Ah 5d 6s 9h]
Aksxone collected $34478 from pot
*** SUMMARY ***
Total pot $35278 | Rake $800
Board [3h Js 2d 5c Ts]
Seat 1: soundfsilenz (button) folded before Flop
Seat 2: Aksxone (small blind) showed [Kh Qc As Kd] and won ($34478)
Seat 3: kimjongun (big blind) folded before Flop
Seat 4: ag2703 folded before Flop (didn't bet)
Seat 5: slotmachine showed [Ah 5d 6s 9h] and lost
Seat 6: TurnOnTuneInDropOut folded before Flop (didn't bet)

PokerStars Hand #228844237: Omaha Pot Limit ($200/$400 USD) - 2020/10/23 13:40:39 ET
Table 'ADA409467368' 6-max Seat #2 is the button
Seat 1: soundfsilenz ($40834 in chips)
Seat 2: Aksxone ($34478 in chips)
Seat 3: kimjongun ($60200 in chips)
Seat 4: ag2703 ($52841 in chips)
Seat 5: slotmachine ($60447 in chips)
Seat 6: TurnOnTuneInDropOut ($32039 in chips)
kimjongun: posts small blind $200
ag2703: posts big blind $400
*** HOLE CARDS ***
Dealt to TurnOnTuneInDropOut [6d Kc 8s 4h]
slotmachine: folds
TurnOnTuneInDropOut: folds
soundfsilenz: raises $1000 to $1400
Aksxone: calls $1400
kimjongun: folds
ag2703: calls $1000
*** FLOP *** [4s 3s Qh]
ag2703: checks
soundfsilenz: checks
Aksxone: checks
*** TURN *** [4s 3s Qh] [5d]
ag2703: checks
soundfsilenz: bets $2948
Aksxone: calls $2948
ag2703: folds
*** RIVER *** [4s 3s Qh 5d] [Jd]
soundfsilenz: bets $6899
Aksxone: calls $6899
*** SHOW DOWN ***
soundfsilenz: mucks hand
Aksxone: shows [2d 2h Ah Jh]
Aksxone collected $23294 from pot
*** SUMMARY ***
Total pot $24094 | Rake $800
Board [4s 3s Qh 5d Jd]
Seat 1: soundfsilenz mucked
Seat 2: Aksxone (button) showed [2d 2h Ah Jh] and won ($23294)
Seat 3: kimjongun (small blind) folded before Flop
Seat 4: ag2703 (big blind) folded on the Turn
Seat 5: slotmachine folded before Flop (didn't bet)
Seat 6: TurnOnTuneInDropOut folded before Flop (didn't bet)

PokerStars Hand #228844238: Omaha Pot Limit ($200/$400 USD) - 2020/10/23 13:42:02 ET
Table 'ADA409467368' 6-max Seat #3 is the button
Seat 1: soundfsilenz ($29587 in chips)
Seat 2: Aksxone ($46525 in chips)
Seat 3: kimjongun ($60000 in chips)
Seat 4: ag2703 ($51441 in chips)
Seat 5: slotmachine ($60447 in chips)
Seat 6: TurnOnTuneInDropOut ($32039 in chips)
ag2703: posts small blind $200
slotmachine: posts big blind $400
*** HOLE CARDS ***
Dealt to TurnOnTuneInDropOut [2h Jh 4s 5h]
TurnOnTuneInDropOut: folds
soundfsilenz: folds
Aksxone: calls $400
kimjongun: folds
ag2703: folds
slotmachine: checks
*** FLOP *** [Ah 5d 7h]
slotmachine: checks
Aksxone: bets $750
slotmachine: folds
Uncalled bet ($750) returned to Aksxone
Aksxone collected $960 from pot
Aksxone: doesn't show hand
*** SUMMARY ***
Total pot $1000 | Rake $40
Board [Ah 5d 7h]
Seat 1: soundfsilenz folded before Flop (didn't bet)
Seat 2: Aksxone collected ($960)
Seat 3: kimjongun (button) folded before Flop (didn't bet)
Seat 4: ag2703 (small blind) folded before Flop
Seat 5: slotmachine (big blind) folded on the Flop
Seat 6: TurnOnTuneInDropOut folded before Flop (didn't bet)

PokerStars Hand #228844241: Omaha Pot Limit ($200/$400 USD) - 2020/10/23 13:45:38 ET
Table 'ADA409467368' 6-max Seat #6 is the button
Seat 1: soundfsilenz ($41188 in chips)
Seat 2: Aksxone ($37535 in chips)
Seat 3: kimjongun ($59600 in chips)
Seat 4: ag2703 ($61561 in chips)
Seat 5: slotmachine ($59847 in chips)
Seat 6: TurnOnTuneInDropOut ($31439 in chips)
soundfsilenz: posts small blind $200
Aksxone: posts big blind $400
*** HOLE CARDS ***
Dealt to TurnOnTuneInDropOut [Jh 5d 6s 4c]
kimjongun: folds
ag2703: raises $400 to $800
slotmachine: folds
TurnOnTuneInDropOut: folds
soundfsilenz: folds
Aksxone: raises $800 to $1600
ag2703: calls $800
*** FLOP *** [9c 8c 6h]
Aksxone: checks
ag2703: bets $3400
Aksxone: folds
Uncalled bet ($3400) returned to ag2703
ag2703 collected $3264 from pot
ag2703: doesn't show hand
*** SUMMARY ***
Total pot $3400 | Rake $136
Board [9c 8c 6h]
Seat 1: soundfsilenz (small blind) folded before Flop
Seat 2: Aksxone (big blind) folded on the Flop
Seat 3: kimjongun folded before Flop (didn't bet)
Seat 4: ag2703 collected ($3264)
Seat 5: slotmachine folded before Flop (didn't bet)
Seat 6: TurnOnTuneInDropOut (button) folded before Flop (didn't bet)

PokerStars Hand #228844242: Omaha Pot Limit ($200/$400 USD) - 2020/10/23 13:47:02 ET
Table 'ADA409467368' 6-max Seat #1 is the button
Seat 1: soundfsilenz ($40988 in chips)
Seat 2: Aksxone ($35935 in chips)
Seat 3: kimjongun ($59600 in chips)
Seat 4: ag2703 ($63225 in chips)
Seat 5: slotmachine ($59847 in chips)
Seat 6: TurnOnTuneInDropOut ($31439 in chips)
Aksxone: posts small blind $200
kimjongun: posts big blind $400
*** HOLE CARDS ***
Dealt to TurnOnTuneInDropOut [Qh 9h 8h 5c]
ag2703: folds
slotmachine: folds
TurnOnTuneInDropOut: folds
soundfsilenz: folds
Aksxone: calls $200
kimjongun: checks
*** FLOP *** [2c Kd Ks]
Aksxone: checks
kimjongun: checks
*** TURN *** [2c Kd Ks] [Kc]
Aksxone: bets $800
kimjongun: folds
Uncalled bet ($800) returned to Aksxone
Aksxone collected $768 from pot
Aksxone: doesn't show hand
*** SUMMARY ***
Total pot $800 | Rake $32
Board [2c Kd Ks Kc]
Seat 1: soundfsilenz (button) folded before Flop (didn't bet)
Seat 2: Aksxone (small blind) collected ($768)
Seat 3: kimjongun (big blind) folded on the Turn
Seat 4: ag2703 folded before Flop (didn't bet)
Seat 5: slotmachine folded before Flop (didn't bet)
Seat 6: TurnOnTuneInDropOut folded before Flop (didn't bet)

PokerStars Hand #228844243: Omaha Pot Limit ($200/$400 USD) - 2020/10/23 13:47:47 ET
Table 'ADA409467368' 6-max Seat #2 is the button
Seat 1: soundfsilenz ($40988 in chips)
Seat 2: Aksxone ($36303 in chips)
Seat 3: kimjongun ($59200 in chips)
Seat 4: ag2703 ($63225 in chips)
Seat 5: slotmachine ($59847 in chips)
Seat 6: TurnOnTuneInDropOut ($31439 in chips)
kimjongun: posts small blind $200
ag2703: posts big blind $400
*** HOLE CARDS ***
Dealt to TurnOnTuneInDropOut [3s 2d 7c Qs]
slotmachine: raises $1000 to $1400
TurnOnTuneInDropOut: folds
soundfsilenz: folds
Aksxone: calls $1400
kimjongun: folds
ag2703: calls $1000
*** FLOP *** [Js 5d Th]
ag2703: bets $4400
slotmachine: folds
Aksxone: raises $13200 to $17600
ag2703: raises $39600 to $57200
Aksxone: calls $17303 and is all-in
Uncalled bet ($22297) returned to ag2703
*** TURN *** [Js 5d Th] [4c]
*** RIVER *** [Js 5d Th 4c] [8s]
*** SHOW DOWN ***
ag2703: shows [7s Qd Jd Jc]
Aksxone: shows [4s 9s Jh Ts]
ag2703 collected $73406 from pot
*** SUMMARY ***
Total pot $74206 | Rake $800
Board [Js 5d Th 4c 8s]
Seat 1: soundfsilenz folded before Flop (didn't bet)
Seat 2: Aksxone (button) showed [4s 9s Jh Ts] and lost
Seat 3: kimjongun (small blind) folded before Flop
Seat 4: ag2703 (big blind) showed [7s Qd Jd Jc] and won ($73406)
Seat 5: slotmachine folded on the Flop
Seat 6: TurnOnTuneInDropOut folded before Flop (didn't bet)

PokerStars Hand #228844244: Omaha Pot Limit ($200/$400 USD) - 2020/10/23 13:49:13 ET
Table 'ADA409467368' 6-max Seat #3 is the button
Seat 1: soundfsilenz ($40988 in chips)
Seat 3: kimjongun ($59000 in chips)
Seat 4: ag2703 ($100328 in chips)
Seat 5: slotmachine ($58447 in chips)
Seat 6: TurnOnTuneInDropOut ($31439 in chips)
ag2703: posts small blind $200
slotmachine: posts big blind $400
*** HOLE CARDS ***
Dealt to TurnOnTuneInDropOut [9h Th 7s Ts]
TurnOnTuneInDropOut: raises $1000 to $1400
soundfsilenz: folds
kimjongun: folds
ag2703: folds
slotmachine: folds
Uncalled bet ($1000) returned to TurnOnTuneInDropOut
TurnOnTuneInDropOut collected $1000 from pot
TurnOnTuneInDropOut: doesn't show hand
*** SUMMARY ***
Total pot $1000 | Rake $0
Seat 1: soundfsilenz folded before Flop (didn't bet)
Seat 3: kimjongun (button) folded before Flop (didn't bet)
Seat 4: ag2703 (small blind) folded before Flop
Seat 5: slotmachine (big blind) folded before Flop
Seat 6: TurnOnTuneInDropOut collected ($1000)

PokerStars Hand #228844245: Omaha Pot Limit ($200/$400 USD) - 2020/10/23 13:49:39 ET
Table 'ADA409467368' 6-max Seat #4 is the button
Seat 1: soundfsilenz ($40988 in chips)
Seat 3: kimjongun ($59000 in chips)
Seat 4: ag2703 ($100128 in chips)
Seat 5: slotmachine ($58047 in chips)
Seat 6: TurnOnTuneInDropOut ($32039 in chips)
slotmachine: posts small blind $200
TurnOnTuneInDropOut: posts big blind $400
*** HOLE CARDS ***
Dealt to TurnOnTuneInDropOut [9d Qh Js 7h]
soundfsilenz: folds
kimjongun: folds
ag2703: raises $1000 to $1400
slotmachine: folds
TurnOnTuneInDropOut: calls $1000
*** FLOP *** [8d Kc 9s]
TurnOnTuneInDropOut: checks
ag2703: bets $3000
TurnOnTuneInDropOut: calls $3000
*** TURN *** [8d Kc 9s] [Kh]
TurnOnTuneInDropOut: checks
ag2703: checks
*** RIVER *** [8d Kc 9s Kh] [Ac]
TurnOnTuneInDropOut: checks
ag2703: bets $9000
TurnOnTuneInDropOut: folds
Uncalled bet ($9000) returned to ag2703
ag2703 collected $8639 from pot
ag2703: doesn't show hand
*** SUMMARY ***
Total pot $9000 | Rake $361
Board [8d Kc 9s Kh Ac]
Seat 1: soundfsilenz folded before Flop (didn't bet)
Seat 3: kimjongun folded before Flop (didn't bet)
Seat 4: ag2703 (button) collected ($8639)
Seat 5: slotmachine (small blind) folded before Flop
Seat 6: TurnOnTuneInDropOut (big blind) folded on the River

PokerStars Hand #228844248: Omaha Pot Limit ($200/$400 USD) - 2020/10/23 13:52:54 ET
Table 'ADA409467368' 6-max Seat #1 is the button
Seat 1: soundfsilenz ($41348 in chips)
Seat 2: Aksxone ($18426 in chips)
Seat 3: kimjongun ($64015 in chips)
Seat 4: ag2703 ($100167 in chips)
Seat 5: slotmachine ($57847 in chips)
Seat 6: TurnOnTuneInDropOut ($27439 in chips)
Aksxone: posts small blind $200
kimjongun: posts big blind $400
*** HOLE CARDS ***
Dealt to TurnOnTuneInDropOut [3c 7d 8d Ah]
ag2703: raises $400 to $800
slotmachine: folds
TurnOnTuneInDropOut: folds
soundfsilenz: folds
Aksxone: raises $2000 to $2800
kimjongun: folds
ag2703: calls $2000
*** FLOP *** [3h Td 6c]
Aksxone: bets $6000
ag2703: folds
Uncalled bet ($6000) returned to Aksxone
Aksxone collected $5759 from pot
Aksxone: doesn't show hand
*** SUMMARY ***
Total pot $6000 | Rake $241
Board [3h Td 6c]
Seat 1: soundfsilenz (button) folded before Flop (didn't bet)
Seat 2: Aksxone (small blind) collected ($5759)
Seat 3: kimjongun (big blind) folded before Flop
Seat 4: ag2703 folded on the Flop
Seat 5: slotmachine folded before Flop (didn't bet)
Seat 6: TurnOnTuneInDropOut folded before Flop (didn't bet)

PokerStars Hand #228844249: Omaha Pot Limit ($200/$400 USD) - 2020/10/23 13:53:34 ET
Table 'ADA409467368' 6-max Seat #2 is the button
Seat 1: soundfsilenz ($41348 in chips)
Seat 2: Aksxone ($21385 in chips)
Seat 3: kimjongun ($63615 in chips)
Seat 4: ag2703 ($97367 in chips)
Seat 5: slotmachine ($57847 in chips)
Seat 6: TurnOnTuneInDropOut ($27439 in chips)
kimjongun: posts small blind $200
ag2703: posts big blind $400
*** HOLE CARDS ***
Dealt to TurnOnTuneInDropOut [4c 5d 3d 2d]
slotmachine: folds
TurnOnTuneInDropOut: folds
soundfsilenz: folds
Aksxone: raises $1000 to $1400
kimjongun: folds
ag2703: calls $1000
*** FLOP *** [7c 6d 5h]
ag2703: checks
Aksxone: checks
*** TURN *** [7c 6d 5h] [Qc]
ag2703: checks
Aksxone: bets $3000
ag2703: folds
Uncalled bet ($3000) returned to Aksxone
Aksxone collected $2880 from pot
Aksxone: doesn't show hand
*** SUMMARY ***
Total pot $3000 | Rake $120
Board [7c 6d 5h Qc]
Seat 1: soundfsilenz folded before Flop (didn't bet)
Seat 2: Aksxone (button) collected ($2880)
Seat 3: kimjongun (small blind) folded before Flop
Seat 4: ag2703 (big blind) folded on the Turn
Seat 5: slotmachine folded before Flop (didn't bet)
Seat 6: TurnOnTuneInDropOut folded before Flop (didn't bet)

PokerStars Hand #228844250: Omaha Pot Limit ($200/$400 USD) - 2020/10/23 13:54:55 ET
Table 'ADA409467368' 6-max Seat #3 is the button
Seat 1: soundfsilenz ($41348 in chips)
Seat 2: Aksxone ($22865 in chips)
Seat 3: kimjongun ($63415 in chips)
Seat 4: ag2703 ($95967 in chips)
Seat 5: slotmachine ($57847 in chips)
Seat 6: TurnOnTuneInDropOut ($27439 in chips)
ag2703: posts small blind $200
slotmachine: posts big blind $400
*** HOLE CARDS ***
Dealt to TurnOnTuneInDropOut [5d 5s 8d 2h]
TurnOnTuneInDropOut: folds
soundfsilenz: folds
Aksxone: calls $400
kimjongun: raises $1400 to $1800
ag2703: calls $1600
slotmachine: calls $1400
Aksxone: calls $1400
*** FLOP *** [Td Jh 4s]
ag2703: bets $7200
slotmachine: folds
Aksxone: raises $13865 to $21065 and is all-in
kimjongun: folds
ag2703: calls $13865
*** TURN *** [Td Jh 4s] [Qc]
*** RIVER *** [Td Jh 4s Qc] [Ks]
*** SHOW DOWN ***
ag2703: shows [9c Ac Ts Js]
Aksxone: shows [Qh 8h 4d Tc]
ag2703 collected $48530 from pot
*** SUMMARY ***
Total pot $49330 | Rake $800
Board [Td Jh 4s Qc Ks]
Seat 1: soundfsilenz folded before Flop (didn't bet)
Seat 2: Aksxone showed [Qh 8h 4d Tc] and lost
Seat 3: kimjongun (button) folded on the Flop
Seat 4: ag2703 (small blind) showed [9c Ac Ts Js] and won ($48530)
Seat 5: slotmachine (big blind) folded on the Flop
Seat 6: TurnOnTuneInDropOut folded before Flop (didn't bet)

PokerStars Hand #228844251: Omaha Pot Limit ($200/$400 USD) - 2020/10/23 13:56:14 ET
Table 'ADA409467368' 6-max Seat #4 is the button
Seat 1: soundfsilenz ($41348 in chips)
Seat 3: kimjongun ($61615 in chips)
Seat 4: ag2703 ($121632 in chips)
Seat 5: slotmachine ($56047 in chips)
Seat 6: TurnOnTuneInDropOut ($27439 in chips)
slotmachine: posts small blind $200
TurnOnTuneInDropOut: posts big blind $400
*** HOLE CARDS ***
Dealt to TurnOnTuneInDropOut [Ad Td 7d 8s]
soundfsilenz: folds
kimjongun: folds
ag2703: raises $1000 to $1400
slotmachine: folds
TurnOnTuneInDropOut: calls $1000
*** FLOP *** [4s 5s Kh]
TurnOnTuneInDropOut: checks
ag2703: bets $3000
TurnOnTuneInDropOut: folds
Uncalled bet ($3000) returned to ag2703
ag2703 collected $2880 from pot
ag2703: doesn't show hand
*** SUMMARY ***
Total pot $3000 | Rake $120
Board [4s 5s Kh]
Seat 1: soundfsilenz folded before Flop (didn't bet)
Seat 3: kimjongun folded before Flop (didn't bet)
Seat 4: ag2703 (button) collected ($2880)
Seat 5: slotmachine (small blind) folded before Flop
Seat 6: TurnOnTuneInDropOut (big blind) folded on the Flop

PokerStars Hand #228844252: Omaha Pot Limit ($200/$400 USD) - 2020/10/23 13:56:51 ET
Table 'ADA409467368' 6-max Seat #5 is the button
Seat 1: soundfsilenz ($41348 in chips)
Seat 3: kimjongun ($61615 in chips)
Seat 4: ag2703 ($123112 in chips)
Seat 5: slotmachine ($55847 in chips)
Seat 6: TurnOnTuneInDropOut ($26039 in chips)
TurnOnTuneInDropOut: posts small blind $200
soundfsilenz: posts big blind $400
*** HOLE CARDS ***
Dealt to TurnOnTuneInDropOut [8d Kd 9s Kc]
kimjongun: folds
ag2703: folds
slotmachine: folds
TurnOnTuneInDropOut: raises $800 to $1200
soundfsilenz: calls $800
*** FLOP *** [Tc 2h 6h]
TurnOnTuneInDropOut: checks
soundfsilenz: checks
*** TURN *** [Tc 2h 6h] [9c]
TurnOnTuneInDropOut: checks
soundfsilenz: checks
*** RIVER *** [Tc 2h 6h 9c] [Qd]
TurnOnTuneInDropOut: checks
soundfsilenz: checks
*** SHOW DOWN ***
TurnOnTuneInDropOut: shows [8d Kd 9s Kc]
soundfsilenz: mucks hand
TurnOnTuneInDropOut collected $2304 from pot
*** SUMMARY ***
Total pot $2400 | Rake $96
Board [Tc 2h 6h 9c Qd]
Seat 1: soundfsilenz (big blind) mucked
Seat 3: kimjongun folded before Flop (didn't bet)
Seat 4: ag2703 folded before Flop (didn't bet)
Seat 5: slotmachine (button) folded before Flop (didn't bet)
Seat 6: TurnOnTuneInDropOut (small blind) showed [8d Kd 9s Kc] and won ($2304)

PokerStars Hand #228844255: Omaha Pot Limit ($200/$400 USD) - 2020/10/23 13:59:56 ET
Table 'ADA409467368' 6-max Seat #2 is the button
Seat 1: soundfsilenz ($35948 in chips)
Seat 2: Aksxone ($24612 in chips)
Seat 3: kimjongun ($61215 in chips)
Seat 4: ag2703 ($122312 in chips)
Seat 5: slotmachine ($55847 in chips)
Seat 6: TurnOnTuneInDropOut ($27143 in chips)
kimjongun: posts small blind $200
ag2703: posts big blind $400
*** HOLE CARDS ***
Dealt to TurnOnTuneInDropOut [Jd Js Kd 9h]
slotmachine: folds
TurnOnTuneInDropOut: raises $1000 to $1400
soundfsilenz: folds
Aksxone: calls $1400
kimjongun: folds
ag2703: folds
*** FLOP *** [Ks 8h Th]
TurnOnTuneInDropOut: checks
Aksxone: bets $3400
TurnOnTuneInDropOut: calls $3400
*** TURN *** [Ks 8h Th] [3s]
TurnOnTuneInDropOut: checks
Aksxone: checks
*** RIVER *** [Ks 8h Th 3s] [6h]
TurnOnTuneInDropOut: checks
Aksxone: bets $3200
TurnOnTuneInDropOut: folds
Uncalled bet ($3200) returned to Aksxone
Aksxone collected $9791 from pot
Aksxone: doesn't show hand
*** SUMMARY ***
Total pot $10200 | Rake $409
Board [Ks 8h Th 3s 6h]
Seat 1: soundfsilenz folded before Flop (didn't bet)
Seat 2: Aksxone (button) collected ($9791)
Seat 3: kimjongun (small blind) folded before Flop
Seat 4: ag2703 (big blind) folded before Flop
Seat 5: slotmachine folded before Flop (didn't bet)
Seat 6: TurnOnTuneInDropOut folded on the River

PokerStars Hand #228844256: Omaha Pot Limit ($200/$400 USD) - 2020/10/23 14:01:56 ET
Table 'ADA409467368' 6-max Seat #3 is the button
Seat 1: soundfsilenz ($35948 in chips)
Seat 2: Aksxone ($29603 in chips)
Seat 3: kimjongun ($61015 in chips)
Seat 4: ag2703 ($121912 in chips)
Seat 5: slotmachine ($55847 in chips)
Seat 6: TurnOnTuneInDropOut ($22343 in chips)
ag2703: posts small blind $200
slotmachine: posts big blind $400
*** HOLE CARDS ***
Dealt to TurnOnTuneInDropOut [9h Js Ts 8d]
TurnOnTuneInDropOut: raises $1000 to $1400
soundfsilenz: folds
Aksxone: calls $1400
kimjongun: folds
ag2703: folds
slotmachine: folds
*** FLOP *** [Tc As 4c]
TurnOnTuneInDropOut: checks
Aksxone: bets $3400
TurnOnTuneInDropOut: folds
Uncalled bet ($3400) returned to Aksxone
Aksxone collected $3264 from pot
Aksxone: doesn't show hand
*** SUMMARY ***
Total pot $3400 | Rake $136
Board [Tc As 4c]
Seat 1: soundfsilenz folded before Flop (didn't bet)
Seat 2: Aksxone collected ($3264)
Seat 3: kimjongun (button) folded before Flop (didn't bet)
Seat 4: ag2703 (small blind) folded before Flop
Seat 5: slotmachine (big blind) folded before Flop
Seat 6: TurnOnTuneInDropOut folded on the Flop

PokerStars Hand #228844259: Omaha Pot Limit ($200/$400 USD) - 2020/10/23 14:05:02 ET
Table 'ADA409467368' 6-max Seat #6 is the button
Seat 1: soundfsilenz ($35548 in chips)
Seat 2: Aksxone ($35626 in chips)
Seat 3: kimjongun ($59215 in chips)
Seat 4: ag2703 ($119912 in chips)
Seat 5: slotmachine ($55247 in chips)
Seat 6: TurnOnTuneInDropOut ($33163 in chips)
soundfsilenz: posts small blind $200
Aksxone: posts big blind $400
*** HOLE CARDS ***
Dealt to TurnOnTuneInDropOut [6d Jd 7c 3h]
kimjongun: folds
ag2703: raises $1000 to $1400
slotmachine: folds
TurnOnTuneInDropOut: folds
soundfsilenz: folds
Aksxone: calls $1000
*** FLOP *** [5d 2s Kc]
Aksxone: checks
ag2703: bets $3000
Aksxone: calls $3000
*** TURN *** [5d 2s Kc] [7d]
Aksxone: checks
ag2703: checks
*** RIVER *** [5d 2s Kc 7d] [4c]
Aksxone: checks
ag2703: checks
*** SHOW DOWN ***
Aksxone: mucks hand
ag2703: shows [Ah Td Ac 9h]
ag2703 collected $8639 from pot
*** SUMMARY ***
Total pot $9000 | Rake $361
Board [5d 2s Kc 7d 4c]
Seat 1: soundfsilenz (small blind) folded before Flop
Seat 2: Aksxone (big blind) mucked
Seat 3: kimjongun folded before Flop (didn't bet)
Seat 4: ag2703 showed [Ah Td Ac 9h] and won ($8639)
Seat 5: slotmachine folded before Flop (didn't bet)
Seat 6: TurnOnTuneInDropOut (button) folded before Flop (didn't bet)

PokerStars Hand #228844261: Omaha Pot Limit ($200/$400 USD) - 2020/10/23 14:06:43 ET
Table 'ADA409467368' 6-max Seat #2 is the button
Seat 1: soundfsilenz ($35948 in chips)
Seat 2: Aksxone ($31026 in chips)
Seat 3: kimjongun ($58815 in chips)
Seat 4: ag2703 ($124151 in chips)
Seat 5: slotmachine ($55247 in chips)
Seat 6: TurnOnTuneInDropOut ($33163 in chips)
kimjongun: posts small blind $200
ag2703: posts big blind $400
*** HOLE CARDS ***
Dealt to TurnOnTuneInDropOut [As 5d 8h 3h]
slotmachine: folds
TurnOnTuneInDropOut: folds
soundfsilenz: raises $1000 to $1400
Aksxone: folds
kimjongun: folds
ag2703: folds
Uncalled bet ($1000) returned to soundfsilenz
soundfsilenz collected $1000 from pot
soundfsilenz: doesn't show hand
*** SUMMARY ***
Total pot $1000 | Rake $0
Seat 1: soundfsilenz collected ($1000)
Seat 2: Aksxone (button) folded before Flop (didn't bet)
Seat 3: kimjongun (small blind) folded before Flop
Seat 4: ag2703 (big blind) folded before Flop
Seat 5: slotmachine folded before Flop (didn't bet)
Seat 6: TurnOnTuneInDropOut folded before Flop (didn't bet)

PokerStars Hand #228844262: Omaha Pot Limit ($200/$400 USD) - 2020/10/23 14:07:30 ET
Table 'ADA409467368' 6-max Seat #3 is the button
Seat 1: soundfsilenz ($36548 in chips)
Seat 2: Aksxone ($31026 in chips)
Seat 3: kimjongun ($58615 in chips)
Seat 4: ag2703 ($123751 in chips)
Seat 5: slotmachine ($55247 in chips)
Seat 6: TurnOnTuneInDropOut ($33163 in chips)
ag2703: posts small blind $200
slotmachine: posts big blind $400
*** HOLE CARDS ***
Dealt to TurnOnTuneInDropOut [4d Kc 7h 8s]
TurnOnTuneInDropOut: folds
soundfsilenz: folds
Aksxone: folds
kimjongun: raises $1000 to $1400
ag2703: calls $1200
slotmachine: folds
*** FLOP *** [Jh Td 3s]
ag2703: checks
kimjongun: checks
*** TURN *** [Jh Td 3s] [Jc]
ag2703: checks
kimjongun: checks
*** RIVER *** [Jh Td 3s Jc] [6d]
ag2703: checks
kimjongun: bets $2112
ag2703: calls $2112
*** SHOW DOWN ***
ag2703: shows [Qh Qs 5h 2s]
kimjongun: shows [Ac 9d 2h As]
kimjongun collected $7126 from pot
*** SUMMARY ***
Total pot $7424 | Rake $298
Board [Jh Td 3s Jc 6d]
Seat 1: soundfsilenz folded before Flop (didn't bet)
Seat 2: Aksxone folded before Flop (didn't bet)
Seat 3: kimjongun (button) showed [Ac 9d 2h As] and won ($7126)
Seat 4: ag2703 (small blind) showed [Qh Qs 5h 2s] and lost
Seat 5: slotmachine (big blind) folded before Flop
Seat 6: TurnOnTuneInDropOut folded before Flop (didn't bet)

PokerStars Hand #228844265: Omaha Pot Limit ($200/$400 USD) - 2020/10/23 14:10:19 ET
Table 'ADA409467368' 6-max Seat #6 is the button
Seat 1: soundfsilenz ($36148 in chips)
Seat 2: Aksxone ($31186 in chips)
Seat 3: kimjongun ($62229 in chips)
Seat 4: ag2703 ($121375 in chips)
Seat 5: slotmachine ($54447 in chips)
Seat 6: TurnOnTuneInDropOut ($32563 in chips)
soundfsilenz: posts small blind $200
Aksxone: posts big blind $400
*** HOLE CARDS ***
Dealt to TurnOnTuneInDropOut [2s Tc Ks 3h]
kimjongun: folds
ag2703: folds
slotmachine: raises $1000 to $1400
TurnOnTuneInDropOut: folds
soundfsilenz: folds
Aksxone: calls $1000
*** FLOP *** [Qh Jc Th]
Aksxone: bets $3000
slotmachine: calls $3000
*** TURN *** [Qh Jc Th] [7s]
Aksxone: bets $9000
slotmachine: folds
Uncalled bet ($9000) returned to Aksxone
Aksxone collected $8639 from pot
Aksxone: doesn't show hand
*** SUMMARY ***
Total pot $9000 | Rake $361
Board [Qh Jc Th 7s]
Seat 1: soundfsilenz (small blind) folded before Flop
Seat 2: Aksxone (big blind) collected ($8639)
Seat 3: kimjongun folded before Flop (didn't bet)
Seat 4: ag2703 folded before Flop (didn't bet)
Seat 5: slotmachine folded on the Turn
Seat 6: TurnOnTuneInDropOut (button) folded before Flop (didn't bet)

PokerStars Hand #228844266: Omaha Pot Limit ($200/$400 USD) - 2020/10/23 14:11:09 ET
Table 'ADA409467368' 6-max Seat #1 is the button
Seat 1: soundfsilenz ($35948 in chips)
Seat 2: Aksxone ($35425 in chips)
Seat 3: kimjongun ($62229 in chips)
Seat 4: ag2703 ($121375 in chips)
Seat 5: slotmachine ($50047 in chips)
Seat 6: TurnOnTuneInDropOut ($32563 in chips)
Aksxone: posts small blind $200
kimjongun: posts big blind $400
*** HOLE CARDS ***
Dealt to TurnOnTuneInDropOut [8s Th 2s Qd]
ag2703: folds
slotmachine: raises $1000 to $1400
TurnOnTuneInDropOut: folds
soundfsilenz: folds
Aksxone: calls $1200
kimjongun: raises $4200 to $5600
slotmachine: folds
Aksxone: calls $4200
*** FLOP *** [Qh Jc 8h]
Aksxone: checks
kimjongun: bets $9450
Aksxone: folds
Uncalled bet ($9450) returned to kimjongun
kimjongun collected $12095 from pot
kimjongun: doesn't show hand
*** SUMMARY ***
Total pot $12600 | Rake $505
Board [Qh Jc 8h]
Seat 1: soundfsilenz (button) folded before Flop (didn't bet)
Seat 2: Aksxone (small blind) folded on the Flop
Seat 3: kimjongun (big blind) collected ($12095)
Seat 4: ag2703 folded before Flop (didn't bet)
Seat 5: slotmachine folded before Flop
Seat 6: TurnOnTuneInDropOut folded before Flop (didn't bet)

PokerStars Hand #228844267: Omaha Pot Limit ($200/$400 USD) - 2020/10/23 14:12:32 ET
Table 'ADA409467368' 6-max Seat #2 is the button
Seat 1: soundfsilenz ($35948 in chips)
Seat 2: Aksxone ($29825 in chips)
Seat 3: kimjongun ($68724 in chips)
Seat 4: ag2703 ($121375 in chips)
Seat 5: slotmachine ($48647 in chips)
Seat 6: TurnOnTuneInDropOut ($32563 in chips)
kimjongun: posts small blind $200
ag2703: posts big blind $400
*** HOLE CARDS ***
Dealt to TurnOnTuneInDropOut [6d 8s 2h 8c]
slotmachine: folds
TurnOnTuneInDropOut: folds
soundfsilenz: raises $400 to $800
Aksxone: raises $2200 to $3000
kimjongun: folds
ag2703: calls $2600
soundfsilenz: folds
*** FLOP *** [Kd 2d 5d]
ag2703: checks
Aksxone: bets $7000
ag2703: folds
Uncalled bet ($7000) returned to Aksxone
Aksxone collected $6719 from pot
Aksxone: doesn't show hand
*** SUMMARY ***
Total pot $7000 | Rake $281
Board [Kd 2d 5d]
Seat 1: soundfsilenz folded before Flop
Seat 2: Aksxone (button) collected ($6719)
Seat 3: kimjongun (small blind) folded before Flop
Seat 4: ag2703 (big blind) folded on the Flop
Seat 5: slotmachine folded before Flop (didn't bet)
Seat 6: TurnOnTuneInDropOut folded before Flop (didn't bet)

PokerStars Hand #228844268: Omaha Pot Limit ($200/$400 USD) - 2020/10/23 14:13:37 ET
Table 'ADA409467368' 6-max Seat #3 is the button
Seat 1: soundfsilenz ($35148 in chips)
Seat 2: Aksxone ($33544 in chips)
Seat 3: kimjongun ($68524 in chips)
Seat 4: ag2703 ($118375 in chips)
Seat 5: slotmachine ($48647 in chips)
Seat 6: TurnOnTuneInDropOut ($32563 in chips)
ag2703: posts small blind $200
slotmachine: posts big blind $400
*** HOLE CARDS ***
Dealt to TurnOnTuneInDropOut [9d 4c 6h 9h]
TurnOnTuneInDropOut: folds
soundfsilenz: folds
Aksxone: calls $400
kimjongun: raises $1400 to $1800
ag2703: folds
slotmachine: folds
Aksxone: calls $1400
*** FLOP *** [3c Kh 8d]
Aksxone: checks
kimjongun: checks
*** TURN *** [3c Kh 8d] [Jc]
Aksxone: bets $4200
kimjongun: calls $4200
*** RIVER *** [3c Kh 8d Jc] [7c]
Aksxone: checks
kimjongun: bets $12600
Aksxone: calls $12600
*** SHOW DOWN ***
Aksxone: mucks hand
kimjongun: shows [Ac 4d Tc Qs]
kimjongun collected $37000 from pot
*** SUMMARY ***
Total pot $37800 | Rake $800
Board [3c Kh 8d Jc 7c]
Seat 1: soundfsilenz folded before Flop (didn't bet)
Seat 2: Aksxone mucked
Seat 3: kimjongun (button) showed [Ac 4d Tc Qs] and won ($37000)
Seat 4: ag2703 (small blind) folded before Flop
Seat 5: slotmachine (big blind) folded before Flop
Seat 6: TurnOnTuneInDropOut folded before Flop (didn't bet)

PokerStars Hand #228844269: Omaha Pot Limit ($200/$400 USD) - 2020/10/23 14:15:14 ET
Table 'ADA409467368' 6-max Seat #4 is the button
Seat 1: soundfsilenz ($35148 in chips)
Seat 2: Aksxone ($14944 in chips)
Seat 3: kimjongun ($86924 in chips)
Seat 4: ag2703 ($118175 in chips)
Seat 5: slotmachine ($48247 in chips)
Seat 6: TurnOnTuneInDropOut ($32563 in chips)
slotmachine: posts small blind $200
TurnOnTuneInDropOut: posts big blind $400
*** HOLE CARDS ***
Dealt to TurnOnTuneInDropOut [8d Ks 2s Jh]
soundfsilenz: folds
Aksxone: folds
kimjongun: folds
ag2703: raises $1000 to $1400
slotmachine: folds
TurnOnTuneInDropOut: folds
Uncalled bet ($1000) returned to ag2703
ag2703 collected $1000 from pot
ag2703: doesn't show hand
*** SUMMARY ***
Total pot $1000 | Rake $0
Seat 1: soundfsilenz folded before Flop (didn't bet)
Seat 2: Aksxone folded before Flop (didn't bet)
Seat 3: kimjongun folded before Flop (didn't bet)
Seat 4: ag2703 (button) collected ($1000)
Seat 5: slotmachine (small blind) folded before Flop
Seat 6: TurnOnTuneInDropOut (big blind) folded before Flop

PokerStars Hand #228844270: Omaha Pot Limit ($200/$400 USD) - 2020/10/23 14:15:35 ET
Table 'ADA409467368' 6-max Seat #5 is the button
Seat 1: soundfsilenz ($35148 in chips)
Seat 2: Aksxone ($14944 in chips)
Seat 3: kimjongun ($86924 in chips)
Seat 4: ag2703 ($118775 in chips)
Seat 5: slotmachine ($48047 in chips)
Seat 6: TurnOnTuneInDropOut ($32163 in chips)
TurnOnTuneInDropOut: posts small blind $200
soundfsilenz: posts big blind $400
*** HOLE CARDS ***
Dealt to TurnOnTuneInDropOut [4h 9c Ad Qs]
Aksxone: folds
kimjongun: raises $600 to $1000
ag2703: folds
slotmachine: folds
TurnOnTuneInDropOut: folds
soundfsilenz: folds
Uncalled bet ($600) returned to kimjongun
kimjongun collected $1000 from pot
kimjongun: doesn't show hand
*** SUMMARY ***
Total pot $1000 | Rake $0
Seat 1: soundfsilenz (big blind) folded before Flop
Seat 2: Aksxone folded before Flop (didn't bet)
Seat 3: kimjongun collected ($1000)
Seat 4: ag2703 folded before Flop (didn't bet)
Seat 5: slotmachine (button) folded before Flop (didn't bet)
Seat 6: TurnOnTuneInDropOut (small blind) folded before Flop

PokerStars Hand #228844272: Omaha Pot Limit ($200/$400 USD) - 2020/10/23 14:17:24 ET
Table 'ADA409467368' 6-max Seat #1 is the button
Seat 1: soundfsilenz ($34548 in chips)
Seat 2: Aksxone ($15872 in chips)
Seat 3: kimjongun ($87524 in chips)
Seat 4: ag2703 ($117975 in chips)
Seat 5: slotmachine ($48047 in chips)
Seat 6: TurnOnTuneInDropOut ($48000 in chips)
Aksxone: posts small blind $200
kimjongun: posts big blind $400
*** HOLE CARDS ***
Dealt to TurnOnTuneInDropOut [5d 7c Ks Jc]
ag2703: folds
slotmachine: folds
TurnOnTuneInDropOut: folds
soundfsilenz: raises $1000 to $1400
Aksxone: calls $1200
kimjongun: folds
*** FLOP *** [As Ad 9h]
Aksxone: checks
soundfsilenz: checks
*** TURN *** [As Ad 9h] [7d]
Aksxone: bets $3200
soundfsilenz: calls $3200
*** RIVER *** [As Ad 9h 7d] [Qs]
Aksxone: bets $9600
soundfsilenz: calls $9600
*** SHOW DOWN ***
Aksxone: shows [Tc 2c Ac 3d]
soundfsilenz: mucks hand
Aksxone collected $28000 from pot
*** SUMMARY ***
Total pot $28800 | Rake $800
Board [As Ad 9h 7d Qs]
Seat 1: soundfsilenz (button) mucked
Seat 2: Aksxone (small blind) showed [Tc 2c Ac 3d] and won ($28000)
Seat 3: kimjongun (big blind) folded before Flop
Seat 4: ag2703 folded before Flop (didn't bet)
Seat 5: slotmachine folded before Flop (didn't bet)
Seat 6: TurnOnTuneInDropOut folded before Flop (didn't bet)

PokerStars Hand #228844273: Omaha Pot Limit ($200/$400 USD) - 2020/10/23 14:19:10 ET
Table 'ADA409467368' 6-max Seat #2 is the button
Seat 1: soundfsilenz ($20348 in chips)
Seat 2: Aksxone ($29672 in chips)
Seat 3: kimjongun ($87124 in chips)
Seat 4: ag2703 ($117975 in chips)
Seat 5: slotmachine ($48047 in chips)
Seat 6: TurnOnTuneInDropOut ($48000 in chips)
kimjongun: posts small blind $200
ag2703: posts big blind $400
*** HOLE CARDS ***
Dealt to TurnOnTuneInDropOut [Qc 6d 2c 3s]
slotmachine: folds
TurnOnTuneInDropOut: folds
soundfsilenz: folds
Aksxone: calls $400
kimjongun: calls $200
ag2703: raises $400 to $800
Aksxone: calls $400
kimjongun: folds
*** FLOP *** [Jc 9h Kd]
ag2703: checks
Aksxone: checks
*** TURN *** [Jc 9h Kd] [9d]
ag2703: checks
Aksxone: checks
*** RIVER *** [Jc 9h Kd 9d] [Qs]
ag2703: checks
Aksxone: bets $2000
ag2703: folds
Uncalled bet ($2000) returned to Aksxone
Aksxone collected $1920 from pot
Aksxone: doesn't show hand
*** SUMMARY ***
Total pot $2000 | Rake $80
Board [Jc 9h Kd 9d Qs]
Seat 1: soundfsilenz folded before Flop (didn't bet)
Seat 2: Aksxone (button) collected ($1920)
Seat 3: kimjongun (small blind) folded before Flop
Seat 4: ag2703 (big blind) folded on the River
Seat 5: slotmachine folded before Flop (didn't bet)
Seat 6: TurnOnTuneInDropOut folded before Flop (didn't bet)

PokerStars Hand #228844274: Omaha Pot Limit ($200/$400 USD) - 2020/10/23 14:20:51 ET
Table 'ADA409467368' 6-max Seat #3 is the button
Seat 1: soundfsilenz ($44349 in chips)
Seat 2: Aksxone ($30792 in chips)
Seat 3: kimjongun ($86724 in chips)
Seat 4: ag2703 ($117175 in chips)
Seat 5: slotmachine ($48047 in chips)
Seat 6: TurnOnTuneInDropOut ($48000 in chips)
ag2703: posts small blind $200
slotmachine: posts big blind $400
*** HOLE CARDS ***
Dealt to TurnOnTuneInDropOut [6h 4d 6c 3s]
TurnOnTuneInDropOut: folds
soundfsilenz: raises $1000 to $1400
Aksxone: calls $1400
kimjongun: folds
ag2703: folds
slotmachine: folds
*** FLOP *** [Kc 9h Ad]
soundfsilenz: bets $2278
Aksxone: folds
Uncalled bet ($2278) returned to soundfsilenz
soundfsilenz collected $3264 from pot
soundfsilenz: doesn't show hand
*** SUMMARY ***
Total pot $3400 | Rake $136
Board [Kc 9h Ad]
Seat 1: soundfsilenz collected ($3264)
Seat 2: Aksxone folded on the Flop
Seat 3: kimjongun (button) folded before Flop (didn't bet)
Seat 4: ag2703 (small blind) folded before Flop
Seat 5: slotmachine (big blind) folded before Flop
Seat 6: TurnOnTuneInDropOut folded before Flop (didn't bet)

PokerStars Hand #228844277: Omaha Pot Limit ($200/$400 USD) - 2020/10/23 14:24:55 ET
Table 'ADA409467368' 6-max Seat #6 is the button
Seat 1: soundfsilenz ($45813 in chips)
Seat 2: Aksxone ($28992 in chips)
Seat 3: kimjongun ($86724 in chips)
Seat 4: ag2703 ($120823 in chips)
Seat 5: slotmachine ($47447 in chips)
Seat 6: TurnOnTuneInDropOut ($44852 in chips)
soundfsilenz: posts small blind $200
Aksxone: posts big blind $400
*** HOLE CARDS ***
Dealt to TurnOnTuneInDropOut [Jc As 4s Ah]
kimjongun: folds
ag2703: folds
slotmachine: folds
TurnOnTuneInDropOut: raises $1000 to $1400
soundfsilenz: folds
Aksxone: folds
Uncalled bet ($1000) returned to TurnOnTuneInDropOut
TurnOnTuneInDropOut collected $1000 from pot
TurnOnTuneInDropOut: doesn't show hand
*** SUMMARY ***
Total pot $1000 | Rake $0
Seat 1: soundfsilenz (small blind) folded before Flop
Seat 2: Aksxone (big blind) folded before Flop
Seat 3: kimjongun folded before Flop (didn't bet)
Seat 4: ag2703 folded before Flop (didn't bet)
Seat 5: slotmachine folded before Flop (didn't bet)
Seat 6: TurnOnTuneInDropOut (button) collected ($1000)

PokerStars Hand #228844278: Omaha Pot Limit ($200/$400 USD) - 2020/10/23 14:25:36 ET
Table 'ADA409467368' 6-max Seat #1 is the button
Seat 1: soundfsilenz ($45613 in chips)
Seat 2: Aksxone ($28592 in chips)
Seat 3: kimjongun ($86724 in chips)
Seat 4: ag2703 ($120823 in chips)
Seat 5: slotmachine ($47447 in chips)
Seat 6: TurnOnTuneInDropOut ($45452 in chips)
Aksxone: posts small blind $200
kimjongun: posts big blind $400
*** HOLE CARDS ***
Dealt to TurnOnTuneInDropOut [Qc 2d 4d Jc]
ag2703: folds
slotmachine: folds
TurnOnTuneInDropOut: folds
soundfsilenz: folds
Aksxone: folds
Uncalled bet ($200) returned to kimjongun
kimjongun collected $400 from pot
kimjongun: doesn't show hand
*** SUMMARY ***
Total pot $400 | Rake $0
Seat 1: soundfsilenz (button) folded before Flop (didn't bet)
Seat 2: Aksxone (small blind) folded before Flop
Seat 3: kimjongun (big blind) collected ($400)
Seat 4: ag2703 folded before Flop (didn't bet)
Seat 5: slotmachine folded before Flop (didn't bet)
Seat 6: TurnOnTuneInDropOut folded before Flop (didn't bet)

PokerStars Hand #228844279: Omaha Pot Limit ($200/$400 USD) - 2020/10/23 14:26:22 ET
Table 'ADA409467368' 6-max Seat #2 is the button
Seat 1: soundfsilenz ($45613 in chips)
Seat 2: Aksxone ($28392 in chips)
Seat 3: kimjongun ($86924 in chips)
Seat 4: ag2703 ($120823 in chips)
Seat 5: slotmachine ($47447 in chips)
Seat 6: TurnOnTuneInDropOut ($45452 in chips)
kimjongun: posts small blind $200
ag2703: posts big blind $400
*** HOLE CARDS ***
Dealt to TurnOnTuneInDropOut [Js 8h Kd 9c]
slotmachine: raises $1000 to $1400
TurnOnTuneInDropOut: folds
soundfsilenz: folds
Aksxone: calls $1400
kimjongun: folds
ag2703: calls $1000
*** FLOP *** [Jd Kh 2h]
ag2703: checks
slotmachine: checks
Aksxone: bets $4400
ag2703: folds
slotmachine: folds
Uncalled bet ($4400) returned to Aksxone
Aksxone collected $4224 from pot
Aksxone: doesn't show hand
*** SUMMARY ***
Total pot $4400 | Rake $176
Board [Jd Kh 2h]
Seat 1: soundfsilenz folded before Flop (didn't bet)
Seat 2: Aksxone (button) collected ($4224)
Seat 3: kimjongun (small blind) folded before Flop
Seat 4: ag2703 (big blind) folded on the Flop
Seat 5: slotmachine folded on the Flop
Seat 6: TurnOnTuneInDropOut folded before Flop (didn't bet)

PokerStars Hand #228844281: Omaha Pot Limit ($200/$400 USD) - 2020/10/23 14:29:39 ET
Table 'ADA409467368' 6-max Seat #5 is the button
Seat 1: soundfsilenz ($45613 in chips)
Seat 2: Aksxone ($25588 in chips)
Seat 4: ag2703 ($130386 in chips)
Seat 5: slotmachine ($40419 in chips)
Seat 6: TurnOnTuneInDropOut ($45052 in chips)
TurnOnTuneInDropOut: posts small blind $200
soundfsilenz: posts big blind $400
*** HOLE CARDS ***
Dealt to TurnOnTuneInDropOut [7c 4h 9h 9s]
Aksxone: raises $1000 to $1400
ag2703: calls $1400
slotmachine: folds
TurnOnTuneInDropOut: folds
soundfsilenz: folds
*** FLOP *** [Kc 8h 7d]
Aksxone: bets $3400
ag2703: calls $3400
*** TURN *** [Kc 8h 7d] [6s]
Aksxone: bets $10200
ag2703: raises $10200 to $20400
Aksxone: raises $388 to $20788 and is all-in
ag2703: calls $388
*** RIVER *** [Kc 8h 7d 6s] [Th]
*** SHOW DOWN ***
Aksxone: shows [6d 5c Ac 8d]
ag2703: shows [7s 7h 9d 6h]
ag2703 collected $50976 from pot
*** SUMMARY ***
Total pot $51776 | Rake $800
Board [Kc 8h 7d 6s Th]
Seat 1: soundfsilenz (big blind) folded before Flop
Seat 2: Aksxone showed [6d 5c Ac 8d] and lost
Seat 4: ag2703 showed [7s 7h 9d 6h] and won ($50976)
Seat 5: slotmachine (button) folded before Flop (didn't bet)
Seat 6: TurnOnTuneInDropOut (small blind) folded before Flop

PokerStars Hand #228844282: Omaha Pot Limit ($200/$400 USD) - 2020/10/23 14:30:38 ET
Table 'ADA409467368' 6-max Seat #6 is the button
Seat 1: soundfsilenz ($45213 in chips)
Seat 3: kimjongun ($86724 in chips)
Seat 4: ag2703 ($155774 in chips)
Seat 5: slotmachine ($40419 in chips)
Seat 6: TurnOnTuneInDropOut ($44852 in chips)
soundfsilenz: posts small blind $200
kimjongun: posts big blind $400
*** HOLE CARDS ***
Dealt to TurnOnTuneInDropOut [5c Kc Kh 3h]
ag2703: folds
slotmachine: folds
TurnOnTuneInDropOut: raises $1000 to $1400
soundfsilenz: folds
kimjongun: folds
Uncalled bet ($1000) returned to TurnOnTuneInDropOut
TurnOnTuneInDropOut collected $1000 from pot
TurnOnTuneInDropOut: doesn't show hand
*** SUMMARY ***
Total pot $1000 | Rake $0
Seat 1: soundfsilenz (small blind) folded before Flop
Seat 3: kimjongun (big blind) folded before Flop
Seat 4: ag2703 folded before Flop (didn't bet)
Seat 5: slotmachine folded before Flop (didn't bet)
Seat 6: TurnOnTuneInDropOut (button) collected ($1000)

PokerStars Hand #228844283: Omaha Pot Limit ($200/$400 USD) - 2020/10/23 14:31:16 ET
Table 'ADA409467368' 6-max Seat #1 is the button
Seat 1: soundfsilenz ($45013 in chips)
Seat 3: kimjongun ($86324 in chips)
Seat 4: ag2703 ($155774 in chips)
Seat 5: slotmachine ($40419 in chips)
Seat 6: TurnOnTuneInDropOut ($45452 in chips)
kimjongun: posts small blind $200
ag2703: posts big blind $400
*** HOLE CARDS ***
Dealt to TurnOnTuneInDropOut [6c 4c 9s 3h]
slotmachine: raises $1000 to $1400
TurnOnTuneInDropOut: folds
soundfsilenz: folds
kimjongun: folds
ag2703: calls $1000
*** FLOP *** [6s 7h 8s]
ag2703: checks
slotmachine: checks
*** TURN *** [6s 7h 8s] [3c]
ag2703: bets $3000
slotmachine: calls $3000
*** RIVER *** [6s 7h 8s 3c] [Kd]
ag2703: bets $9000
slotmachine: folds
Uncalled bet ($9000) returned to ag2703
ag2703 collected $8639 from pot
ag2703: doesn't show hand
*** SUMMARY ***
Total pot $9000 | Rake $361
Board [6s 7h 8s 3c Kd]
Seat 1: soundfsilenz (button) folded before Flop (didn't bet)
Seat 3: kimjongun (small blind) folded before Flop
Seat 4: ag2703 (big blind) collected ($8639)
Seat 5: slotmachine folded on the River
Seat 6: TurnOnTuneInDropOut folded before Flop (didn't bet)

PokerStars Hand #228844284: Omaha Pot Limit ($200/$400 USD) - 2020/10/23 14:32:30 ET
Table 'ADA409467368' 6-max Seat #3 is the button
Seat 1: soundfsilenz ($45013 in chips)
Seat 3: kimjongun ($86124 in chips)
Seat 4: ag2703 ($160013 in chips)
Seat 5: slotmachine ($48000 in chips)
Seat 6: TurnOnTuneInDropOut ($45452 in chips)
ag2703: posts small blind $200
slotmachine: posts big blind $400
*** HOLE CARDS ***
Dealt to TurnOnTuneInDropOut [Kh 2c 7c 3h]
TurnOnTuneInDropOut: folds
soundfsilenz: folds
kimjongun: raises $1000 to $1400
ag2703: folds
slotmachine: calls $1000
*** FLOP *** [7h 3s 9d]
slotmachine: checks
kimjongun: checks
*** TURN *** [7h 3s 9d] [Qd]
slotmachine: checks
kimjongun: bets $3000
slotmachine: folds
Uncalled bet ($3000) returned to kimjongun
kimjongun collected $2880 from pot
kimjongun: doesn't show hand
*** SUMMARY ***
Total pot $3000 | Rake $120
Board [7h 3s 9d Qd]
Seat 1: soundfsilenz folded before Flop (didn't bet)
Seat 3: kimjongun (button) collected ($2880)
Seat 4: ag2703 (small blind) folded before Flop
Seat 5: slotmachine (big blind) folded on the Turn
Seat 6: TurnOnTuneInDropOut folded before Flop (didn't bet)

PokerStars Hand #228844285: Omaha Pot Limit ($200/$400 USD) - 2020/10/23 14:33:16 ET
Table 'ADA409467368' 6-max Seat #4 is the button
Seat 1: soundfsilenz ($45013 in chips)
Seat 3: kimjongun ($87604 in chips)
Seat 4: ag2703 ($159813 in chips)
Seat 5: slotmachine ($46600 in chips)
Seat 6: TurnOnTuneInDropOut ($45452 in chips)
slotmachine: posts small blind $200
TurnOnTuneInDropOut: posts big blind $400
*** HOLE CARDS ***
Dealt to TurnOnTuneInDropOut [5d 9h Qh 6d]
soundfsilenz: raises $1000 to $1400
kimjongun: raises $3400 to $4800
ag2703: folds
slotmachine: folds
TurnOnTuneInDropOut: folds
soundfsilenz: raises $10200 to $15000
kimjongun: calls $10200
*** FLOP *** [Qs Ac Ad]
soundfsilenz: bets $30013 and is all-in
kimjongun: folds
Uncalled bet ($30013) returned to soundfsilenz
soundfsilenz collected $29800 from pot
soundfsilenz: doesn't show hand
*** SUMMARY ***
Total pot $30600 | Rake $800
Board [Qs Ac Ad]
Seat 1: soundfsilenz collected ($29800)
Seat 3: kimjongun folded on the Flop
Seat 4: ag2703 (button) folded before Flop (didn't bet)
Seat 5: slotmachine (small blind) folded before Flop
Seat 6: TurnOnTuneInDropOut (big blind) folded before Flop

PokerStars Hand #228844286: Omaha Pot Limit ($200/$400 USD) - 2020/10/23 14:35:01 ET
Table 'ADA409467368' 6-max Seat #5 is the button
Seat 1: soundfsilenz ($59813 in chips)
Seat 3: kimjongun ($72604 in chips)
Seat 4: ag2703 ($159813 in chips)
Seat 5: slotmachine ($46400 in chips)
Seat 6: TurnOnTuneInDropOut ($45052 in chips)
TurnOnTuneInDropOut: posts small blind $200
soundfsilenz: posts big blind $400
*** HOLE CARDS ***
Dealt to TurnOnTuneInDropOut [Qh 9d Qs 6s]
kimjongun: folds
ag2703: folds
slotmachine: raises $1000 to $1400
TurnOnTuneInDropOut: folds
soundfsilenz: folds
Uncalled bet ($1000) returned to slotmachine
slotmachine collected $1000 from pot
slotmachine: doesn't show hand
*** SUMMARY ***
Total pot $1000 | Rake $0
Seat 1: soundfsilenz (big blind) folded before Flop
Seat 3: kimjongun folded before Flop (didn't bet)
Seat 4: ag2703 folded before Flop (didn't bet)
Seat 5: slotmachine (button) collected ($1000)
Seat 6: TurnOnTuneInDropOut (small blind) folded before Flop

PokerStars Hand #228844287: Omaha Pot Limit ($200/$400 USD) - 2020/10/23 14:35:30 ET
Table 'ADA409467368' 6-max Seat #6 is the button
Seat 1: soundfsilenz ($59413 in chips)
Seat 3: kimjongun ($72604 in chips)
Seat 4: ag2703 ($159813 in chips)
Seat 5: slotmachine ($47000 in chips)
Seat 6: TurnOnTuneInDropOut ($44852 in chips)
soundfsilenz: posts small blind $200
kimjongun: posts big blind $400
*** HOLE CARDS ***
Dealt to TurnOnTuneInDropOut [5s 2s As 6d]
ag2703: raises $1000 to $1400
slotmachine: folds
TurnOnTuneInDropOut: folds
soundfsilenz: folds
kimjongun: folds
Uncalled bet ($1000) returned to ag2703
ag2703 collected $1000 from pot
ag2703: doesn't show hand
*** SUMMARY ***
Total pot $1000 | Rake $0
Seat 1: soundfsilenz (small blind) folded before Flop
Seat 3: kimjongun (big blind) folded before Flop
Seat 4: ag2703 collected ($1000)
Seat 5: slotmachine folded before Flop (didn't bet)
Seat 6: TurnOnTuneInDropOut (button) folded before Flop (didn't bet)

PokerStars Hand #228844288: Omaha Pot Limit ($200/$400 USD) - 2020/10/23 14:36:00 ET
Table 'ADA409467368' 6-max Seat #1 is the button
Seat 1: soundfsilenz ($59213 in chips)
Seat 3: kimjongun ($72204 in chips)
Seat 4: ag2703 ($160413 in chips)
Seat 5: slotmachine ($47000 in chips)
Seat 6: TurnOnTuneInDropOut ($44852 in chips)
kimjongun: posts small blind $200
ag2703: posts big blind $400
*** HOLE CARDS ***
Dealt to TurnOnTuneInDropOut [Jd Qc 3h 7d]
slotmachine: folds
TurnOnTuneInDropOut: folds
soundfsilenz: folds
kimjongun: folds
Uncalled bet ($200) returned to ag2703
ag2703 collected $400 from pot
ag2703: doesn't show hand
*** SUMMARY ***
Total pot $400 | Rake $0
Seat 1: soundfsilenz (button) folded before Flop (didn't bet)
Seat 3: kimjongun (small blind) folded before Flop
Seat 4: ag2703 (big blind) collected ($400)
Seat 5: slotmachine folded before Flop (didn't bet)
Seat 6: TurnOnTuneInDropOut folded before Flop (didn't bet)

PokerStars Hand #228844289: Omaha Pot Limit ($200/$400 USD) - 2020/10/23 14:36:25 ET
Table 'ADA409467368' 6-max Seat #3 is the button
Seat 1: soundfsilenz ($59213 in chips)
Seat 3: kimjongun ($72004 in chips)
Seat 4: ag2703 ($160613 in chips)
Seat 5: slotmachine ($47000 in chips)
Seat 6: TurnOnTuneInDropOut ($44852 in chips)
ag2703: posts small blind $200
slotmachine: posts big blind $400
*** HOLE CARDS ***
Dealt to TurnOnTuneInDropOut [5c 6d 8h Qs]
TurnOnTuneInDropOut: folds
soundfsilenz: folds
kimjongun: folds
ag2703: calls $200
slotmachine: checks
*** FLOP *** [7c 5d Jh]
ag2703: bets $800
slotmachine: calls $800
*** TURN *** [7c 5d Jh] [3d]
ag2703: checks
slotmachine: checks
*** RIVER *** [7c 5d Jh 3d] [6s]
ag2703: checks
slotmachine: bets $1200
ag2703: folds
Uncalled bet ($1200) returned to slotmachine
slotmachine collected $2304 from pot
slotmachine: doesn't show hand
*** SUMMARY ***
Total pot $2400 | Rake $96
Board [7c 5d Jh 3d 6s]
Seat 1: soundfsilenz folded before Flop (didn't bet)
Seat 3: kimjongun (button) folded before Flop (didn't bet)
Seat 4: ag2703 (small blind) folded on the River
Seat 5: slotmachine (big blind) collected ($2304)
Seat 6: TurnOnTuneInDropOut folded before Flop (didn't bet)

PokerStars Hand #228844291: Omaha Pot Limit ($200/$400 USD) - 2020/10/23 14:39:00 ET
Table 'ADA409467368' 6-max Seat #5 is the button
Seat 1: soundfsilenz ($59213 in chips)
Seat 4: ag2703 ($158013 in chips)
Seat 5: slotmachine ($47904 in chips)
Seat 6: TurnOnTuneInDropOut ($46332 in chips)
TurnOnTuneInDropOut: posts small blind $200
soundfsilenz: posts big blind $400
*** HOLE CARDS ***
Dealt to TurnOnTuneInDropOut [8c Ah Qh 2h]
ag2703: folds
slotmachine: raises $1000 to $1400
TurnOnTuneInDropOut: folds
soundfsilenz: folds
Uncalled bet ($1000) returned to slotmachine
slotmachine collected $1000 from pot
slotmachine: doesn't show hand
*** SUMMARY ***
Total pot $1000 | Rake $0
Seat 1: soundfsilenz (big blind) folded before Flop
Seat 4: ag2703 folded before Flop (didn't bet)
Seat 5: slotmachine (button) collected ($1000)
Seat 6: TurnOnTuneInDropOut (small blind) folded before Flop

PokerStars Hand #228844293: Omaha Pot Limit ($200/$400 USD) - 2020/10/23 14:40:13 ET
Table 'ADA409467368' 6-max Seat #1 is the button
Seat 1: soundfsilenz ($58613 in chips)
Seat 3: kimjongun ($71604 in chips)
Seat 4: ag2703 ($157613 in chips)
Seat 5: slotmachine ($49504 in chips)
Seat 6: TurnOnTuneInDropOut ($46132 in chips)
kimjongun: posts small blind $200
ag2703: posts big blind $400
*** HOLE CARDS ***
Dealt to TurnOnTuneInDropOut [7d 5d 6h Kd]
slotmachine: raises $1000 to $1400
TurnOnTuneInDropOut: folds
soundfsilenz: folds
kimjongun: raises $3200 to $4600
ag2703: folds
slotmachine: calls $3200
*** FLOP *** [6d Qs 8d]
kimjongun: checks
slotmachine: checks
*** TURN *** [6d Qs 8d] [Qc]
kimjongun: bets $4800
slotmachine: raises $12240 to $17040
kimjongun: raises $43680 to $60720
slotmachine: folds
Uncalled bet ($43680) returned to kimjongun
kimjongun collected $42880 from pot
kimjongun: doesn't show hand
*** SUMMARY ***
Total pot $43680 | Rake $800
Board [6d Qs 8d Qc]
Seat 1: soundfsilenz (button) folded before Flop (didn't bet)
Seat 3: kimjongun (small blind) collected ($42880)
Seat 4: ag2703 (big blind) folded before Flop
Seat 5: slotmachine folded on the Turn
Seat 6: TurnOnTuneInDropOut folded before Flop (didn't bet)

PokerStars Hand #228844294: Omaha Pot Limit ($200/$400 USD) - 2020/10/23 14:41:22 ET
Table 'ADA409467368' 6-max Seat #3 is the button
Seat 1: soundfsilenz ($58613 in chips)
Seat 3: kimjongun ($92844 in chips)
Seat 4: ag2703 ($157213 in chips)
Seat 5: slotmachine ($48000 in chips)
Seat 6: TurnOnTuneInDropOut ($46132 in chips)
ag2703: posts small blind $200
slotmachine: posts big blind $400
*** HOLE CARDS ***
Dealt to TurnOnTuneInDropOut [2h Td 8h 3h]
TurnOnTuneInDropOut: folds
soundfsilenz: raises $1000 to $1400
kimjongun: folds
ag2703: calls $1200
slotmachine: calls $1000
*** FLOP *** [4s 3s 9c]
ag2703: checks
slotmachine: checks
soundfsilenz: checks
*** TURN *** [4s 3s 9c] [Qd]
ag2703: checks
slotmachine: checks
soundfsilenz: checks
*** RIVER *** [4s 3s 9c Qd] [5d]
ag2703: checks
slotmachine: bets $3150
soundfsilenz: folds
ag2703: folds
Uncalled bet ($3150) returned to slotmachine
slotmachine collected $4032 from pot
slotmachine: doesn't show hand
*** SUMMARY ***
Total pot $4200 | Rake $168
Board [4s 3s 9c Qd 5d]
Seat 1: soundfsilenz folded on the River
Seat 3: kimjongun (button) folded before Flop (didn't bet)
Seat 4: ag2703 (small blind) folded on the River
Seat 5: slotmachine (big blind) collected ($4032)
Seat 6: TurnOnTuneInDropOut folded before Flop (didn't bet)

PokerStars Hand #228844364: Omaha Pot Limit ($200/$400 USD) - 2020/10/23 16:39:31 ET
Table 'ADA409467368' 6-max Seat #3 is the button
Seat 3: yatin47 ($50911 in chips)
Seat 4: hashstack ($22515 in chips)
Seat 5: TurnOnTuneInDropOut ($30000 in chips)
hashstack: posts small blind $200
TurnOnTuneInDropOut: posts big blind $400
*** HOLE CARDS ***
Dealt to TurnOnTuneInDropOut [7c 6h Kd 6s]
yatin47: folds
hashstack: raises $800 to $1200
TurnOnTuneInDropOut: folds
Uncalled bet ($800) returned to hashstack
hashstack collected $800 from pot
hashstack: doesn't show hand
*** SUMMARY ***
Total pot $800 | Rake $0
Seat 3: yatin47 (button) folded before Flop (didn't bet)
Seat 4: hashstack (small blind) collected ($800)
Seat 5: TurnOnTuneInDropOut (big blind) folded before Flop

PokerStars Hand #228844365: Omaha Pot Limit ($200/$400 USD) - 2020/10/23 16:39:46 ET
Table 'ADA409467368' 6-max Seat #4 is the button
Seat 3: yatin47 ($50911 in chips)
Seat 4: hashstack ($22915 in chips)
Seat 5: TurnOnTuneInDropOut ($29600 in chips)
TurnOnTuneInDropOut: posts small blind $200
yatin47: posts big blind $400
*** HOLE CARDS ***
Dealt to TurnOnTuneInDropOut [Ad 9s 5d 2h]
hashstack: raises $650 to $1050
TurnOnTuneInDropOut: folds
yatin47: calls $650
*** FLOP *** [As 7c 6d]
yatin47: checks
hashstack: bets $1725
yatin47: folds
Uncalled bet ($1725) returned to hashstack
hashstack collected $2208 from pot
hashstack: doesn't show hand
*** SUMMARY ***
Total pot $2300 | Rake $92
Board [As 7c 6d]
Seat 3: yatin47 (big blind) folded on the Flop
Seat 4: hashstack (button) collected ($2208)
Seat 5: TurnOnTuneInDropOut (small blind) folded before Flop

PokerStars Hand #228844366: Omaha Pot Limit ($200/$400 USD) - 2020/10/23 16:40:03 ET
Table 'ADA409467368' 6-max Seat #5 is the button
Seat 3: yatin47 ($49861 in chips)
Seat 4: hashstack ($24073 in chips)
Seat 5: TurnOnTuneInDropOut ($29400 in chips)
yatin47: posts small blind $200
hashstack: posts big blind $400
*** HOLE CARDS ***
Dealt to TurnOnTuneInDropOut [2c 8s Kh 2d]
TurnOnTuneInDropOut: folds
yatin47: calls $200
hashstack: raises $800 to $1200
yatin47: calls $800
*** FLOP *** [Tc Kc 9c]
yatin47: checks
hashstack: checks
*** TURN *** [Tc Kc 9c] [6h]
yatin47: checks
hashstack: checks
*** RIVER *** [Tc Kc 9c 6h] [Td]
yatin47: checks
hashstack: checks
*** SHOW DOWN ***
yatin47: shows [Ks 6c 7s Qc]
hashstack: mucks hand
yatin47 collected $2304 from pot
*** SUMMARY ***
Total pot $2400 | Rake $96
Board [Tc Kc 9c 6h Td]
Seat 3: yatin47 (small blind) showed [Ks 6c 7s Qc] and won ($2304)
Seat 4: hashstack (big blind) mucked
Seat 5: TurnOnTuneInDropOut (button) folded before Flop (didn't bet)

PokerStars Hand #228844368: Omaha Pot Limit ($200/$400 USD) - 2020/10/23 16:41:01 ET
Table 'ADA409467368' 6-max Seat #4 is the button
Seat 1: Sam565 ($12000 in chips)
Seat 3: yatin47 ($50565 in chips)
Seat 4: hashstack ($22473 in chips)
Seat 5: TurnOnTuneInDropOut ($30152 in chips)
TurnOnTuneInDropOut: posts small blind $200
Sam565: posts big blind $400
*** HOLE CARDS ***
Dealt to TurnOnTuneInDropOut [9s 7c 4d 4s]
yatin47: folds
hashstack: raises $650 to $1050
TurnOnTuneInDropOut: folds
Sam565: calls $650
*** FLOP *** [3s 7d 2c]
Sam565: checks
hashstack: bets $1600
Sam565: calls $1600
*** TURN *** [3s 7d 2c] [6d]
Sam565: checks
hashstack: bets $4125
Sam565: raises $5225 to $9350 and is all-in
hashstack: calls $5225
*** RIVER *** [3s 7d 2c 6d] [Kd]
*** SHOW DOWN ***
Sam565: shows [8d As 7h 6c]
hashstack: shows [Kc 3d 3h Jh]
hashstack collected $23400 from pot
*** SUMMARY ***
Total pot $24200 | Rake $800
Board [3s 7d 2c 6d Kd]
Seat 1: Sam565 (big blind) showed [8d As 7h 6c] and lost
Seat 3: yatin47 folded before Flop (didn't bet)
Seat 4: hashstack (button) showed [Kc 3d 3h Jh] and won ($23400)
Seat 5: TurnOnTuneInDropOut (small blind) folded before Flop

PokerStars Hand #228844369: Omaha Pot Limit ($200/$400 USD) - 2020/10/23 16:41:32 ET
Table 'ADA409467368' 6-max Seat #5 is the button
Seat 3: yatin47 ($50565 in chips)
Seat 4: hashstack ($33873 in chips)
Seat 5: TurnOnTuneInDropOut ($29952 in chips)
yatin47: posts small blind $200
hashstack: posts big blind $400
*** HOLE CARDS ***
Dealt to TurnOnTuneInDropOut [Jd Ac 2d Jc]
TurnOnTuneInDropOut: raises $1000 to $1400
yatin47: folds
hashstack: calls $1000
*** FLOP *** [5s 7h 9h]
hashstack: bets $2250
TurnOnTuneInDropOut: folds
Uncalled bet ($2250) returned to hashstack
hashstack collected $2880 from pot
hashstack: doesn't show hand
*** SUMMARY ***
Total pot $3000 | Rake $120
Board [5s 7h 9h]
Seat 3: yatin47 (small blind) folded before Flop
Seat 4: hashstack (big blind) collected ($2880)
Seat 5: TurnOnTuneInDropOut (button) folded on the Flop

PokerStars Hand #228844371: Omaha Pot Limit ($200/$400 USD) - 2020/10/23 16:42:26 ET
Table 'ADA409467368' 6-max Seat #4 is the button
Seat 1: Sam565 ($11600 in chips)
Seat 3: yatin47 ($51501 in chips)
Seat 4: hashstack ($34953 in chips)
Seat 5: TurnOnTuneInDropOut ($28152 in chips)
TurnOnTuneInDropOut: posts small blind $200
Sam565: posts big blind $400
*** HOLE CARDS ***
Dealt to TurnOnTuneInDropOut [Th 7d Ks 4h]
yatin47: folds
hashstack: raises $800 to $1200
TurnOnTuneInDropOut: folds
Sam565: raises $2600 to $3800
hashstack: calls $2600
*** FLOP *** [Kh 8d Qh]
Sam565: bets $7800 and is all-in
hashstack: calls $7800
*** TURN *** [Kh 8d Qh] [2s]
*** RIVER *** [Kh 8d Qh 2s] [3c]
*** SHOW DOWN ***
Sam565: shows [6s As 5d Ac]
hashstack: shows [4c 8s 6d 5c]
Sam565 collected $22600 from pot
*** SUMMARY ***
Total pot $23400 | Rake $800
Board [Kh 8d Qh 2s 3c]
Seat 1: Sam565 (big blind) showed [6s As 5d Ac] and won ($22600)
Seat 3: yatin47 folded before Flop (didn't bet)
Seat 4: hashstack (button) showed [4c 8s 6d 5c] and lost
Seat 5: TurnOnTuneInDropOut (small blind) folded before Flop

PokerStars Hand #228844372: Omaha Pot Limit ($200/$400 USD) - 2020/10/23 16:42:49 ET
Table 'ADA409467368' 6-max Seat #5 is the button
Seat 1: Sam565 ($22600 in chips)
Seat 3: yatin47 ($51501 in chips)
Seat 4: hashstack ($23353 in chips)
Seat 5: TurnOnTuneInDropOut ($27952 in chips)
Sam565: posts small blind $200
yatin47: posts big blind $400
*** HOLE CARDS ***
Dealt to TurnOnTuneInDropOut [9h 4h As Qd]
hashstack: raises $650 to $1050
TurnOnTuneInDropOut: folds
Sam565: calls $850
yatin47: calls $650
*** FLOP *** [2s 5c 7s]
Sam565: checks
yatin47: checks
hashstack: checks
*** TURN *** [2s 5c 7s] [Jh]
Sam565: checks
yatin47: checks
hashstack: bets $1975
Sam565: folds
yatin47: calls $1975
*** RIVER *** [2s 5c 7s Jh] [Ad]
yatin47: checks
hashstack: checks
*** SHOW DOWN ***
yatin47: mucks hand
hashstack: shows [Js 8d 9c 4d]
hashstack collected $6815 from pot
*** SUMMARY ***
Total pot $7100 | Rake $285
Board [2s 5c 7s Jh Ad]
Seat 1: Sam565 (small blind) folded on the Turn
Seat 3: yatin47 (big blind) mucked
Seat 4: hashstack showed [Js 8d 9c 4d] and won ($6815)
Seat 5: TurnOnTuneInDropOut (button) folded before Flop (didn't bet)

PokerStars Hand #228844373: Omaha Pot Limit ($200/$400 USD) - 2020/10/23 16:43:33 ET
Table 'ADA409467368' 6-max Seat #1 is the button
Seat 1: Sam565 ($21550 in chips)
Seat 3: yatin47 ($48476 in chips)
Seat 4: hashstack ($27143 in chips)
Seat 5: TurnOnTuneInDropOut ($48000 in chips)
yatin47: posts small blind $200
hashstack: posts big blind $400
*** HOLE CARDS ***
Dealt to TurnOnTuneInDropOut [6c 3c 9s 3s]
TurnOnTuneInDropOut: folds
Sam565: folds
yatin47: calls $200
hashstack: raises $800 to $1200
yatin47: raises $2400 to $3600
hashstack: calls $2400
*** FLOP *** [Ac 2s 5d]
yatin47: bets $7200
hashstack: folds
Uncalled bet ($7200) returned to yatin47
yatin47 collected $6911 from pot
yatin47: doesn't show hand
*** SUMMARY ***
Total pot $7200 | Rake $289
Board [Ac 2s 5d]
Seat 1: Sam565 (button) folded before Flop (didn't bet)
Seat 3: yatin47 (small blind) collected ($6911)
Seat 4: hashstack (big blind) folded on the Flop
Seat 5: TurnOnTuneInDropOut folded before Flop (didn't bet)

PokerStars Hand #228844375: Omaha Pot Limit ($200/$400 USD) - 2020/10/23 16:45:03 ET
Table 'ADA409467368' 6-max Seat #4 is the button
Seat 1: Sam565 ($21550 in chips)
Seat 3: yatin47 ($50187 in chips)
Seat 4: hashstack ($23143 in chips)
Seat 5: TurnOnTuneInDropOut ($49856 in chips)
TurnOnTuneInDropOut: posts small blind $200
Sam565: posts big blind $400
*** HOLE CARDS ***
Dealt to TurnOnTuneInDropOut [5d Td Tc 6h]
yatin47: folds
hashstack: raises $1000 to $1400
TurnOnTuneInDropOut: folds
Sam565: calls $1000
*** FLOP *** [Kh 3s 8s]
Sam565: checks
hashstack: bets $1500
Sam565: folds
Uncalled bet ($1500) returned to hashstack
hashstack collected $2880 from pot
hashstack: doesn't show hand
*** SUMMARY ***
Total pot $3000 | Rake $120
Board [Kh 3s 8s]
Seat 1: Sam565 (big blind) folded on the Flop
Seat 3: yatin47 folded before Flop (didn't bet)
Seat 4: hashstack (button) collected ($2880)
Seat 5: TurnOnTuneInDropOut (small blind) folded before Flop

PokerStars Hand #228844376: Omaha Pot Limit ($200/$400 USD) - 2020/10/23 16:45:27 ET
Table 'ADA409467368' 6-max Seat #5 is the button
Seat 1: Sam565 ($20150 in chips)
Seat 3: yatin47 ($50187 in chips)
Seat 4: hashstack ($24623 in chips)
Seat 5: TurnOnTuneInDropOut ($49656 in chips)
Sam565: posts small blind $200
yatin47: posts big blind $400
*** HOLE CARDS ***
Dealt to TurnOnTuneInDropOut [9h Ad Kc 4d]
hashstack: raises $400 to $800
TurnOnTuneInDropOut: raises $2200 to $3000
Sam565: folds
yatin47: folds
hashstack: calls $2200
*** FLOP *** [8s Jd 7d]
hashstack: checks
TurnOnTuneInDropOut: checks
*** TURN *** [8s Jd 7d] [6c]
hashstack: bets $5350
TurnOnTuneInDropOut: folds
Uncalled bet ($5350) returned to hashstack
hashstack collected $6335 from pot
hashstack: doesn't show hand
*** SUMMARY ***
Total pot $6600 | Rake $265
Board [8s Jd 7d 6c]
Seat 1: Sam565 (small blind) folded before Flop
Seat 3: yatin47 (big blind) folded before Flop
Seat 4: hashstack collected ($6335)
Seat 5: TurnOnTuneInDropOut (button) folded on the Turn

PokerStars Hand #228844377: Omaha Pot Limit ($200/$400 USD) - 2020/10/23 16:46:22 ET
Table 'ADA409467368' 6-max Seat #1 is the button
Seat 1: Sam565 ($19950 in chips)
Seat 3: yatin47 ($49787 in chips)
Seat 4: hashstack ($27958 in chips)
Seat 5: TurnOnTuneInDropOut ($46656 in chips)
Seat 6: craftplayer ($30000 in chips)
yatin47: posts small blind $200
hashstack: posts big blind $400
craftplayer: posts big blind $400
*** HOLE CARDS ***
Dealt to TurnOnTuneInDropOut [Td 5s Kd 2s]
TurnOnTuneInDropOut: folds
craftplayer: raises $400 to $800
Sam565: calls $800
yatin47: folds
hashstack: calls $400
*** FLOP *** [Ks Js 3h]
hashstack: checks
craftplayer: checks
Sam565: checks
*** TURN *** [Ks Js 3h] [Ad]
hashstack: checks
craftplayer: checks
Sam565: checks
*** RIVER *** [Ks Js 3h Ad] [Jc]
hashstack: checks
craftplayer: bets $1950
Sam565: folds
hashstack: folds
Uncalled bet ($1950) returned to craftplayer
craftplayer collected $2496 from pot
craftplayer: doesn't show hand
*** SUMMARY ***
Total pot $2600 | Rake $104
Board [Ks Js 3h Ad Jc]
Seat 1: Sam565 (button) folded on the River
Seat 3: yatin47 (small blind) folded before Flop
Seat 4: hashstack (big blind) folded on the River
Seat 5: TurnOnTuneInDropOut folded before Flop (didn't bet)
Seat 6: craftplayer collected ($2496)

PokerStars Hand #228844378: Omaha Pot Limit ($200/$400 USD) - 2020/10/23 16:48:11 ET
Table 'ADA409467368' 6-max Seat #3 is the button
Seat 1: Sam565 ($19150 in chips)
Seat 3: yatin47 ($49587 in chips)
Seat 4: hashstack ($27158 in chips)
Seat 5: TurnOnTuneInDropOut ($46656 in chips)
Seat 6: craftplayer ($31696 in chips)
hashstack: posts small blind $200
TurnOnTuneInDropOut: posts big blind $400
*** HOLE CARDS ***
Dealt to TurnOnTuneInDropOut [3h 8c 6c Kh]
craftplayer: raises $400 to $800
Sam565: calls $800
yatin47: calls $800
hashstack: folds
TurnOnTuneInDropOut: folds
*** FLOP *** [3d Qh 7d]
craftplayer: bets $1500
Sam565: folds
yatin47: folds
Uncalled bet ($1500) returned to craftplayer
craftplayer collected $2880 from pot
craftplayer: doesn't show hand
*** SUMMARY ***
Total pot $3000 | Rake $120
Board [3d Qh 7d]
Seat 1: Sam565 folded on the Flop
Seat 3: yatin47 (button) folded on the Flop
Seat 4: hashstack (small blind) folded before Flop
Seat 5: TurnOnTuneInDropOut (big blind) folded before Flop
Seat 6: craftplayer collected ($2880)

PokerStars Hand #228844380: Omaha Pot Limit ($200/$400 USD) - 2020/10/23 16:50:37 ET
Table 'ADA409467368' 6-max Seat #5 is the button
Seat 1: Sam565 ($18350 in chips)
Seat 4: hashstack ($26958 in chips)
Seat 5: TurnOnTuneInDropOut ($12000 in chips)
Seat 6: craftplayer ($27376 in chips)
craftplayer: posts small blind $200
Sam565: posts big blind $400
*** HOLE CARDS ***
Dealt to TurnOnTuneInDropOut [7s Tc Td Qd]
hashstack: raises $800 to $1200
TurnOnTuneInDropOut: folds
craftplayer: calls $1000
Sam565: calls $800
*** FLOP *** [Kh 5h Th]
craftplayer: checks
Sam565: checks
hashstack: bets $800
craftplayer: calls $800
Sam565: folds
*** TURN *** [Kh 5h Th] [2h]
craftplayer: checks
hashstack: checks
*** RIVER *** [Kh 5h Th 2h] [2s]
craftplayer: checks
hashstack: checks
*** SHOW DOWN ***
craftplayer: shows [6h 8h 9h As]
hashstack: mucks hand
craftplayer collected $4991 from pot
*** SUMMARY ***
Total pot $5200 | Rake $209
Board [Kh 5h Th 2h 2s]
Seat 1: Sam565 (big blind) folded on the Flop
Seat 4: hashstack mucked
Seat 5: TurnOnTuneInDropOut (button) folded before Flop (didn't bet)
Seat 6: craftplayer (small blind) showed [6h 8h 9h As] and won ($4991)

PokerStars Hand #228844381: Omaha Pot Limit ($200/$400 USD) - 2020/10/23 16:52:28 ET
Table 'ADA409467368' 6-max Seat #6 is the button
Seat 1: Sam565 ($17150 in chips)
Seat 2: kimjongun ($30000 in chips)
Seat 4: hashstack ($24958 in chips)
Seat 5: TurnOnTuneInDropOut ($48000 in chips)
Seat 6: craftplayer ($30367 in chips)
Sam565: posts small blind $200
kimjongun: posts big blind $400
*** HOLE CARDS ***
Dealt to TurnOnTuneInDropOut [8d Th Ks Qc]
hashstack: raises $668 to $1068
TurnOnTuneInDropOut: folds
craftplayer: calls $1068
Sam565: calls $868
kimjongun: folds
*** FLOP *** [3c 6d 5h]
Sam565: checks
hashstack: checks
craftplayer: checks
*** TURN *** [3c 6d 5h] [3s]
Sam565: checks
hashstack: checks
craftplayer: checks
*** RIVER *** [3c 6d 5h 3s] [8h]
Sam565: checks
hashstack: checks
craftplayer: bets $2703
Sam565: folds
hashstack: calls $2703
*** SHOW DOWN ***
hashstack: mucks hand
craftplayer: shows [Tc 5s 7h 9c]
craftplayer collected $8649 from pot
*** SUMMARY ***
Total pot $9010 | Rake $361
Board [3c 6d 5h 3s 8h]
Seat 1: Sam565 (small blind) folded on the River
Seat 2: kimjongun (big blind) folded before Flop
Seat 4: hashstack mucked
Seat 5: TurnOnTuneInDropOut folded before Flop (didn't bet)
Seat 6: craftplayer (button) showed [Tc 5s 7h 9c] and won ($8649)

PokerStars Hand #228844382: Omaha Pot Limit ($200/$400 USD) - 2020/10/23 16:54:03 ET
Table 'ADA409467368' 6-max Seat #1 is the button
Seat 1: Sam565 ($16082 in chips)
Seat 2: kimjongun ($29600 in chips)
Seat 4: hashstack ($21187 in chips)
Seat 5: TurnOnTuneInDropOut ($48000 in chips)
Seat 6: craftplayer ($35245 in chips)
kimjongun: posts small blind $200
hashstack: posts big blind $400
*** HOLE CARDS ***
Dealt to TurnOnTuneInDropOut [5h 4d 8c 3c]
TurnOnTuneInDropOut: folds
craftplayer: folds
Sam565: raises $1000 to $1400
kimjongun: folds
hashstack: folds
Uncalled bet ($1000) returned to Sam565
Sam565 collected $1000 from pot
Sam565: doesn't show hand
*** SUMMARY ***
Total pot $1000 | Rake $0
Seat 1: Sam565 (button) collected ($1000)
Seat 2: kimjongun (small blind) folded before Flop
Seat 4: hashstack (big blind) folded before Flop
Seat 5: TurnOnTuneInDropOut folded before Flop (didn't bet)
Seat 6: craftplayer folded before Flop (didn't bet)

PokerStars Hand #228844383: Omaha Pot Limit ($200/$400 USD) - 2020/10/23 16:54:22 ET
Table 'ADA409467368' 6-max Seat #2 is the button
Seat 1: Sam565 ($16682 in chips)
Seat 2: kimjongun ($29400 in chips)
Seat 4: hashstack ($20787 in chips)
Seat 5: TurnOnTuneInDropOut ($48000 in chips)
Seat 6: craftplayer ($35245 in chips)
hashstack: posts small blind $200
TurnOnTuneInDropOut: posts big blind $400
*** HOLE CARDS ***
Dealt to TurnOnTuneInDropOut [Ac Ad 3s Kd]
craftplayer: raises $1000 to $1400
Sam565: folds
kimjongun: folds
hashstack: calls $1200
TurnOnTuneInDropOut: raises $4200 to $5600
craftplayer: calls $4200
hashstack: folds
*** FLOP *** [2d 2h Js]
TurnOnTuneInDropOut: bets $4158
craftplayer: calls $4158
*** TURN *** [2d 2h Js] [Td]
TurnOnTuneInDropOut: checks
craftplayer: checks
*** RIVER *** [2d 2h Js Td] [4d]
TurnOnTuneInDropOut: bets $15887
craftplayer: folds
Uncalled bet ($15887) returned to TurnOnTuneInDropOut
TurnOnTuneInDropOut collected $20116 from pot
TurnOnTuneInDropOut: doesn't show hand
*** SUMMARY ***
Total pot $20916 | Rake $800
Board [2d 2h Js Td 4d]
Seat 1: Sam565 folded before Flop (didn't bet)
Seat 2: kimjongun (button) folded before Flop (didn't bet)
Seat 4: hashstack (small blind) folded before Flop
Seat 5: TurnOnTuneInDropOut (big blind) collected ($20116)
Seat 6: craftplayer folded on the River

PokerStars Hand #228844384: Omaha Pot Limit ($200/$400 USD) - 2020/10/23 16:55:54 ET
Table 'ADA409467368' 6-max Seat #4 is the button
Seat 1: Sam565 ($16682 in chips)
Seat 2: kimjongun ($29400 in chips)
Seat 4: hashstack ($19387 in chips)
Seat 5: TurnOnTuneInDropOut ($58358 in chips)
Seat 6: craftplayer ($25487 in chips)
TurnOnTuneInDropOut: posts small blind $200
craftplayer: posts big blind $400
*** HOLE CARDS ***
Dealt to TurnOnTuneInDropOut [Ah 7h 6h 4s]
Sam565: folds
kimjongun: raises $1000 to $1400
hashstack: folds
TurnOnTuneInDropOut: folds
craftplayer: calls $1000
*** FLOP *** [8h 7d 2c]
craftplayer: checks
kimjongun: checks
*** TURN *** [8h 7d 2c] [6s]
craftplayer: checks
kimjongun: checks
*** RIVER *** [8h 7d 2c 6s] [Kd]
craftplayer: checks
kimjongun: bets $2250
craftplayer: folds
Uncalled bet ($2250) returned to kimjongun
kimjongun collected $2880 from pot
kimjongun: doesn't show hand
*** SUMMARY ***
Total pot $3000 | Rake $120
Board [8h 7d 2c 6s Kd]
Seat 1: Sam565 folded before Flop (didn't bet)
Seat 2: kimjongun collected ($2880)
Seat 4: hashstack (button) folded before Flop (didn't bet)
Seat 5: TurnOnTuneInDropOut (small blind) folded before Flop
Seat 6: craftplayer (big blind) folded on the River

PokerStars Hand #228844385: Omaha Pot Limit ($200/$400 USD) - 2020/10/23 16:56:52 ET
Table 'ADA409467368' 6-max Seat #5 is the button
Seat 1: Sam565 ($16682 in chips)
Seat 2: kimjongun ($30880 in chips)
Seat 4: hashstack ($19387 in chips)
Seat 5: TurnOnTuneInDropOut ($58158 in chips)
Seat 6: craftplayer ($24087 in chips)
craftplayer: posts small blind $200
Sam565: posts big blind $400
*** HOLE CARDS ***
Dealt to TurnOnTuneInDropOut [4h 3c Td Kh]
kimjongun: folds
hashstack: folds
TurnOnTuneInDropOut: folds
craftplayer: raises $800 to $1200
Sam565: calls $800
*** FLOP *** [9c Qh 7h]
craftplayer: bets $1800
Sam565: folds
Uncalled bet ($1800) returned to craftplayer
craftplayer collected $2304 from pot
craftplayer: doesn't show hand
*** SUMMARY ***
Total pot $2400 | Rake $96
Board [9c Qh 7h]
Seat 1: Sam565 (big blind) folded on the Flop
Seat 2: kimjongun folded before Flop (didn't bet)
Seat 4: hashstack folded before Flop (didn't bet)
Seat 5: TurnOnTuneInDropOut (button) folded before Flop (didn't bet)
Seat 6: craftplayer (small blind) collected ($2304)

PokerStars Hand #228844386: Omaha Pot Limit ($200/$400 USD) - 2020/10/23 16:57:45 ET
Table 'ADA409467368' 6-max Seat #6 is the button
Seat 1: Sam565 ($15482 in chips)
Seat 2: kimjongun ($30880 in chips)
Seat 4: hashstack ($19387 in chips)
Seat 5: TurnOnTuneInDropOut ($58158 in chips)
Seat 6: craftplayer ($25191 in chips)
Sam565: posts small blind $200
kimjongun: posts big blind $400
*** HOLE CARDS ***
Dealt to TurnOnTuneInDropOut [3d Th Jc 7h]
hashstack: folds
TurnOnTuneInDropOut: folds
craftplayer: raises $1000 to $1400
Sam565: folds
kimjongun: folds
Uncalled bet ($1000) returned to craftplayer
craftplayer collected $1000 from pot
craftplayer: doesn't show hand
*** SUMMARY ***
Total pot $1000 | Rake $0
Seat 1: Sam565 (small blind) folded before Flop
Seat 2: kimjongun (big blind) folded before Flop
Seat 4: hashstack folded before Flop (didn't bet)
Seat 5: TurnOnTuneInDropOut folded before Flop (didn't bet)
Seat 6: craftplayer (button) collected ($1000)

PokerStars Hand #228844387: Omaha Pot Limit ($200/$400 USD) - 2020/10/23 16:58:07 ET
Table 'ADA409467368' 6-max Seat #1 is the button
Seat 1: Sam565 ($15282 in chips)
Seat 2: kimjongun ($30480 in chips)
Seat 4: hashstack ($19387 in chips)
Seat 5: TurnOnTuneInDropOut ($58158 in chips)
Seat 6: craftplayer ($25791 in chips)
kimjongun: posts small blind $200
hashstack: posts big blind $400
*** HOLE CARDS ***
Dealt to TurnOnTuneInDropOut [5c 7h 9d 6s]
TurnOnTuneInDropOut: folds
craftplayer: raises $400 to $800
Sam565: calls $800
kimjongun: raises $2800 to $3600
hashstack: folds
craftplayer: calls $2800
Sam565: calls $2800
*** FLOP *** [6h 5s Qd]
kimjongun: checks
craftplayer: checks
Sam565: bets $11200
kimjongun: folds
craftplayer: folds
Uncalled bet ($11200) returned to Sam565
Sam565 collected $10751 from pot
Sam565: doesn't show hand
*** SUMMARY ***
Total pot $11200 | Rake $449
Board [6h 5s Qd]
Seat 1: Sam565 (button) collected ($10751)
Seat 2: kimjongun (small blind) folded on the Flop
Seat 4: hashstack (big blind) folded before Flop
Seat 5: TurnOnTuneInDropOut folded before Flop (didn't bet)
Seat 6: craftplayer folded on the Flop

PokerStars Hand #228844388: Omaha Pot Limit ($200/$400 USD) - 2020/10/23 16:59:52 ET
Table 'ADA409467368' 6-max Seat #2 is the button
Seat 1: Sam565 ($22433 in chips)
Seat 2: kimjongun ($26880 in chips)
Seat 4: hashstack ($18987 in chips)
Seat 5: TurnOnTuneInDropOut ($58158 in chips)
Seat 6: craftplayer ($22191 in chips)
hashstack: posts small blind $200
TurnOnTuneInDropOut: posts big blind $400
*** HOLE CARDS ***
Dealt to TurnOnTuneInDropOut [8d Ad 3h 7c]
craftplayer: raises $400 to $800
Sam565: raises $2200 to $3000
kimjongun: folds
hashstack: folds
TurnOnTuneInDropOut: folds
craftplayer: calls $2200
*** FLOP *** [Ac 4c 6h]
craftplayer: checks
Sam565: bets $6600
craftplayer: folds
Uncalled bet ($6600) returned to Sam565
Sam565 collected $6335 from pot
Sam565: doesn't show hand
*** SUMMARY ***
Total pot $6600 | Rake $265
Board [Ac 4c 6h]
Seat 1: Sam565 collected ($6335)
Seat 2: kimjongun (button) folded before Flop (didn't bet)
Seat 4: hashstack (small blind) folded before Flop
Seat 5: TurnOnTuneInDropOut (big blind) folded before Flop
Seat 6: craftplayer folded on the Flop

PokerStars Hand #228844390: Omaha Pot Limit ($200/$400 USD) - 2020/10/23 17:03:34 ET
Table 'ADA409467368' 6-max Seat #5 is the button
Seat 1: Sam565 ($28617 in chips)
Seat 2: kimjongun ($26880 in chips)
Seat 4: hashstack ($16837 in chips)
Seat 5: TurnOnTuneInDropOut ($57558 in chips)
Sam565: posts small blind $200
kimjongun: posts big blind $400
*** HOLE CARDS ***
Dealt to TurnOnTuneInDropOut [3d Qd 5h Qh]
hashstack: folds
TurnOnTuneInDropOut: raises $1000 to $1400
Sam565: folds
kimjongun: folds
Uncalled bet ($1000) returned to TurnOnTuneInDropOut
TurnOnTuneInDropOut collected $1000 from pot
TurnOnTuneInDropOut: doesn't show hand
*** SUMMARY ***
Total pot $1000 | Rake $0
Seat 1: Sam565 (small blind) folded before Flop
Seat 2: kimjongun (big blind) folded before Flop
Seat 4: hashstack folded before Flop (didn't bet)
Seat 5: TurnOnTuneInDropOut (button) collected ($1000)

PokerStars Hand #228844391: Omaha Pot Limit ($200/$400 USD) - 2020/10/23 17:03:53 ET
Table 'ADA409467368' 6-max Seat #1 is the button
Seat 1: Sam565 ($28417 in chips)
Seat 2: kimjongun ($26480 in chips)
Seat 4: hashstack ($16837 in chips)
Seat 5: TurnOnTuneInDropOut ($58158 in chips)
kimjongun: posts small blind $200
hashstack: posts big blind $400
*** HOLE CARDS ***
Dealt to TurnOnTuneInDropOut [Ah 4s 4c Kh]
TurnOnTuneInDropOut: folds
Sam565: folds
kimjongun: raises $800 to $1200
hashstack: calls $800
*** FLOP *** [3h 3c 7h]
kimjongun: checks
hashstack: bets $1800
kimjongun: calls $1800
*** TURN *** [3h 3c 7h] [2c]
kimjongun: bets $3000
hashstack: raises $10837 to $13837 and is all-in
kimjongun: calls $10837
*** RIVER *** [3h 3c 7h 2c] [8h]
*** SHOW DOWN ***
kimjongun: shows [Tc Jh Ac 5h]
hashstack: shows [6c 9s 3s 6h]
kimjongun collected $32874 from pot
*** SUMMARY ***
Total pot $33674 | Rake $800
Board [3h 3c 7h 2c 8h]
Seat 1: Sam565 (button) folded before Flop (didn't bet)
Seat 2: kimjongun (small blind) showed [Tc Jh Ac 5h] and won ($32874)
Seat 4: hashstack (big blind) showed [6c 9s 3s 6h] and lost
Seat 5: TurnOnTuneInDropOut folded before Flop (didn't bet)

PokerStars Hand #228844392: Omaha Pot Limit ($200/$400 USD) - 2020/10/23 17:04:34 ET
Table 'ADA409467368' 6-max Seat #2 is the button
Seat 1: Sam565 ($28417 in chips)
Seat 2: kimjongun ($42517 in chips)
Seat 5: TurnOnTuneInDropOut ($58158 in chips)
TurnOnTuneInDropOut: posts small blind $200
Sam565: posts big blind $400
*** HOLE CARDS ***
Dealt to TurnOnTuneInDropOut [Ks Ad Kc Ah]
kimjongun: raises $1000 to $1400
TurnOnTuneInDropOut: raises $3200 to $4600
Sam565: folds
kimjongun: folds
Uncalled bet ($3200) returned to TurnOnTuneInDropOut
TurnOnTuneInDropOut collected $3200 from pot
TurnOnTuneInDropOut: doesn't show hand
*** SUMMARY ***
Total pot $3200 | Rake $0
Seat 1: Sam565 (big blind) folded before Flop
Seat 2: kimjongun (button) folded before Flop
Seat 5: TurnOnTuneInDropOut (small blind) collected ($3200)

PokerStars Hand #1054739449: Omaha Pot Limit ($500/$1000 USD) - 2020/10/23 12:15:02 ET
Table 'ADA540885739' 6-max Seat #1 is the button
Seat 1: TurnOnTuneInDropOut ($81639 in chips)
Seat 2: vaibz16 ($31774 in chips)
Seat 3: slotmachine ($75000 in chips)
Seat 4: ag2703 ($71500 in chips)
Seat 5: bothras ($45910 in chips)
vaibz16: posts small blind $500
slotmachine: posts big blind $1000
*** HOLE CARDS ***
Dealt to TurnOnTuneInDropOut [3d 5c Td 2h]
ag2703: raises $1797 to $2797
bothras: folds
TurnOnTuneInDropOut: folds
vaibz16: folds
slotmachine: folds
Uncalled bet ($1797) returned to ag2703
ag2703 collected $2500 from pot
ag2703: doesn't show hand
*** SUMMARY ***
Total pot $2500 | Rake $0
Seat 1: TurnOnTuneInDropOut (button) folded before Flop (didn't bet)
Seat 2: vaibz16 (small blind) folded before Flop
Seat 3: slotmachine (big blind) folded before Flop
Seat 4: ag2703 collected ($2500)
Seat 5: bothras folded before Flop (didn't bet)

PokerStars Hand #1054739450: Omaha Pot Limit ($500/$1000 USD) - 2020/10/23 12:15:35 ET
Table 'ADA540885739' 6-max Seat #2 is the button
Seat 1: TurnOnTuneInDropOut ($81639 in chips)
Seat 2: vaibz16 ($31274 in chips)
Seat 3: slotmachine ($74000 in chips)
Seat 4: ag2703 ($73000 in chips)
Seat 5: bothras ($45910 in chips)
slotmachine: posts small blind $500
ag2703: posts big blind $1000
*** HOLE CARDS ***
Dealt to TurnOnTuneInDropOut [Ah 5s 7d 9h]
bothras: raises $2500 to $3500
TurnOnTuneInDropOut: folds
vaibz16: folds
slotmachine: folds
ag2703: calls $2500
*** FLOP *** [3c Ts 8d]
ag2703: checks
bothras: checks
*** TURN *** [3c Ts 8d] [Kh]
ag2703: bets $3750
bothras: raises $15000 to $18750
ag2703: folds
Uncalled bet ($15000) returned to bothras
bothras collected $14548 from pot
bothras: doesn't show hand
*** SUMMARY ***
Total pot $15000 | Rake $452
Board [3c Ts 8d Kh]
Seat 1: TurnOnTuneInDropOut folded before Flop (didn't bet)
Seat 2: vaibz16 (button) folded before Flop (didn't bet)
Seat 3: slotmachine (small blind) folded before Flop
Seat 4: ag2703 (big blind) folded on the Turn
Seat 5: bothras collected ($14548)

PokerStars Hand #1054739451: Omaha Pot Limit ($500/$1000 USD) - 2020/10/23 12:16:18 ET
Table 'ADA540885739' 6-max Seat #3 is the button
Seat 1: TurnOnTuneInDropOut ($81639 in chips)
Seat 2: vaibz16 ($31274 in chips)
Seat 3: slotmachine ($73500 in chips)
Seat 4: ag2703 ($65750 in chips)
Seat 5: bothras ($53208 in chips)
ag2703: posts small blind $500
bothras: posts big blind $1000
*** HOLE CARDS ***
Dealt to TurnOnTuneInDropOut [Kd 5d Jh Ac]
TurnOnTuneInDropOut: raises $2500 to $3500
vaibz16: folds
slotmachine: folds
ag2703: calls $3000
bothras: folds
*** FLOP *** [Qd Qs 6s]
ag2703: checks
TurnOnTuneInDropOut: bets $2640
ag2703: folds
Uncalled bet ($2640) returned to TurnOnTuneInDropOut
TurnOnTuneInDropOut collected $7759 from pot
TurnOnTuneInDropOut: doesn't show hand
*** SUMMARY ***
Total pot $8000 | Rake $241
Board [Qd Qs 6s]
Seat 1: TurnOnTuneInDropOut collected ($7759)
Seat 2: vaibz16 folded before Flop (didn't bet)
Seat 3: slotmachine (button) folded before Flop (didn't bet)
Seat 4: ag2703 (small blind) folded on the Flop
Seat 5: bothras (big blind) folded before Flop

PokerStars Hand #1054739452: Omaha Pot Limit ($500/$1000 USD) - 2020/10/23 12:17:19 ET
Table 'ADA540885739' 6-max Seat #4 is the button
Seat 1: TurnOnTuneInDropOut ($85898 in chips)
Seat 2: vaibz16 ($31274 in chips)
Seat 3: slotmachine ($73500 in chips)
Seat 4: ag2703 ($62250 in chips)
Seat 5: bothras ($52208 in chips)
bothras: posts small blind $500
TurnOnTuneInDropOut: posts big blind $1000
*** HOLE CARDS ***
Dealt to TurnOnTuneInDropOut [6c 2h 8h 6h]
vaibz16: folds
slotmachine: folds
ag2703: folds
bothras: raises $2000 to $3000
TurnOnTuneInDropOut: folds
Uncalled bet ($2000) returned to bothras
bothras collected $2000 from pot
bothras: doesn't show hand
*** SUMMARY ***
Total pot $2000 | Rake $0
Seat 1: TurnOnTuneInDropOut (big blind) folded before Flop
Seat 2: vaibz16 folded before Flop (didn't bet)
Seat 3: slotmachine folded before Flop (didn't bet)
Seat 4: ag2703 (button) folded before Flop (didn't bet)
Seat 5: bothras (small blind) collected ($2000)

PokerStars Hand #1054739453: Omaha Pot Limit ($500/$1000 USD) - 2020/10/23 12:17:39 ET
Table 'ADA540885739' 6-max Seat #5 is the button
Seat 1: TurnOnTuneInDropOut ($84898 in chips)
Seat 2: vaibz16 ($31274 in chips)
Seat 3: slotmachine ($73500 in chips)
Seat 4: ag2703 ($62250 in chips)
Seat 5: bothras ($53208 in chips)
TurnOnTuneInDropOut: posts small blind $500
vaibz16: posts big blind $1000
*** HOLE CARDS ***
Dealt to TurnOnTuneInDropOut [Ad 3h Qc Td]
slotmachine: folds
ag2703: folds
bothras: folds
TurnOnTuneInDropOut: raises $2000 to $3000
vaibz16: folds
Uncalled bet ($2000) returned to TurnOnTuneInDropOut
TurnOnTuneInDropOut collected $2000 from pot
TurnOnTuneInDropOut: doesn't show hand
*** SUMMARY ***
Total pot $2000 | Rake $0
Seat 1: TurnOnTuneInDropOut (small blind) collected ($2000)
Seat 2: vaibz16 (big blind) folded before Flop
Seat 3: slotmachine folded before Flop (didn't bet)
Seat 4: ag2703 folded before Flop (didn't bet)
Seat 5: bothras (button) folded before Flop (didn't bet)

PokerStars Hand #1054739454: Omaha Pot Limit ($500/$1000 USD) - 2020/10/23 12:18:03 ET
Table 'ADA540885739' 6-max Seat #1 is the button
Seat 1: TurnOnTuneInDropOut ($85898 in chips)
Seat 2: vaibz16 ($30274 in chips)
Seat 3: slotmachine ($73500 in chips)
Seat 4: ag2703 ($62250 in chips)
Seat 5: bothras ($53208 in chips)
vaibz16: posts small blind $500
slotmachine: posts big blind $1000
*** HOLE CARDS ***
Dealt to TurnOnTuneInDropOut [Js 5s Ks 6s]
ag2703: folds
bothras: folds
TurnOnTuneInDropOut: folds
vaibz16: folds
Uncalled bet ($500) returned to slotmachine
slotmachine collected $1000 from pot
slotmachine: doesn't show hand
*** SUMMARY ***
Total pot $1000 | Rake $0
Seat 1: TurnOnTuneInDropOut (button) folded before Flop (didn't bet)
Seat 2: vaibz16 (small blind) folded before Flop
Seat 3: slotmachine (big blind) collected ($1000)
Seat 4: ag2703 folded before Flop (didn't bet)
Seat 5: bothras folded before Flop (didn't bet)

PokerStars Hand #1054739455: Omaha Pot Limit ($500/$1000 USD) - 2020/10/23 12:18:26 ET
Table 'ADA540885739' 6-max Seat #2 is the button
Seat 1: TurnOnTuneInDropOut ($85898 in chips)
Seat 2: vaibz16 ($29774 in chips)
Seat 3: slotmachine ($74000 in chips)
Seat 4: ag2703 ($62250 in chips)
Seat 5: bothras ($53208 in chips)
slotmachine: posts small blind $500
ag2703: posts big blind $1000
*** HOLE CARDS ***
Dealt to TurnOnTuneInDropOut [8d 2d Th Qd]
bothras: folds
TurnOnTuneInDropOut: folds
vaibz16: raises $2500 to $3500
slotmachine: folds
ag2703: calls $2500
*** FLOP *** [6d 3s Ah]
ag2703: checks
vaibz16: bets $3750
ag2703: raises $15000 to $18750
vaibz16: folds
Uncalled bet ($15000) returned to ag2703
ag2703 collected $14548 from pot
ag2703: doesn't show hand
*** SUMMARY ***
Total pot $15000 | Rake $452
Board [6d 3s Ah]
Seat 1: TurnOnTuneInDropOut folded before Flop (didn't bet)
Seat 2: vaibz16 (button) folded on the Flop
Seat 3: slotmachine (small blind) folded before Flop
Seat 4: ag2703 (big blind) collected ($14548)
Seat 5: bothras folded before Flop (didn't bet)

PokerStars Hand #1054739456: Omaha Pot Limit ($500/$1000 USD) - 2020/10/23 12:19:12 ET
Table 'ADA540885739' 6-max Seat #3 is the button
Seat 1: TurnOnTuneInDropOut ($85898 in chips)
Seat 2: vaibz16 ($22524 in chips)
Seat 3: slotmachine ($73500 in chips)
Seat 4: ag2703 ($69548 in chips)
Seat 5: bothras ($53208 in chips)
ag2703: posts small blind $500
bothras: posts big blind $1000
*** HOLE CARDS ***
Dealt to TurnOnTuneInDropOut [Qd 3c 4h 2d]
TurnOnTuneInDropOut: folds
vaibz16: raises $2500 to $3500
slotmachine: folds
ag2703: folds
bothras: folds
Uncalled bet ($2500) returned to vaibz16
vaibz16 collected $2500 from pot
vaibz16: doesn't show hand
*** SUMMARY ***
Total pot $2500 | Rake $0
Seat 1: TurnOnTuneInDropOut folded before Flop (didn't bet)
Seat 2: vaibz16 collected ($2500)
Seat 3: slotmachine (button) folded before Flop (didn't bet)
Seat 4: ag2703 (small blind) folded before Flop
Seat 5: bothras (big blind) folded before Flop

PokerStars Hand #1054739462: Omaha Pot Limit ($500/$1000 USD) - 2020/10/23 12:24:06 ET
Table 'ADA540885739' 6-max Seat #4 is the button
Seat 1: TurnOnTuneInDropOut ($72898 in chips)
Seat 2: vaibz16 ($24949 in chips)
Seat 3: slotmachine ($86703 in chips)
Seat 4: ag2703 ($66973 in chips)
Seat 5: bothras ($53133 in chips)
Seat 6: nicholas93 ($36544 in chips)
bothras: posts small blind $500
nicholas93: posts big blind $1000
*** HOLE CARDS ***
Dealt to TurnOnTuneInDropOut [As 3d Jh Th]
TurnOnTuneInDropOut: folds
vaibz16: calls $1000
slotmachine: calls $1000
ag2703: calls $1000
bothras: folds
nicholas93: checks
*** FLOP *** [9d Kh 2c]
nicholas93: checks
vaibz16: checks
slotmachine: checks
ag2703: checks
*** TURN *** [9d Kh 2c] [8c]
nicholas93: checks
vaibz16: bets $3375
slotmachine: calls $3375
ag2703: folds
nicholas93: folds
*** RIVER *** [9d Kh 2c 8c] [7s]
vaibz16: bets $8438
slotmachine: calls $8438
*** SHOW DOWN ***
vaibz16: shows [8s Qc 6c Ts]
slotmachine: mucks hand
vaibz16 collected $27279 from pot
*** SUMMARY ***
Total pot $28126 | Rake $847
Board [9d Kh 2c 8c 7s]
Seat 1: TurnOnTuneInDropOut folded before Flop (didn't bet)
Seat 2: vaibz16 showed [8s Qc 6c Ts] and won ($27279)
Seat 3: slotmachine mucked
Seat 4: ag2703 (button) folded on the Turn
Seat 5: bothras (small blind) folded before Flop
Seat 6: nicholas93 (big blind) folded on the Turn

PokerStars Hand #1054739472: Omaha Pot Limit ($500/$1000 USD) - 2020/10/23 12:33:35 ET
Table 'ADA540885739' 6-max Seat #5 is the button
Seat 1: TurnOnTuneInDropOut ($71898 in chips)
Seat 3: slotmachine ($73390 in chips)
Seat 4: ag2703 ($63473 in chips)
Seat 5: bothras ($40268 in chips)
TurnOnTuneInDropOut: posts small blind $500
slotmachine: posts big blind $1000
*** HOLE CARDS ***
Dealt to TurnOnTuneInDropOut [7h Jd Kh 7s]
ag2703: folds
bothras: folds
TurnOnTuneInDropOut: raises $2000 to $3000
slotmachine: folds
Uncalled bet ($2000) returned to TurnOnTuneInDropOut
TurnOnTuneInDropOut collected $2000 from pot
TurnOnTuneInDropOut: doesn't show hand
*** SUMMARY ***
Total pot $2000 | Rake $0
Seat 1: TurnOnTuneInDropOut (small blind) collected ($2000)
Seat 3: slotmachine (big blind) folded before Flop
Seat 4: ag2703 folded before Flop (didn't bet)
Seat 5: bothras (button) folded before Flop (didn't bet)

PokerStars Hand #1054739473: Omaha Pot Limit ($500/$1000 USD) - 2020/10/23 12:34:06 ET
Table 'ADA540885739' 6-max Seat #1 is the button
Seat 1: TurnOnTuneInDropOut ($72898 in chips)
Seat 3: slotmachine ($72390 in chips)
Seat 4: ag2703 ($63473 in chips)
Seat 5: bothras ($40268 in chips)
slotmachine: posts small blind $500
ag2703: posts big blind $1000
*** HOLE CARDS ***
Dealt to TurnOnTuneInDropOut [6s 2h 4h 2d]
bothras: folds
TurnOnTuneInDropOut: folds
slotmachine: folds
Uncalled bet ($500) returned to ag2703
ag2703 collected $1000 from pot
ag2703: doesn't show hand
*** SUMMARY ***
Total pot $1000 | Rake $0
Seat 1: TurnOnTuneInDropOut (button) folded before Flop (didn't bet)
Seat 3: slotmachine (small blind) folded before Flop
Seat 4: ag2703 (big blind) collected ($1000)
Seat 5: bothras folded before Flop (didn't bet)

PokerStars Hand #1054739474: Omaha Pot Limit ($500/$1000 USD) - 2020/10/23 12:34:35 ET
Table 'ADA540885739' 6-max Seat #3 is the button
Seat 1: TurnOnTuneInDropOut ($72898 in chips)
Seat 3: slotmachine ($71890 in chips)
Seat 4: ag2703 ($63973 in chips)
Seat 5: bothras ($40268 in chips)
Seat 6: Prateek1986 ($49581 in chips)
ag2703: posts small blind $500
bothras: posts big blind $1000
Prateek1986: posts big blind $1000
*** HOLE CARDS ***
Dealt to TurnOnTuneInDropOut [6d 2h Qs 8d]
Prateek1986: raises $2500 to $3500
TurnOnTuneInDropOut: folds
slotmachine: folds
ag2703: folds
bothras: calls $2500
*** FLOP *** [9h Tc 9d]
bothras: checks
Prateek1986: checks
*** TURN *** [9h Tc 9d] [Qh]
bothras: bets $5625
Prateek1986: calls $5625
*** RIVER *** [9h Tc 9d Qh] [3d]
bothras: bets $12063
Prateek1986: folds
Uncalled bet ($12063) returned to bothras
bothras collected $18186 from pot
bothras: doesn't show hand
*** SUMMARY ***
Total pot $18750 | Rake $564
Board [9h Tc 9d Qh 3d]
Seat 1: TurnOnTuneInDropOut folded before Flop (didn't bet)
Seat 3: slotmachine (button) folded before Flop (didn't bet)
Seat 4: ag2703 (small blind) folded before Flop
Seat 5: bothras (big blind) collected ($18186)
Seat 6: Prateek1986 folded on the River

PokerStars Hand #1054739475: Omaha Pot Limit ($500/$1000 USD) - 2020/10/23 12:35:23 ET
Table 'ADA540885739' 6-max Seat #4 is the button
Seat 1: TurnOnTuneInDropOut ($72898 in chips)
Seat 3: slotmachine ($71890 in chips)
Seat 4: ag2703 ($63473 in chips)
Seat 5: bothras ($49329 in chips)
Seat 6: Prateek1986 ($40456 in chips)
bothras: posts small blind $500
Prateek1986: posts big blind $1000
*** HOLE CARDS ***
Dealt to TurnOnTuneInDropOut [Kc 8d 3d Kh]
TurnOnTuneInDropOut: folds
slotmachine: folds
ag2703: folds
bothras: folds
Uncalled bet ($500) returned to Prateek1986
Prateek1986 collected $1000 from pot
Prateek1986: doesn't show hand
*** SUMMARY ***
Total pot $1000 | Rake $0
Seat 1: TurnOnTuneInDropOut folded before Flop (didn't bet)
Seat 3: slotmachine folded before Flop (didn't bet)
Seat 4: ag2703 (button) folded before Flop (didn't bet)
Seat 5: bothras (small blind) folded before Flop
Seat 6: Prateek1986 (big blind) collected ($1000)

PokerStars Hand #1054739476: Omaha Pot Limit ($500/$1000 USD) - 2020/10/23 12:35:42 ET
Table 'ADA540885739' 6-max Seat #5 is the button
Seat 1: TurnOnTuneInDropOut ($72898 in chips)
Seat 3: slotmachine ($71890 in chips)
Seat 4: ag2703 ($63473 in chips)
Seat 5: bothras ($48829 in chips)
Seat 6: Prateek1986 ($40956 in chips)
Prateek1986: posts small blind $500
TurnOnTuneInDropOut: posts big blind $1000
*** HOLE CARDS ***
Dealt to TurnOnTuneInDropOut [9s Qs Kd 8d]
slotmachine: folds
ag2703: folds
bothras: folds
Prateek1986: folds
Uncalled bet ($500) returned to TurnOnTuneInDropOut
TurnOnTuneInDropOut collected $1000 from pot
TurnOnTuneInDropOut: doesn't show hand
*** SUMMARY ***
Total pot $1000 | Rake $0
Seat 1: TurnOnTuneInDropOut (big blind) collected ($1000)
Seat 3: slotmachine folded before Flop (didn't bet)
Seat 4: ag2703 folded before Flop (didn't bet)
Seat 5: bothras (button) folded before Flop (didn't bet)
Seat 6: Prateek1986 (small blind) folded before Flop

PokerStars Hand #1054739479: Omaha Pot Limit ($500/$1000 USD) - 2020/10/23 12:39:04 ET
Table 'ADA540885739' 6-max Seat #3 is the button
Seat 1: TurnOnTuneInDropOut ($72898 in chips)
Seat 3: slotmachine ($120000 in chips)
Seat 4: ag2703 ($47473 in chips)
Seat 5: bothras ($48829 in chips)
Seat 6: Prateek1986 ($83234 in chips)
ag2703: posts small blind $500
bothras: posts big blind $1000
*** HOLE CARDS ***
Dealt to TurnOnTuneInDropOut [3h 3c 7d 5c]
Prateek1986: folds
TurnOnTuneInDropOut: folds
slotmachine: folds
ag2703: calls $500
bothras: checks
*** FLOP *** [Tc Qd Td]
ag2703: checks
bothras: bets $1000
ag2703: folds
Uncalled bet ($1000) returned to bothras
bothras collected $1940 from pot
bothras: doesn't show hand
*** SUMMARY ***
Total pot $2000 | Rake $60
Board [Tc Qd Td]
Seat 1: TurnOnTuneInDropOut folded before Flop (didn't bet)
Seat 3: slotmachine (button) folded before Flop (didn't bet)
Seat 4: ag2703 (small blind) folded on the Flop
Seat 5: bothras (big blind) collected ($1940)
Seat 6: Prateek1986 folded before Flop (didn't bet)

PokerStars Hand #1957459583: Omaha Pot Limit ($500/$1000 USD) - 2020/10/23 13:27:18 ET
Table 'ADA540885739' 6-max Seat #4 is the button
Seat 1: vaibz16 ($149489 in chips)
Seat 2: vishnu2788 ($31579 in chips)
Seat 3: slotmachine ($140693 in chips)
Seat 4: TurnOnTuneInDropOut ($78774 in chips)
Seat 5: gaganhyd ($39129 in chips)
gaganhyd: posts small blind $500
vaibz16: posts big blind $1000
*** HOLE CARDS ***
Dealt to TurnOnTuneInDropOut [Tc 3d 5h Ad]
vishnu2788: folds
slotmachine: folds
TurnOnTuneInDropOut: raises $2500 to $3500
gaganhyd: calls $3000
vaibz16: folds
*** FLOP *** [Th 7d 3s]
gaganhyd: bets $8000
TurnOnTuneInDropOut: raises $24000 to $32000
gaganhyd: raises $3629 to $35629 and is all-in
TurnOnTuneInDropOut: calls $3629
*** TURN *** [Th 7d 3s] [2s]
*** RIVER *** [Th 7d 3s 2s] [9h]
*** SHOW DOWN ***
gaganhyd: shows [Qh 8d 9d Jd]
TurnOnTuneInDropOut: shows [Tc 3d 5h Ad]
gaganhyd collected $77859 from pot
*** SUMMARY ***
Total pot $79258 | Rake $1399
Board [Th 7d 3s 2s 9h]
Seat 1: vaibz16 (big blind) folded before Flop
Seat 2: vishnu2788 folded before Flop (didn't bet)
Seat 3: slotmachine folded before Flop (didn't bet)
Seat 4: TurnOnTuneInDropOut (button) showed [Tc 3d 5h Ad] and lost
Seat 5: gaganhyd (small blind) showed [Qh 8d 9d Jd] and won ($77859)

PokerStars Hand #1957459584: Omaha Pot Limit ($500/$1000 USD) - 2020/10/23 13:27:55 ET
Table 'ADA540885739' 6-max Seat #5 is the button
Seat 2: vishnu2788 ($31579 in chips)
Seat 3: slotmachine ($140693 in chips)
Seat 4: TurnOnTuneInDropOut ($39645 in chips)
Seat 5: gaganhyd ($77859 in chips)
vishnu2788: posts small blind $500
slotmachine: posts big blind $1000
*** HOLE CARDS ***
Dealt to TurnOnTuneInDropOut [6c Jc 9h Kd]
TurnOnTuneInDropOut: folds
gaganhyd: folds
vishnu2788: raises $2000 to $3000
slotmachine: calls $2000
*** FLOP *** [6s 7s 7h]
vishnu2788: checks
slotmachine: checks
*** TURN *** [6s 7s 7h] [Qc]
vishnu2788: bets $6000
slotmachine: folds
Uncalled bet ($6000) returned to vishnu2788
vishnu2788 collected $5819 from pot
vishnu2788: doesn't show hand
*** SUMMARY ***
Total pot $6000 | Rake $181
Board [6s 7s 7h Qc]
Seat 2: vishnu2788 (small blind) collected ($5819)
Seat 3: slotmachine (big blind) folded on the Turn
Seat 4: TurnOnTuneInDropOut folded before Flop (didn't bet)
Seat 5: gaganhyd (button) folded before Flop (didn't bet)

PokerStars Hand #1957459589: Omaha Pot Limit ($500/$1000 USD) - 2020/10/23 13:32:04 ET
Table 'ADA540885739' 6-max Seat #2 is the button
Seat 2: vishnu2788 ($29438 in chips)
Seat 3: slotmachine ($136193 in chips)
Seat 4: TurnOnTuneInDropOut ($78793 in chips)
Seat 5: gaganhyd ($76359 in chips)
Seat 6: Shr181 ($57134 in chips)
slotmachine: posts small blind $500
TurnOnTuneInDropOut: posts big blind $1000
*** HOLE CARDS ***
Dealt to TurnOnTuneInDropOut [4h 7c Ts Th]
gaganhyd: raises $1000 to $2000
Shr181: calls $2000
vishnu2788: calls $2000
slotmachine: folds
TurnOnTuneInDropOut: folds
*** FLOP *** [6s 3s 8d]
gaganhyd: checks
Shr181: checks
vishnu2788: checks
*** TURN *** [6s 3s 8d] [7h]
gaganhyd: bets $3750
Shr181: folds
vishnu2788: calls $3750
*** RIVER *** [6s 3s 8d 7h] [5c]
gaganhyd: bets $6603
vishnu2788: raises $17085 to $23688 and is all-in
gaganhyd: folds
Uncalled bet ($17085) returned to vishnu2788
vishnu2788 collected $27357 from pot
vishnu2788: doesn't show hand
*** SUMMARY ***
Total pot $28206 | Rake $849
Board [6s 3s 8d 7h 5c]
Seat 2: vishnu2788 (button) collected ($27357)
Seat 3: slotmachine (small blind) folded before Flop
Seat 4: TurnOnTuneInDropOut (big blind) folded before Flop
Seat 5: gaganhyd folded on the River
Seat 6: Shr181 folded on the Turn

PokerStars Hand #1957459592: Omaha Pot Limit ($500/$1000 USD) - 2020/10/23 13:35:58 ET
Table 'ADA540885739' 6-max Seat #5 is the button
Seat 2: bothras ($45000 in chips)
Seat 3: slotmachine ($143381 in chips)
Seat 4: TurnOnTuneInDropOut ($77293 in chips)
Seat 5: gaganhyd ($66105 in chips)
Seat 6: Shr181 ($45220 in chips)
Shr181: posts small blind $500
bothras: posts big blind $1000
*** HOLE CARDS ***
Dealt to TurnOnTuneInDropOut [4c 3c Qh 7d]
slotmachine: raises $2500 to $3500
TurnOnTuneInDropOut: folds
gaganhyd: folds
Shr181: folds
bothras: folds
Uncalled bet ($2500) returned to slotmachine
slotmachine collected $2500 from pot
slotmachine: doesn't show hand
*** SUMMARY ***
Total pot $2500 | Rake $0
Seat 2: bothras (big blind) folded before Flop
Seat 3: slotmachine collected ($2500)
Seat 4: TurnOnTuneInDropOut folded before Flop (didn't bet)
Seat 5: gaganhyd (button) folded before Flop (didn't bet)
Seat 6: Shr181 (small blind) folded before Flop

PokerStars Hand #1957459593: Omaha Pot Limit ($500/$1000 USD) - 2020/10/23 13:36:29 ET
Table 'ADA540885739' 6-max Seat #6 is the button
Seat 2: bothras ($44000 in chips)
Seat 3: slotmachine ($144881 in chips)
Seat 4: TurnOnTuneInDropOut ($77293 in chips)
Seat 5: gaganhyd ($66105 in chips)
Seat 6: Shr181 ($44720 in chips)
bothras: posts small blind $500
slotmachine: posts big blind $1000
*** HOLE CARDS ***
Dealt to TurnOnTuneInDropOut [7h Kc 8s Ts]
TurnOnTuneInDropOut: folds
gaganhyd: raises $1000 to $2000
Shr181: calls $2000
bothras: folds
slotmachine: folds
*** FLOP *** [Qh 2h Jc]
gaganhyd: checks
Shr181: checks
*** TURN *** [Qh 2h Jc] [9s]
gaganhyd: checks
Shr181: checks
*** RIVER *** [Qh 2h Jc 9s] [3c]
gaganhyd: checks
Shr181: checks
*** SHOW DOWN ***
gaganhyd: shows [8c 6h 9c 7c]
Shr181: mucks hand
gaganhyd collected $5334 from pot
*** SUMMARY ***
Total pot $5500 | Rake $166
Board [Qh 2h Jc 9s 3c]
Seat 2: bothras (small blind) folded before Flop
Seat 3: slotmachine (big blind) folded before Flop
Seat 4: TurnOnTuneInDropOut folded before Flop (didn't bet)
Seat 5: gaganhyd showed [8c 6h 9c 7c] and won ($5334)
Seat 6: Shr181 (button) mucked

PokerStars Hand #1957459594: Omaha Pot Limit ($500/$1000 USD) - 2020/10/23 13:37:28 ET
Table 'ADA540885739' 6-max Seat #2 is the button
Seat 2: bothras ($43500 in chips)
Seat 3: slotmachine ($143881 in chips)
Seat 4: TurnOnTuneInDropOut ($77293 in chips)
Seat 5: gaganhyd ($69439 in chips)
Seat 6: Shr181 ($42720 in chips)
slotmachine: posts small blind $500
TurnOnTuneInDropOut: posts big blind $1000
*** HOLE CARDS ***
Dealt to TurnOnTuneInDropOut [Ts 4d 9c Th]
gaganhyd: folds
Shr181: folds
bothras: folds
slotmachine: folds
Uncalled bet ($500) returned to TurnOnTuneInDropOut
TurnOnTuneInDropOut collected $1000 from pot
TurnOnTuneInDropOut: doesn't show hand
*** SUMMARY ***
Total pot $1000 | Rake $0
Seat 2: bothras (button) folded before Flop (didn't bet)
Seat 3: slotmachine (small blind) folded before Flop
Seat 4: TurnOnTuneInDropOut (big blind) collected ($1000)
Seat 5: gaganhyd folded before Flop (didn't bet)
Seat 6: Shr181 folded before Flop (didn't bet)

PokerStars Hand #1957459595: Omaha Pot Limit ($500/$1000 USD) - 2020/10/23 13:37:43 ET
Table 'ADA540885739' 6-max Seat #3 is the button
Seat 2: bothras ($43500 in chips)
Seat 3: slotmachine ($143381 in chips)
Seat 4: TurnOnTuneInDropOut ($77793 in chips)
Seat 5: gaganhyd ($69439 in chips)
Seat 6: Shr181 ($42720 in chips)
TurnOnTuneInDropOut: posts small blind $500
gaganhyd: posts big blind $1000
*** HOLE CARDS ***
Dealt to TurnOnTuneInDropOut [Jd 6s 7c 5s]
Shr181: folds
bothras: folds
slotmachine: raises $2500 to $3500
TurnOnTuneInDropOut: folds
gaganhyd: raises $7500 to $11000
slotmachine: calls $7500
*** FLOP *** [9c 4h 2d]
gaganhyd: bets $16875
slotmachine: raises $56250 to $73125
gaganhyd: calls $41564 and is all-in
Uncalled bet ($14686) returned to slotmachine
*** TURN *** [9c 4h 2d] [Kh]
*** RIVER *** [9c 4h 2d Kh] [Th]
*** SHOW DOWN ***
gaganhyd: shows [As Qc 8d Ad]
slotmachine: shows [8c Ah Js 9s]
gaganhyd collected $68989 from pot
*** SUMMARY ***
Total pot $139378 | Rake $70389
Board [9c 4h 2d Kh Th]
Seat 2: bothras folded before Flop (didn't bet)
Seat 3: slotmachine (button) showed [8c Ah Js 9s] and lost
Seat 4: TurnOnTuneInDropOut (small blind) folded before Flop
Seat 5: gaganhyd (big blind) showed [As Qc 8d Ad] and won ($68989)
Seat 6: Shr181 folded before Flop (didn't bet)

PokerStars Hand #1957459596: Omaha Pot Limit ($500/$1000 USD) - 2020/10/23 13:38:33 ET
Table 'ADA540885739' 6-max Seat #4 is the button
Seat 2: bothras ($43500 in chips)
Seat 3: slotmachine ($88850 in chips)
Seat 4: TurnOnTuneInDropOut ($77293 in chips)
Seat 5: gaganhyd ($137978 in chips)
Seat 6: Shr181 ($42720 in chips)
gaganhyd: posts small blind $500
Shr181: posts big blind $1000
*** HOLE CARDS ***
Dealt to TurnOnTuneInDropOut [Jh 5s 2d 2c]
bothras: raises $2500 to $3500
slotmachine: folds
TurnOnTuneInDropOut: folds
gaganhyd: folds
Shr181: calls $2500
*** FLOP *** [As 9c Qh]
Shr181: checks
bothras: bets $4500
Shr181: calls $4500
*** TURN *** [As 9c Qh] [Qd]
Shr181: bets $5573
bothras: folds
Uncalled bet ($5573) returned to Shr181
Shr181 collected $16003 from pot
Shr181: doesn't show hand
*** SUMMARY ***
Total pot $16500 | Rake $497
Board [As 9c Qh Qd]
Seat 2: bothras folded on the Turn
Seat 3: slotmachine folded before Flop (didn't bet)
Seat 4: TurnOnTuneInDropOut (button) folded before Flop (didn't bet)
Seat 5: gaganhyd (small blind) folded before Flop
Seat 6: Shr181 (big blind) collected ($16003)

PokerStars Hand #1957459597: Omaha Pot Limit ($500/$1000 USD) - 2020/10/23 13:39:14 ET
Table 'ADA540885739' 6-max Seat #5 is the button
Seat 2: bothras ($35500 in chips)
Seat 3: slotmachine ($88850 in chips)
Seat 4: TurnOnTuneInDropOut ($77293 in chips)
Seat 5: gaganhyd ($137478 in chips)
Seat 6: Shr181 ($50723 in chips)
Shr181: posts small blind $500
bothras: posts big blind $1000
*** HOLE CARDS ***
Dealt to TurnOnTuneInDropOut [5c Qd 6c Kh]
slotmachine: raises $2500 to $3500
TurnOnTuneInDropOut: folds
gaganhyd: folds
Shr181: calls $3000
bothras: folds
*** FLOP *** [4s 3s 4c]
Shr181: checks
slotmachine: bets $2640
Shr181: calls $2640
*** TURN *** [4s 3s 4c] [3d]
Shr181: checks
slotmachine: checks
*** RIVER *** [4s 3s 4c 3d] [Jd]
Shr181: bets $7175
slotmachine: calls $7175
*** SHOW DOWN ***
Shr181: shows [4h 3c 7h 8h]
slotmachine: mucks hand
Shr181 collected $26798 from pot
*** SUMMARY ***
Total pot $27630 | Rake $832
Board [4s 3s 4c 3d Jd]
Seat 2: bothras (big blind) folded before Flop
Seat 3: slotmachine mucked
Seat 4: TurnOnTuneInDropOut folded before Flop (didn't bet)
Seat 5: gaganhyd (button) folded before Flop (didn't bet)
Seat 6: Shr181 (small blind) showed [4h 3c 7h 8h] and won ($26798)

PokerStars Hand #1957459598: Omaha Pot Limit ($500/$1000 USD) - 2020/10/23 13:40:15 ET
Table 'ADA540885739' 6-max Seat #6 is the button
Seat 2: bothras ($34500 in chips)
Seat 3: slotmachine ($75535 in chips)
Seat 4: TurnOnTuneInDropOut ($77293 in chips)
Seat 6: Shr181 ($64206 in chips)
bothras: posts small blind $500
slotmachine: posts big blind $1000
*** HOLE CARDS ***
Dealt to TurnOnTuneInDropOut [Ad As 9s 8c]
TurnOnTuneInDropOut: raises $2500 to $3500
Shr181: calls $3500
bothras: folds
slotmachine: folds
*** FLOP *** [3c 2s 9h]
TurnOnTuneInDropOut: bets $8500
Shr181: calls $8500
*** TURN *** [3c 2s 9h] [8s]
TurnOnTuneInDropOut: bets $16830
Shr181: calls $16830
*** RIVER *** [3c 2s 9h 8s] [Td]
TurnOnTuneInDropOut: checks
Shr181: checks
*** SHOW DOWN ***
TurnOnTuneInDropOut: shows [Ad As 9s 8c]
Shr181: mucks hand
TurnOnTuneInDropOut collected $57761 from pot
*** SUMMARY ***
Total pot $59160 | Rake $1399
Board [3c 2s 9h 8s Td]
Seat 2: bothras (small blind) folded before Flop
Seat 3: slotmachine (big blind) folded before Flop
Seat 4: TurnOnTuneInDropOut showed [Ad As 9s 8c] and won ($57761)
Seat 6: Shr181 (button) mucked

PokerStars Hand #1957459600: Omaha Pot Limit ($500/$1000 USD) - 2020/10/23 13:43:36 ET
Table 'ADA540885739' 6-max Seat #3 is the button
Seat 1: Prateek1986 ($70250 in chips)
Seat 3: slotmachine ($73535 in chips)
Seat 4: TurnOnTuneInDropOut ($105224 in chips)
Seat 5: aggtarun ($120000 in chips)
Seat 6: Shr181 ($42750 in chips)
TurnOnTuneInDropOut: posts small blind $500
aggtarun: posts big blind $1000
*** HOLE CARDS ***
Dealt to TurnOnTuneInDropOut [9h Th 3h Ah]
Shr181: folds
Prateek1986: raises $1000 to $2000
slotmachine: folds
TurnOnTuneInDropOut: folds
aggtarun: calls $1000
*** FLOP *** [3c 4s 8s]
aggtarun: checks
Prateek1986: checks
*** TURN *** [3c 4s 8s] [3s]
aggtarun: checks
Prateek1986: bets $3375
aggtarun: calls $3375
*** RIVER *** [3c 4s 8s 3s] [4h]
aggtarun: checks
Prateek1986: checks
*** SHOW DOWN ***
aggtarun: mucks hand
Prateek1986: shows [5s Ad Js Ks]
Prateek1986 collected $10911 from pot
*** SUMMARY ***
Total pot $11250 | Rake $339
Board [3c 4s 8s 3s 4h]
Seat 1: Prateek1986 showed [5s Ad Js Ks] and won ($10911)
Seat 3: slotmachine (button) folded before Flop (didn't bet)
Seat 4: TurnOnTuneInDropOut (small blind) folded before Flop
Seat 5: aggtarun (big blind) mucked
Seat 6: Shr181 folded before Flop (didn't bet)

PokerStars Hand #1957459601: Omaha Pot Limit ($500/$1000 USD) - 2020/10/23 13:44:24 ET
Table 'ADA540885739' 6-max Seat #4 is the button
Seat 1: Prateek1986 ($75786 in chips)
Seat 3: slotmachine ($73535 in chips)
Seat 4: TurnOnTuneInDropOut ($104724 in chips)
Seat 5: aggtarun ($120000 in chips)
aggtarun: posts small blind $500
Prateek1986: posts big blind $1000
*** HOLE CARDS ***
Dealt to TurnOnTuneInDropOut [5h 6c 4s Qh]
slotmachine: folds
TurnOnTuneInDropOut: folds
aggtarun: raises $2000 to $3000
Prateek1986: calls $2000
*** FLOP *** [8c 7h 9s]
aggtarun: bets $4140
Prateek1986: calls $4140
*** TURN *** [8c 7h 9s] [3c]
aggtarun: bets $14280
Prateek1986: calls $14280
*** RIVER *** [8c 7h 9s 3c] [Ks]
aggtarun: bets $29560
Prateek1986: folds
Uncalled bet ($29560) returned to aggtarun
aggtarun collected $41551 from pot
aggtarun: doesn't show hand
*** SUMMARY ***
Total pot $42840 | Rake $1289
Board [8c 7h 9s 3c Ks]
Seat 1: Prateek1986 (big blind) folded on the River
Seat 3: slotmachine folded before Flop (didn't bet)
Seat 4: TurnOnTuneInDropOut (button) folded before Flop (didn't bet)
Seat 5: aggtarun (small blind) collected ($41551)

PokerStars Hand #1957459602: Omaha Pot Limit ($500/$1000 USD) - 2020/10/23 13:45:28 ET
Table 'ADA540885739' 6-max Seat #5 is the button
Seat 1: Prateek1986 ($54366 in chips)
Seat 3: slotmachine ($73535 in chips)
Seat 4: TurnOnTuneInDropOut ($104724 in chips)
Seat 5: aggtarun ($140131 in chips)
Prateek1986: posts small blind $500
slotmachine: posts big blind $1000
*** HOLE CARDS ***
Dealt to TurnOnTuneInDropOut [Th Jc Kc Ac]
TurnOnTuneInDropOut: raises $2500 to $3500
aggtarun: calls $3500
Prateek1986: calls $3000
slotmachine: folds
*** FLOP *** [Ks 4c 6c]
Prateek1986: checks
TurnOnTuneInDropOut: checks
aggtarun: checks
*** TURN *** [Ks 4c 6c] [9d]
Prateek1986: checks
TurnOnTuneInDropOut: checks
aggtarun: checks
*** RIVER *** [Ks 4c 6c 9d] [5h]
Prateek1986: checks
TurnOnTuneInDropOut: checks
aggtarun: bets $8970
Prateek1986: folds
TurnOnTuneInDropOut: folds
Uncalled bet ($8970) returned to aggtarun
aggtarun collected $11154 from pot
aggtarun: doesn't show hand
*** SUMMARY ***
Total pot $11500 | Rake $346
Board [Ks 4c 6c 9d 5h]
Seat 1: Prateek1986 (small blind) folded on the River
Seat 3: slotmachine (big blind) folded before Flop
Seat 4: TurnOnTuneInDropOut folded on the River
Seat 5: aggtarun (button) collected ($11154)

PokerStars Hand #1957459603: Omaha Pot Limit ($500/$1000 USD) - 2020/10/23 13:46:58 ET
Table 'ADA540885739' 6-max Seat #1 is the button
Seat 1: Prateek1986 ($50866 in chips)
Seat 3: slotmachine ($72535 in chips)
Seat 4: TurnOnTuneInDropOut ($101224 in chips)
Seat 5: aggtarun ($147785 in chips)
slotmachine: posts small blind $500
TurnOnTuneInDropOut: posts big blind $1000
*** HOLE CARDS ***
Dealt to TurnOnTuneInDropOut [Kd 4h 9d Tc]
aggtarun: folds
Prateek1986: folds
slotmachine: raises $2000 to $3000
TurnOnTuneInDropOut: calls $2000
*** FLOP *** [Jd 5h 2c]
slotmachine: bets $6000
TurnOnTuneInDropOut: folds
Uncalled bet ($6000) returned to slotmachine
slotmachine collected $5819 from pot
slotmachine: doesn't show hand
*** SUMMARY ***
Total pot $6000 | Rake $181
Board [Jd 5h 2c]
Seat 1: Prateek1986 (button) folded before Flop (didn't bet)
Seat 3: slotmachine (small blind) collected ($5819)
Seat 4: TurnOnTuneInDropOut (big blind) folded on the Flop
Seat 5: aggtarun folded before Flop (didn't bet)

PokerStars Hand #1957459604: Omaha Pot Limit ($500/$1000 USD) - 2020/10/23 13:47:29 ET
Table 'ADA540885739' 6-max Seat #3 is the button
Seat 1: Prateek1986 ($50866 in chips)
Seat 3: slotmachine ($75354 in chips)
Seat 4: TurnOnTuneInDropOut ($98224 in chips)
Seat 5: aggtarun ($147785 in chips)
TurnOnTuneInDropOut: posts small blind $500
aggtarun: posts big blind $1000
*** HOLE CARDS ***
Dealt to TurnOnTuneInDropOut [5h 4d Td 6h]
Prateek1986: folds
slotmachine: raises $2500 to $3500
TurnOnTuneInDropOut: folds
aggtarun: raises $7500 to $11000
slotmachine: calls $7500
*** FLOP *** [Jh 5c 9c]
aggtarun: bets $22500
slotmachine: raises $41854 to $64354 and is all-in
aggtarun: calls $41854
*** TURN *** [Jh 5c 9c] [2h]
*** RIVER *** [Jh 5c 9c 2h] [6d]
*** SHOW DOWN ***
aggtarun: shows [As 4c 6c Js]
slotmachine: shows [3c Kd 8d Jc]
aggtarun collected $149809 from pot
*** SUMMARY ***
Total pot $151208 | Rake $1399
Board [Jh 5c 9c 2h 6d]
Seat 1: Prateek1986 folded before Flop (didn't bet)
Seat 3: slotmachine (button) showed [3c Kd 8d Jc] and lost
Seat 4: TurnOnTuneInDropOut (small blind) folded before Flop
Seat 5: aggtarun (big blind) showed [As 4c 6c Js] and won ($149809)

PokerStars Hand #1957459605: Omaha Pot Limit ($500/$1000 USD) - 2020/10/23 13:48:15 ET
Table 'ADA540885739' 6-max Seat #4 is the button
Seat 1: Prateek1986 ($50866 in chips)
Seat 3: slotmachine ($90000 in chips)
Seat 4: TurnOnTuneInDropOut ($97724 in chips)
Seat 5: aggtarun ($222240 in chips)
aggtarun: posts small blind $500
Prateek1986: posts big blind $1000
*** HOLE CARDS ***
Dealt to TurnOnTuneInDropOut [5s Th 6d Ah]
slotmachine: folds
TurnOnTuneInDropOut: raises $2500 to $3500
aggtarun: folds
Prateek1986: folds
Uncalled bet ($2500) returned to TurnOnTuneInDropOut
TurnOnTuneInDropOut collected $2500 from pot
TurnOnTuneInDropOut: doesn't show hand
*** SUMMARY ***
Total pot $2500 | Rake $0
Seat 1: Prateek1986 (big blind) folded before Flop
Seat 3: slotmachine folded before Flop (didn't bet)
Seat 4: TurnOnTuneInDropOut (button) collected ($2500)
Seat 5: aggtarun (small blind) folded before Flop

PokerStars Hand #1957459606: Omaha Pot Limit ($500/$1000 USD) - 2020/10/23 13:48:30 ET
Table 'ADA540885739' 6-max Seat #5 is the button
Seat 1: Prateek1986 ($49866 in chips)
Seat 2: Lock2k16 ($92649 in chips)
Seat 3: slotmachine ($90000 in chips)
Seat 4: TurnOnTuneInDropOut ($99224 in chips)
Seat 5: aggtarun ($221740 in chips)
Prateek1986: posts small blind $500
Lock2k16: posts big blind $1000
*** HOLE CARDS ***
Dealt to TurnOnTuneInDropOut [8d 8s Ad 5s]
slotmachine: folds
TurnOnTuneInDropOut: raises $2500 to $3500
aggtarun: calls $3500
Prateek1986: folds
Lock2k16: calls $2500
*** FLOP *** [Tc Jc 7s]
Lock2k16: checks
TurnOnTuneInDropOut: checks
aggtarun: checks
*** TURN *** [Tc Jc 7s] [2c]
Lock2k16: bets $3000
TurnOnTuneInDropOut: folds
aggtarun: folds
Uncalled bet ($3000) returned to Lock2k16
Lock2k16 collected $10669 from pot
Lock2k16: doesn't show hand
*** SUMMARY ***
Total pot $11000 | Rake $331
Board [Tc Jc 7s 2c]
Seat 1: Prateek1986 (small blind) folded before Flop
Seat 2: Lock2k16 (big blind) collected ($10669)
Seat 3: slotmachine folded before Flop (didn't bet)
Seat 4: TurnOnTuneInDropOut folded on the Turn
Seat 5: aggtarun (button) folded on the Turn

PokerStars Hand #1957459607: Omaha Pot Limit ($500/$1000 USD) - 2020/10/23 13:49:15 ET
Table 'ADA540885739' 6-max Seat #1 is the button
Seat 1: Prateek1986 ($49366 in chips)
Seat 2: Lock2k16 ($99818 in chips)
Seat 3: slotmachine ($90000 in chips)
Seat 4: TurnOnTuneInDropOut ($95724 in chips)
Seat 5: aggtarun ($218240 in chips)
Seat 6: Shr181 ($42750 in chips)
Lock2k16: posts small blind $500
slotmachine: posts big blind $1000
Shr181: posts big blind $1000
*** HOLE CARDS ***
Dealt to TurnOnTuneInDropOut [6d As 4h 3h]
TurnOnTuneInDropOut: folds
aggtarun: calls $1000
Shr181: checks
Prateek1986: folds
Lock2k16: raises $1000 to $2000
slotmachine: folds
aggtarun: raises $6000 to $8000
Shr181: folds
Lock2k16: calls $6000
*** FLOP *** [3s 6h 2d]
Lock2k16: checks
aggtarun: checks
*** TURN *** [3s 6h 2d] [8c]
Lock2k16: bets $4000
aggtarun: raises $20400 to $24400
Lock2k16: folds
Uncalled bet ($20400) returned to aggtarun
aggtarun collected $25217 from pot
aggtarun: doesn't show hand
*** SUMMARY ***
Total pot $26000 | Rake $783
Board [3s 6h 2d 8c]
Seat 1: Prateek1986 (button) folded before Flop (didn't bet)
Seat 2: Lock2k16 (small blind) folded on the Turn
Seat 3: slotmachine (big blind) folded before Flop
Seat 4: TurnOnTuneInDropOut folded before Flop (didn't bet)
Seat 5: aggtarun collected ($25217)
Seat 6: Shr181 folded before Flop

PokerStars Hand #1957459617: Omaha Pot Limit ($500/$1000 USD) - 2020/10/23 13:59:52 ET
Table 'ADA540885739' 6-max Seat #6 is the button
Seat 1: Prateek1986 ($43366 in chips)
Seat 2: Lock2k16 ($74179 in chips)
Seat 3: slotmachine ($121684 in chips)
Seat 4: TurnOnTuneInDropOut ($86036 in chips)
Seat 5: aggtarun ($264852 in chips)
Seat 6: Shr181 ($32250 in chips)
Prateek1986: posts small blind $500
Lock2k16: posts big blind $1000
*** HOLE CARDS ***
Dealt to TurnOnTuneInDropOut [Qd 9c Ac Js]
slotmachine: folds
TurnOnTuneInDropOut: raises $2500 to $3500
aggtarun: folds
Shr181: calls $3500
Prateek1986: calls $3000
Lock2k16: calls $2500
*** FLOP *** [Jh 5c Ks]
Prateek1986: checks
Lock2k16: checks
TurnOnTuneInDropOut: checks
Shr181: checks
*** TURN *** [Jh 5c Ks] [2d]
Prateek1986: checks
Lock2k16: bets $4000
TurnOnTuneInDropOut: calls $4000
Shr181: calls $4000
Prateek1986: calls $4000
*** RIVER *** [Jh 5c Ks 2d] [4d]
Prateek1986: bets $22500
Lock2k16: folds
TurnOnTuneInDropOut: folds
Shr181: folds
Uncalled bet ($22500) returned to Prateek1986
Prateek1986 collected $29097 from pot
Prateek1986: doesn't show hand
*** SUMMARY ***
Total pot $30000 | Rake $903
Board [Jh 5c Ks 2d 4d]
Seat 1: Prateek1986 (small blind) collected ($29097)
Seat 2: Lock2k16 (big blind) folded on the River
Seat 3: slotmachine folded before Flop (didn't bet)
Seat 4: TurnOnTuneInDropOut folded on the River
Seat 5: aggtarun folded before Flop (didn't bet)
Seat 6: Shr181 (button) folded on the River

PokerStars Hand #1957459618: Omaha Pot Limit ($500/$1000 USD) - 2020/10/23 14:01:10 ET
Table 'ADA540885739' 6-max Seat #1 is the button
Seat 1: Prateek1986 ($64963 in chips)
Seat 2: Lock2k16 ($66679 in chips)
Seat 3: slotmachine ($121684 in chips)
Seat 4: TurnOnTuneInDropOut ($78536 in chips)
Seat 5: aggtarun ($264852 in chips)
Seat 6: Shr181 ($24750 in chips)
Lock2k16: posts small blind $500
slotmachine: posts big blind $1000
*** HOLE CARDS ***
Dealt to TurnOnTuneInDropOut [Ts 3c 6h 3d]
TurnOnTuneInDropOut: folds
aggtarun: raises $2500 to $3500
Shr181: raises $2500 to $6000
Prateek1986: calls $6000
Lock2k16: folds
slotmachine: folds
aggtarun: raises $19500 to $25500
Shr181: calls $18750 and is all-in
Prateek1986: calls $19500
*** FLOP *** [Th 9d 4c]
aggtarun: bets $77250
Prateek1986: calls $39463 and is all-in
Uncalled bet ($37787) returned to aggtarun
*** TURN *** [Th 9d 4c] [7d]
*** RIVER *** [Th 9d 4c 7d] [Kc]
*** SHOW DOWN ***
aggtarun: shows [Qc Qs Kd 8s]
Prateek1986: shows [Td Ah Qd 5h]
aggtarun collected $80426 from side pot
Shr181: shows [Jh 3s Jd 4h]
aggtarun collected $74351 from main pot
*** SUMMARY ***
Total pot $156176 Main pot $74351. Side pot $80426. | Rake $1399
Board [Th 9d 4c 7d Kc]
Seat 1: Prateek1986 (button) showed [Td Ah Qd 5h] and lost
Seat 2: Lock2k16 (small blind) folded before Flop
Seat 3: slotmachine (big blind) folded before Flop
Seat 4: TurnOnTuneInDropOut folded before Flop (didn't bet)
Seat 5: aggtarun showed [Qc Qs Kd 8s] and won ($154777)
Seat 6: Shr181 showed [Jh 3s Jd 4h] and lost

PokerStars Hand #1957459619: Omaha Pot Limit ($500/$1000 USD) - 2020/10/23 14:02:19 ET
Table 'ADA540885739' 6-max Seat #2 is the button
Seat 2: Lock2k16 ($66179 in chips)
Seat 3: slotmachine ($120684 in chips)
Seat 4: TurnOnTuneInDropOut ($78536 in chips)
Seat 5: aggtarun ($354666 in chips)
slotmachine: posts small blind $500
TurnOnTuneInDropOut: posts big blind $1000
*** HOLE CARDS ***
Dealt to TurnOnTuneInDropOut [6d 8d Jh 9s]
aggtarun: raises $2500 to $3500
Lock2k16: folds
slotmachine: folds
TurnOnTuneInDropOut: folds
Uncalled bet ($2500) returned to aggtarun
aggtarun collected $2500 from pot
aggtarun: doesn't show hand
*** SUMMARY ***
Total pot $2500 | Rake $0
Seat 2: Lock2k16 (button) folded before Flop (didn't bet)
Seat 3: slotmachine (small blind) folded before Flop
Seat 4: TurnOnTuneInDropOut (big blind) folded before Flop
Seat 5: aggtarun collected ($2500)

PokerStars Hand #1957459621: Omaha Pot Limit ($500/$1000 USD) - 2020/10/23 14:03:21 ET
Table 'ADA540885739' 6-max Seat #4 is the button
Seat 2: Lock2k16 ($70423 in chips)
Seat 3: slotmachine ($120184 in chips)
Seat 4: TurnOnTuneInDropOut ($77036 in chips)
Seat 5: aggtarun ($352166 in chips)
aggtarun: posts small blind $500
Lock2k16: posts big blind $1000
*** HOLE CARDS ***
Dealt to TurnOnTuneInDropOut [7c 8s 6s 3c]
slotmachine: folds
TurnOnTuneInDropOut: raises $2500 to $3500
aggtarun: folds
Lock2k16: folds
Uncalled bet ($2500) returned to TurnOnTuneInDropOut
TurnOnTuneInDropOut collected $2500 from pot
TurnOnTuneInDropOut: doesn't show hand
*** SUMMARY ***
Total pot $2500 | Rake $0
Seat 2: Lock2k16 (big blind) folded before Flop
Seat 3: slotmachine folded before Flop (didn't bet)
Seat 4: TurnOnTuneInDropOut (button) collected ($2500)
Seat 5: aggtarun (small blind) folded before Flop

PokerStars Hand #1957459622: Omaha Pot Limit ($500/$1000 USD) - 2020/10/23 14:03:48 ET
Table 'ADA540885739' 6-max Seat #5 is the button
Seat 2: Lock2k16 ($69423 in chips)
Seat 3: slotmachine ($120184 in chips)
Seat 4: TurnOnTuneInDropOut ($78536 in chips)
Seat 5: aggtarun ($351666 in chips)
Lock2k16: posts small blind $500
slotmachine: posts big blind $1000
*** HOLE CARDS ***
Dealt to TurnOnTuneInDropOut [6c 8d Qs 2c]
TurnOnTuneInDropOut: folds
aggtarun: folds
Lock2k16: calls $500
slotmachine: raises $2000 to $3000
Lock2k16: folds
Uncalled bet ($2000) returned to slotmachine
slotmachine collected $2000 from pot
slotmachine: doesn't show hand
*** SUMMARY ***
Total pot $2000 | Rake $0
Seat 2: Lock2k16 (small blind) folded before Flop
Seat 3: slotmachine (big blind) collected ($2000)
Seat 4: TurnOnTuneInDropOut folded before Flop (didn't bet)
Seat 5: aggtarun (button) folded before Flop (didn't bet)

PokerStars Hand #1957459627: Omaha Pot Limit ($500/$1000 USD) - 2020/10/23 14:06:38 ET
Table 'ADA540885739' 6-max Seat #2 is the button
Seat 2: Lock2k16 ($63995 in chips)
Seat 3: slotmachine ($132862 in chips)
Seat 4: TurnOnTuneInDropOut ($78536 in chips)
Seat 5: aggtarun ($346666 in chips)
Seat 6: gaganhyd ($36720 in chips)
slotmachine: posts small blind $500
TurnOnTuneInDropOut: posts big blind $1000
*** HOLE CARDS ***
Dealt to TurnOnTuneInDropOut [Ad 2d Td 6h]
aggtarun: folds
gaganhyd: folds
Lock2k16: raises $1000 to $2000
slotmachine: folds
TurnOnTuneInDropOut: calls $1000
*** FLOP *** [Tc 9h 3s]
TurnOnTuneInDropOut: checks
Lock2k16: bets $1000
TurnOnTuneInDropOut: calls $1000
*** TURN *** [Tc 9h 3s] [Js]
TurnOnTuneInDropOut: checks
Lock2k16: bets $6500
TurnOnTuneInDropOut: folds
Uncalled bet ($6500) returned to Lock2k16
Lock2k16 collected $6304 from pot
Lock2k16: doesn't show hand
*** SUMMARY ***
Total pot $6500 | Rake $196
Board [Tc 9h 3s Js]
Seat 2: Lock2k16 (button) collected ($6304)
Seat 3: slotmachine (small blind) folded before Flop
Seat 4: TurnOnTuneInDropOut (big blind) folded on the Turn
Seat 5: aggtarun folded before Flop (didn't bet)
Seat 6: gaganhyd folded before Flop (didn't bet)

PokerStars Hand #1957459628: Omaha Pot Limit ($500/$1000 USD) - 2020/10/23 14:07:13 ET
Table 'ADA540885739' 6-max Seat #3 is the button
Seat 2: Lock2k16 ($67299 in chips)
Seat 3: slotmachine ($132362 in chips)
Seat 4: TurnOnTuneInDropOut ($75536 in chips)
Seat 5: aggtarun ($346666 in chips)
Seat 6: gaganhyd ($36720 in chips)
TurnOnTuneInDropOut: posts small blind $500
aggtarun: posts big blind $1000
*** HOLE CARDS ***
Dealt to TurnOnTuneInDropOut [Ks 7d 2s Kd]
gaganhyd: folds
Lock2k16: raises $1000 to $2000
slotmachine: folds
TurnOnTuneInDropOut: raises $5000 to $7000
aggtarun: folds
Lock2k16: calls $5000
*** FLOP *** [3h 5h Kh]
TurnOnTuneInDropOut: bets $2950
Lock2k16: calls $2950
*** TURN *** [3h 5h Kh] [Qs]
TurnOnTuneInDropOut: checks
Lock2k16: bets $10450
TurnOnTuneInDropOut: calls $10450
*** RIVER *** [3h 5h Kh Qs] [Ts]
TurnOnTuneInDropOut: checks
Lock2k16: bets $20900
TurnOnTuneInDropOut: calls $20900
*** SHOW DOWN ***
TurnOnTuneInDropOut: shows [Ks 7d 2s Kd]
Lock2k16: mucks hand
TurnOnTuneInDropOut collected $82201 from pot
*** SUMMARY ***
Total pot $83600 | Rake $1399
Board [3h 5h Kh Qs Ts]
Seat 2: Lock2k16 mucked
Seat 3: slotmachine (button) folded before Flop (didn't bet)
Seat 4: TurnOnTuneInDropOut (small blind) showed [Ks 7d 2s Kd] and won ($82201)
Seat 5: aggtarun (big blind) folded before Flop
Seat 6: gaganhyd folded before Flop (didn't bet)

PokerStars Hand #1957459631: Omaha Pot Limit ($500/$1000 USD) - 2020/10/23 14:09:41 ET
Table 'ADA540885739' 6-max Seat #6 is the button
Seat 1: inveigle ($120000 in chips)
Seat 2: Lock2k16 ($23499 in chips)
Seat 3: slotmachine ($133862 in chips)
Seat 4: TurnOnTuneInDropOut ($116437 in chips)
Seat 5: aggtarun ($343166 in chips)
Seat 6: gaganhyd ($40994 in chips)
inveigle: posts small blind $500
Lock2k16: posts big blind $1000
*** HOLE CARDS ***
Dealt to TurnOnTuneInDropOut [8s 6d Kc 3d]
slotmachine: folds
TurnOnTuneInDropOut: folds
aggtarun: folds
gaganhyd: folds
inveigle: calls $500
Lock2k16: raises $2000 to $3000
inveigle: raises $6000 to $9000
Lock2k16: calls $6000
*** FLOP *** [8c Qc 2d]
inveigle: bets $18000
Lock2k16: calls $14499 and is all-in
Uncalled bet ($3501) returned to inveigle
*** TURN *** [8c Qc 2d] [Qh]
*** RIVER *** [8c Qc 2d Qh] [Th]
*** SHOW DOWN ***
inveigle: shows [7d Kd 4h Kh]
Lock2k16: shows [Ad 9h 2s 7h]
inveigle collected $45599 from pot
*** SUMMARY ***
Total pot $46998 | Rake $1399
Board [8c Qc 2d Qh Th]
Seat 1: inveigle (small blind) showed [7d Kd 4h Kh] and won ($45599)
Seat 2: Lock2k16 (big blind) showed [Ad 9h 2s 7h] and lost
Seat 3: slotmachine folded before Flop (didn't bet)
Seat 4: TurnOnTuneInDropOut folded before Flop (didn't bet)
Seat 5: aggtarun folded before Flop (didn't bet)
Seat 6: gaganhyd (button) folded before Flop (didn't bet)

PokerStars Hand #1957459647: Omaha Pot Limit ($500/$1000 USD) - 2020/10/23 14:18:34 ET
Table 'ADA540885739' 6-max Seat #3 is the button
Seat 1: inveigle ($119500 in chips)
Seat 3: slotmachine ($179828 in chips)
Seat 4: TurnOnTuneInDropOut ($107437 in chips)
Seat 5: prashantshah ($41500 in chips)
TurnOnTuneInDropOut: posts small blind $500
prashantshah: posts big blind $1000
*** HOLE CARDS ***
Dealt to TurnOnTuneInDropOut [Ad 4h Ah 6s]
inveigle: folds
slotmachine: folds
TurnOnTuneInDropOut: raises $2000 to $3000
prashantshah: calls $2000
*** FLOP *** [Kc 9h Jc]
TurnOnTuneInDropOut: checks
prashantshah: checks
*** TURN *** [Kc 9h Jc] [6c]
TurnOnTuneInDropOut: checks
prashantshah: checks
*** RIVER *** [Kc 9h Jc 6c] [5h]
TurnOnTuneInDropOut: checks
prashantshah: bets $1000
TurnOnTuneInDropOut: folds
Uncalled bet ($1000) returned to prashantshah
prashantshah collected $5819 from pot
prashantshah: doesn't show hand
*** SUMMARY ***
Total pot $6000 | Rake $181
Board [Kc 9h Jc 6c 5h]
Seat 1: inveigle folded before Flop (didn't bet)
Seat 3: slotmachine (button) folded before Flop (didn't bet)
Seat 4: TurnOnTuneInDropOut (small blind) folded on the River
Seat 5: prashantshah (big blind) collected ($5819)

PokerStars Hand #1957459648: Omaha Pot Limit ($500/$1000 USD) - 2020/10/23 14:19:37 ET
Table 'ADA540885739' 6-max Seat #4 is the button
Seat 1: inveigle ($119500 in chips)
Seat 3: slotmachine ($179828 in chips)
Seat 4: TurnOnTuneInDropOut ($104437 in chips)
Seat 5: prashantshah ($44319 in chips)
Seat 6: Prateek1986 ($41614 in chips)
prashantshah: posts small blind $500
Prateek1986: posts big blind $1000
*** HOLE CARDS ***
Dealt to TurnOnTuneInDropOut [Ks 2s 7c 3c]
inveigle: folds
slotmachine: folds
TurnOnTuneInDropOut: folds
prashantshah: calls $500
Prateek1986: checks
*** FLOP *** [Qc 6s 9c]
prashantshah: checks
Prateek1986: checks
*** TURN *** [Qc 6s 9c] [6c]
prashantshah: checks
Prateek1986: checks
*** RIVER *** [Qc 6s 9c 6c] [7d]
prashantshah: checks
Prateek1986: checks
*** SHOW DOWN ***
prashantshah: shows [Jd 7h Kc 4h]
Prateek1986: mucks hand
prashantshah collected $1940 from pot
*** SUMMARY ***
Total pot $2000 | Rake $60
Board [Qc 6s 9c 6c 7d]
Seat 1: inveigle folded before Flop (didn't bet)
Seat 3: slotmachine folded before Flop (didn't bet)
Seat 4: TurnOnTuneInDropOut (button) folded before Flop (didn't bet)
Seat 5: prashantshah (small blind) showed [Jd 7h Kc 4h] and won ($1940)
Seat 6: Prateek1986 (big blind) mucked

PokerStars Hand #1957459649: Omaha Pot Limit ($500/$1000 USD) - 2020/10/23 14:20:26 ET
Table 'ADA540885739' 6-max Seat #5 is the button
Seat 1: inveigle ($119500 in chips)
Seat 3: slotmachine ($179828 in chips)
Seat 4: TurnOnTuneInDropOut ($104437 in chips)
Seat 5: prashantshah ($45259 in chips)
Seat 6: Prateek1986 ($40614 in chips)
Prateek1986: posts small blind $500
inveigle: posts big blind $1000
*** HOLE CARDS ***
Dealt to TurnOnTuneInDropOut [7s Jd Kd Kh]
slotmachine: folds
TurnOnTuneInDropOut: raises $2500 to $3500
prashantshah: folds
Prateek1986: folds
inveigle: folds
Uncalled bet ($2500) returned to TurnOnTuneInDropOut
TurnOnTuneInDropOut collected $2500 from pot
TurnOnTuneInDropOut: doesn't show hand
*** SUMMARY ***
Total pot $2500 | Rake $0
Seat 1: inveigle (big blind) folded before Flop
Seat 3: slotmachine folded before Flop (didn't bet)
Seat 4: TurnOnTuneInDropOut collected ($2500)
Seat 5: prashantshah (button) folded before Flop (didn't bet)
Seat 6: Prateek1986 (small blind) folded before Flop

PokerStars Hand #1957459650: Omaha Pot Limit ($500/$1000 USD) - 2020/10/23 14:20:56 ET
Table 'ADA540885739' 6-max Seat #6 is the button
Seat 1: inveigle ($118500 in chips)
Seat 3: slotmachine ($179828 in chips)
Seat 4: TurnOnTuneInDropOut ($105937 in chips)
Seat 5: prashantshah ($45259 in chips)
Seat 6: Prateek1986 ($40114 in chips)
inveigle: posts small blind $500
slotmachine: posts big blind $1000
*** HOLE CARDS ***
Dealt to TurnOnTuneInDropOut [Kh 8s 4h Ac]
TurnOnTuneInDropOut: folds
prashantshah: folds
Prateek1986: calls $1000
inveigle: calls $500
slotmachine: checks
*** FLOP *** [6d 5s Kd]
inveigle: checks
slotmachine: checks
Prateek1986: checks
*** TURN *** [6d 5s Kd] [Js]
inveigle: checks
slotmachine: checks
Prateek1986: checks
*** RIVER *** [6d 5s Kd Js] [8h]
inveigle: bets $3000
slotmachine: folds
Prateek1986: folds
Uncalled bet ($3000) returned to inveigle
inveigle collected $2910 from pot
inveigle: doesn't show hand
*** SUMMARY ***
Total pot $3000 | Rake $90
Board [6d 5s Kd Js 8h]
Seat 1: inveigle (small blind) collected ($2910)
Seat 3: slotmachine (big blind) folded on the River
Seat 4: TurnOnTuneInDropOut folded before Flop (didn't bet)
Seat 5: prashantshah folded before Flop (didn't bet)
Seat 6: Prateek1986 (button) folded on the River

PokerStars Hand #1957459652: Omaha Pot Limit ($500/$1000 USD) - 2020/10/23 14:22:56 ET
Table 'ADA540885739' 6-max Seat #3 is the button
Seat 1: inveigle ($121910 in chips)
Seat 3: slotmachine ($178328 in chips)
Seat 4: TurnOnTuneInDropOut ($104937 in chips)
Seat 5: prashantshah ($45259 in chips)
Seat 6: Prateek1986 ($39114 in chips)
TurnOnTuneInDropOut: posts small blind $500
prashantshah: posts big blind $1000
*** HOLE CARDS ***
Dealt to TurnOnTuneInDropOut [6c Kd As 4h]
Prateek1986: folds
inveigle: folds
slotmachine: folds
TurnOnTuneInDropOut: folds
Uncalled bet ($500) returned to prashantshah
prashantshah collected $1000 from pot
prashantshah: doesn't show hand
*** SUMMARY ***
Total pot $1000 | Rake $0
Seat 1: inveigle folded before Flop (didn't bet)
Seat 3: slotmachine (button) folded before Flop (didn't bet)
Seat 4: TurnOnTuneInDropOut (small blind) folded before Flop
Seat 5: prashantshah (big blind) collected ($1000)
Seat 6: Prateek1986 folded before Flop (didn't bet)

PokerStars Hand #1957459653: Omaha Pot Limit ($500/$1000 USD) - 2020/10/23 14:23:23 ET
Table 'ADA540885739' 6-max Seat #4 is the button
Seat 3: slotmachine ($178328 in chips)
Seat 4: TurnOnTuneInDropOut ($104437 in chips)
Seat 5: prashantshah ($45759 in chips)
Seat 6: Prateek1986 ($39114 in chips)
prashantshah: posts small blind $500
Prateek1986: posts big blind $1000
*** HOLE CARDS ***
Dealt to TurnOnTuneInDropOut [6d Jc Qh 7s]
slotmachine: folds
TurnOnTuneInDropOut: folds
prashantshah: calls $500
Prateek1986: raises $2000 to $3000
prashantshah: folds
Uncalled bet ($2000) returned to Prateek1986
Prateek1986 collected $2000 from pot
Prateek1986: doesn't show hand
*** SUMMARY ***
Total pot $2000 | Rake $0
Seat 3: slotmachine folded before Flop (didn't bet)
Seat 4: TurnOnTuneInDropOut (button) folded before Flop (didn't bet)
Seat 5: prashantshah (small blind) folded before Flop
Seat 6: Prateek1986 (big blind) collected ($2000)

PokerStars Hand #1957459654: Omaha Pot Limit ($500/$1000 USD) - 2020/10/23 14:23:56 ET
Table 'ADA540885739' 6-max Seat #5 is the button
Seat 3: slotmachine ($178328 in chips)
Seat 4: TurnOnTuneInDropOut ($104437 in chips)
Seat 5: prashantshah ($44759 in chips)
Seat 6: Prateek1986 ($40114 in chips)
Prateek1986: posts small blind $500
slotmachine: posts big blind $1000
*** HOLE CARDS ***
Dealt to TurnOnTuneInDropOut [Kh 4d 7h 8h]
TurnOnTuneInDropOut: folds
prashantshah: folds
Prateek1986: folds
Uncalled bet ($500) returned to slotmachine
slotmachine collected $1000 from pot
slotmachine: doesn't show hand
*** SUMMARY ***
Total pot $1000 | Rake $0
Seat 3: slotmachine (big blind) collected ($1000)
Seat 4: TurnOnTuneInDropOut folded before Flop (didn't bet)
Seat 5: prashantshah (button) folded before Flop (didn't bet)
Seat 6: Prateek1986 (small blind) folded before Flop

PokerStars Hand #1957459657: Omaha Pot Limit ($500/$1000 USD) - 2020/10/23 14:26:21 ET
Table 'ADA540885739' 6-max Seat #4 is the button
Seat 3: slotmachine ($178328 in chips)
Seat 4: TurnOnTuneInDropOut ($105832 in chips)
Seat 5: prashantshah ($48488 in chips)
Seat 6: Prateek1986 ($34614 in chips)
prashantshah: posts small blind $500
Prateek1986: posts big blind $1000
*** HOLE CARDS ***
Dealt to TurnOnTuneInDropOut [Kd 8s Ac Kc]
slotmachine: folds
TurnOnTuneInDropOut: raises $2500 to $3500
prashantshah: folds
Prateek1986: folds
Uncalled bet ($2500) returned to TurnOnTuneInDropOut
TurnOnTuneInDropOut collected $2500 from pot
TurnOnTuneInDropOut: doesn't show hand
*** SUMMARY ***
Total pot $2500 | Rake $0
Seat 3: slotmachine folded before Flop (didn't bet)
Seat 4: TurnOnTuneInDropOut (button) collected ($2500)
Seat 5: prashantshah (small blind) folded before Flop
Seat 6: Prateek1986 (big blind) folded before Flop

PokerStars Hand #1957459658: Omaha Pot Limit ($500/$1000 USD) - 2020/10/23 14:26:39 ET
Table 'ADA540885739' 6-max Seat #5 is the button
Seat 3: slotmachine ($178328 in chips)
Seat 4: TurnOnTuneInDropOut ($107332 in chips)
Seat 5: prashantshah ($47988 in chips)
Seat 6: Prateek1986 ($33614 in chips)
Prateek1986: posts small blind $500
slotmachine: posts big blind $1000
*** HOLE CARDS ***
Dealt to TurnOnTuneInDropOut [As 5h 9h Js]
TurnOnTuneInDropOut: raises $2500 to $3500
prashantshah: folds
Prateek1986: calls $3000
slotmachine: folds
*** FLOP *** [Qs 3c 4c]
Prateek1986: checks
TurnOnTuneInDropOut: checks
*** TURN *** [Qs 3c 4c] [Ad]
Prateek1986: checks
TurnOnTuneInDropOut: bets $6000
Prateek1986: folds
Uncalled bet ($6000) returned to TurnOnTuneInDropOut
TurnOnTuneInDropOut collected $7759 from pot
TurnOnTuneInDropOut: doesn't show hand
*** SUMMARY ***
Total pot $8000 | Rake $241
Board [Qs 3c 4c Ad]
Seat 3: slotmachine (big blind) folded before Flop
Seat 4: TurnOnTuneInDropOut collected ($7759)
Seat 5: prashantshah (button) folded before Flop (didn't bet)
Seat 6: Prateek1986 (small blind) folded on the Turn

PokerStars Hand #1957459662: Omaha Pot Limit ($500/$1000 USD) - 2020/10/23 14:29:44 ET
Table 'ADA540885739' 6-max Seat #5 is the button
Seat 3: slotmachine ($178328 in chips)
Seat 4: TurnOnTuneInDropOut ($110091 in chips)
Seat 5: prashantshah ($45488 in chips)
Seat 6: Prateek1986 ($33039 in chips)
Prateek1986: posts small blind $500
slotmachine: posts big blind $1000
*** HOLE CARDS ***
Dealt to TurnOnTuneInDropOut [2s Tc 9c 5h]
TurnOnTuneInDropOut: folds
prashantshah: folds
Prateek1986: calls $500
slotmachine: raises $2000 to $3000
Prateek1986: calls $2000
*** FLOP *** [Qs 2h 7s]
Prateek1986: checks
slotmachine: bets $6000
Prateek1986: folds
Uncalled bet ($6000) returned to slotmachine
slotmachine collected $5819 from pot
slotmachine: doesn't show hand
*** SUMMARY ***
Total pot $6000 | Rake $181
Board [Qs 2h 7s]
Seat 3: slotmachine (big blind) collected ($5819)
Seat 4: TurnOnTuneInDropOut folded before Flop (didn't bet)
Seat 5: prashantshah (button) folded before Flop (didn't bet)
Seat 6: Prateek1986 (small blind) folded on the Flop

PokerStars Hand #1957459663: Omaha Pot Limit ($500/$1000 USD) - 2020/10/23 14:30:33 ET
Table 'ADA540885739' 6-max Seat #6 is the button
Seat 3: slotmachine ($181147 in chips)
Seat 4: TurnOnTuneInDropOut ($110091 in chips)
Seat 5: prashantshah ($45488 in chips)
Seat 6: Prateek1986 ($30039 in chips)
slotmachine: posts small blind $500
TurnOnTuneInDropOut: posts big blind $1000
*** HOLE CARDS ***
Dealt to TurnOnTuneInDropOut [7h Kc 2s Tc]
prashantshah: folds
Prateek1986: folds
slotmachine: raises $2000 to $3000
TurnOnTuneInDropOut: calls $2000
*** FLOP *** [4s 7d 4d]
slotmachine: bets $1980
TurnOnTuneInDropOut: raises $5401 to $7381
slotmachine: calls $5401
*** TURN *** [4s 7d 4d] [8c]
slotmachine: checks
TurnOnTuneInDropOut: checks
*** RIVER *** [4s 7d 4d 8c] [6c]
slotmachine: bets $10381
TurnOnTuneInDropOut: folds
Uncalled bet ($10381) returned to slotmachine
slotmachine collected $20137 from pot
slotmachine: doesn't show hand
*** SUMMARY ***
Total pot $20762 | Rake $625
Board [4s 7d 4d 8c 6c]
Seat 3: slotmachine (small blind) collected ($20137)
Seat 4: TurnOnTuneInDropOut (big blind) folded on the River
Seat 5: prashantshah folded before Flop (didn't bet)
Seat 6: Prateek1986 (button) folded before Flop (didn't bet)

PokerStars Hand #1957459666: Omaha Pot Limit ($500/$1000 USD) - 2020/10/23 14:32:40 ET
Table 'ADA540885739' 6-max Seat #5 is the button
Seat 3: slotmachine ($192403 in chips)
Seat 4: TurnOnTuneInDropOut ($99210 in chips)
Seat 5: prashantshah ($43988 in chips)
Seat 6: Prateek1986 ($30464 in chips)
Prateek1986: posts small blind $500
slotmachine: posts big blind $1000
*** HOLE CARDS ***
Dealt to TurnOnTuneInDropOut [Ks 8s 5h Kd]
TurnOnTuneInDropOut: raises $2500 to $3500
prashantshah: folds
Prateek1986: calls $3000
slotmachine: folds
*** FLOP *** [9h 2d Th]
Prateek1986: checks
TurnOnTuneInDropOut: checks
*** TURN *** [9h 2d Th] [Js]
Prateek1986: checks
TurnOnTuneInDropOut: bets $6000
Prateek1986: folds
Uncalled bet ($6000) returned to TurnOnTuneInDropOut
TurnOnTuneInDropOut collected $7759 from pot
TurnOnTuneInDropOut: doesn't show hand
*** SUMMARY ***
Total pot $8000 | Rake $241
Board [9h 2d Th Js]
Seat 3: slotmachine (big blind) folded before Flop
Seat 4: TurnOnTuneInDropOut collected ($7759)
Seat 5: prashantshah (button) folded before Flop (didn't bet)
Seat 6: Prateek1986 (small blind) folded on the Turn

PokerStars Hand #1957459667: Omaha Pot Limit ($500/$1000 USD) - 2020/10/23 14:33:41 ET
Table 'ADA540885739' 6-max Seat #6 is the button
Seat 3: slotmachine ($191403 in chips)
Seat 4: TurnOnTuneInDropOut ($103469 in chips)
Seat 5: prashantshah ($43988 in chips)
Seat 6: Prateek1986 ($26964 in chips)
slotmachine: posts small blind $500
TurnOnTuneInDropOut: posts big blind $1000
*** HOLE CARDS ***
Dealt to TurnOnTuneInDropOut [8c 7s Kd 8s]
prashantshah: folds
Prateek1986: folds
slotmachine: folds
Uncalled bet ($500) returned to TurnOnTuneInDropOut
TurnOnTuneInDropOut collected $1000 from pot
TurnOnTuneInDropOut: doesn't show hand
*** SUMMARY ***
Total pot $1000 | Rake $0
Seat 3: slotmachine (small blind) folded before Flop
Seat 4: TurnOnTuneInDropOut (big blind) collected ($1000)
Seat 5: prashantshah folded before Flop (didn't bet)
Seat 6: Prateek1986 (button) folded before Flop (didn't bet)

PokerStars Hand #1957459670: Omaha Pot Limit ($500/$1000 USD) - 2020/10/23 14:35:42 ET
Table 'ADA540885739' 6-max Seat #5 is the button
Seat 3: slotmachine ($195647 in chips)
Seat 4: TurnOnTuneInDropOut ($99969 in chips)
Seat 5: prashantshah ($42488 in chips)
Seat 6: Prateek1986 ($27389 in chips)
Prateek1986: posts small blind $500
slotmachine: posts big blind $1000
*** HOLE CARDS ***
Dealt to TurnOnTuneInDropOut [Jc 8c Jd 3d]
TurnOnTuneInDropOut: raises $2500 to $3500
prashantshah: folds
Prateek1986: folds
slotmachine: calls $2500
*** FLOP *** [9s 4d Js]
slotmachine: checks
TurnOnTuneInDropOut: bets $5625
slotmachine: calls $5625
*** TURN *** [9s 4d Js] [4c]
slotmachine: checks
TurnOnTuneInDropOut: bets $12375
slotmachine: calls $12375
*** RIVER *** [9s 4d Js 4c] [7h]
slotmachine: checks
TurnOnTuneInDropOut: bets $43500
slotmachine: folds
Uncalled bet ($43500) returned to TurnOnTuneInDropOut
TurnOnTuneInDropOut collected $42191 from pot
TurnOnTuneInDropOut: doesn't show hand
*** SUMMARY ***
Total pot $43500 | Rake $1309
Board [9s 4d Js 4c 7h]
Seat 3: slotmachine (big blind) folded on the River
Seat 4: TurnOnTuneInDropOut collected ($42191)
Seat 5: prashantshah (button) folded before Flop (didn't bet)
Seat 6: Prateek1986 (small blind) folded before Flop

PokerStars Hand #1957459671: Omaha Pot Limit ($500/$1000 USD) - 2020/10/23 14:37:32 ET
Table 'ADA540885739' 6-max Seat #6 is the button
Seat 3: slotmachine ($174147 in chips)
Seat 4: TurnOnTuneInDropOut ($120660 in chips)
Seat 5: prashantshah ($42488 in chips)
Seat 6: Prateek1986 ($26889 in chips)
slotmachine: posts small blind $500
TurnOnTuneInDropOut: posts big blind $1000
*** HOLE CARDS ***
Dealt to TurnOnTuneInDropOut [Ac Tc Ad As]
prashantshah: folds
Prateek1986: raises $2500 to $3500
slotmachine: folds
TurnOnTuneInDropOut: raises $7500 to $11000
Prateek1986: calls $7500
*** FLOP *** [7d 5c Td]
TurnOnTuneInDropOut: bets $22500
Prateek1986: calls $15889 and is all-in
Uncalled bet ($6611) returned to TurnOnTuneInDropOut
*** TURN *** [7d 5c Td] [2c]
*** RIVER *** [7d 5c Td 2c] [9c]
*** SHOW DOWN ***
TurnOnTuneInDropOut: shows [Ac Tc Ad As]
Prateek1986: shows [Qd 3s 4c Qc]
TurnOnTuneInDropOut collected $52879 from pot
*** SUMMARY ***
Total pot $54278 | Rake $1399
Board [7d 5c Td 2c 9c]
Seat 3: slotmachine (small blind) folded before Flop
Seat 4: TurnOnTuneInDropOut (big blind) showed [Ac Tc Ad As] and won ($52879)
Seat 5: prashantshah folded before Flop (didn't bet)
Seat 6: Prateek1986 (button) showed [Qd 3s 4c Qc] and lost

PokerStars Hand #1957459672: Omaha Pot Limit ($500/$1000 USD) - 2020/10/23 14:38:20 ET
Table 'ADA540885739' 6-max Seat #3 is the button
Seat 3: slotmachine ($173647 in chips)
Seat 4: TurnOnTuneInDropOut ($146650 in chips)
Seat 5: prashantshah ($42488 in chips)
TurnOnTuneInDropOut: posts small blind $500
prashantshah: posts big blind $1000
*** HOLE CARDS ***
Dealt to TurnOnTuneInDropOut [5c As 7c 2d]
slotmachine: folds
TurnOnTuneInDropOut: folds
Uncalled bet ($500) returned to prashantshah
prashantshah collected $1000 from pot
prashantshah: doesn't show hand
*** SUMMARY ***
Total pot $1000 | Rake $0
Seat 3: slotmachine (button) folded before Flop (didn't bet)
Seat 4: TurnOnTuneInDropOut (small blind) folded before Flop
Seat 5: prashantshah (big blind) collected ($1000)

PokerStars Hand #1957459673: Omaha Pot Limit ($500/$1000 USD) - 2020/10/23 14:38:34 ET
Table 'ADA540885739' 6-max Seat #4 is the button
Seat 1: terminator369 ($30000 in chips)
Seat 3: slotmachine ($173647 in chips)
Seat 4: TurnOnTuneInDropOut ($146150 in chips)
Seat 5: prashantshah ($42988 in chips)
prashantshah: posts small blind $500
terminator369: posts big blind $1000
*** HOLE CARDS ***
Dealt to TurnOnTuneInDropOut [4h Qs Jc 3c]
slotmachine: folds
TurnOnTuneInDropOut: folds
prashantshah: calls $500
terminator369: raises $2000 to $3000
prashantshah: folds
Uncalled bet ($2000) returned to terminator369
terminator369 collected $2000 from pot
terminator369: doesn't show hand
*** SUMMARY ***
Total pot $2000 | Rake $0
Seat 1: terminator369 (big blind) collected ($2000)
Seat 3: slotmachine folded before Flop (didn't bet)
Seat 4: TurnOnTuneInDropOut (button) folded before Flop (didn't bet)
Seat 5: prashantshah (small blind) folded before Flop

PokerStars Hand #1957459674: Omaha Pot Limit ($500/$1000 USD) - 2020/10/23 14:39:03 ET
Table 'ADA540885739' 6-max Seat #5 is the button
Seat 1: terminator369 ($31000 in chips)
Seat 3: slotmachine ($173647 in chips)
Seat 4: TurnOnTuneInDropOut ($146150 in chips)
Seat 5: prashantshah ($41988 in chips)
terminator369: posts small blind $500
slotmachine: posts big blind $1000
*** HOLE CARDS ***
Dealt to TurnOnTuneInDropOut [9s 8s Jc Kd]
TurnOnTuneInDropOut: raises $2500 to $3500
prashantshah: folds
terminator369: folds
slotmachine: folds
Uncalled bet ($2500) returned to TurnOnTuneInDropOut
TurnOnTuneInDropOut collected $2500 from pot
TurnOnTuneInDropOut: doesn't show hand
*** SUMMARY ***
Total pot $2500 | Rake $0
Seat 1: terminator369 (small blind) folded before Flop
Seat 3: slotmachine (big blind) folded before Flop
Seat 4: TurnOnTuneInDropOut collected ($2500)
Seat 5: prashantshah (button) folded before Flop (didn't bet)

PokerStars Hand #1255059641: Omaha Pot Limit ($200/$400 USD) - 2020/10/23 12:24:37 ET
Table 'ADA675920511' 6-max Seat #4 is the button
Seat 1: PokerMessi ($57050 in chips)
Seat 2: TurnOnTuneInDropOut ($29400 in chips)
Seat 3: slotmachine ($54021 in chips)
Seat 4: rajan2017 ($9360 in chips)
Seat 6: soundfsilenz ($39186 in chips)
soundfsilenz: posts small blind $200
PokerMessi: posts big blind $400
*** HOLE CARDS ***
Dealt to TurnOnTuneInDropOut [Qs 5d Jd Ks]
TurnOnTuneInDropOut: raises $1000 to $1400
slotmachine: folds
rajan2017: raises $3400 to $4800
soundfsilenz: folds
PokerMessi: folds
TurnOnTuneInDropOut: raises $10200 to $15000
rajan2017: calls $4560 and is all-in
Uncalled bet ($5640) returned to TurnOnTuneInDropOut
*** FLOP *** [2d Kc 7s]
*** TURN *** [2d Kc 7s] [2h]
*** RIVER *** [2d Kc 7s 2h] [6s]
*** SHOW DOWN ***
TurnOnTuneInDropOut: shows [Qs 5d Jd Ks]
rajan2017: shows [Jc 9d Kd 7c]
rajan2017 collected $18545 from pot
*** SUMMARY ***
Total pot $19320 | Rake $775
Board [2d Kc 7s 2h 6s]
Seat 1: PokerMessi (big blind) folded before Flop
Seat 2: TurnOnTuneInDropOut showed [Qs 5d Jd Ks] and lost
Seat 3: slotmachine folded before Flop (didn't bet)
Seat 4: rajan2017 (button) showed [Jc 9d Kd 7c] and won ($18545)
Seat 6: soundfsilenz (small blind) folded before Flop

PokerStars Hand #1255059682: Omaha Pot Limit ($200/$400 USD) - 2020/10/23 13:24:34 ET
Table 'ADA675920511' 6-max Seat #1 is the button
Seat 1: harshb_95 ($13480 in chips)
Seat 2: vaibz16 ($22100 in chips)
Seat 4: TurnOnTuneInDropOut ($30000 in chips)
vaibz16: posts small blind $200
TurnOnTuneInDropOut: posts big blind $400
*** HOLE CARDS ***
Dealt to TurnOnTuneInDropOut [As Ts 8c Kh]
harshb_95: raises $1000 to $1400
vaibz16: folds
TurnOnTuneInDropOut: raises $3000 to $4400
harshb_95: calls $3000
*** FLOP *** [6c 7d Ad]
TurnOnTuneInDropOut: bets $9000
harshb_95: raises $80 to $9080 and is all-in
TurnOnTuneInDropOut: calls $80
*** TURN *** [6c 7d Ad] [Qc]
*** RIVER *** [6c 7d Ad Qc] [Qs]
*** SHOW DOWN ***
TurnOnTuneInDropOut: shows [As Ts 8c Kh]
harshb_95: shows [8d Jd Jc Kc]
TurnOnTuneInDropOut collected $26460 from pot
*** SUMMARY ***
Total pot $27160 | Rake $700
Board [6c 7d Ad Qc Qs]
Seat 1: harshb_95 (button) showed [8d Jd Jc Kc] and lost
Seat 2: vaibz16 (small blind) folded before Flop
Seat 4: TurnOnTuneInDropOut (big blind) showed [As Ts 8c Kh] and won ($26460)

PokerStars Hand #1255059688: Omaha Pot Limit ($200/$400 USD) - 2020/10/23 13:28:01 ET
Table 'ADA675920511' 6-max Seat #1 is the button
Seat 1: harshb_95 ($11400 in chips)
Seat 2: gaganhyd ($19824 in chips)
Seat 4: TurnOnTuneInDropOut ($42780 in chips)
Seat 5: kimjongun ($42600 in chips)
Seat 6: karanchawla09 ($28905 in chips)
gaganhyd: posts small blind $200
TurnOnTuneInDropOut: posts big blind $400
karanchawla09: posts big blind $400
*** HOLE CARDS ***
Dealt to TurnOnTuneInDropOut [7c 5c Td Th]
kimjongun: folds
karanchawla09: raises $1000 to $1400
harshb_95: calls $1400
gaganhyd: folds
TurnOnTuneInDropOut: folds
*** FLOP *** [8c 8h 6c]
karanchawla09: checks
harshb_95: bets $3400
karanchawla09: raises $10200 to $13600
harshb_95: calls $6600 and is all-in
Uncalled bet ($3600) returned to karanchawla09
*** TURN *** [8c 8h 6c] [2d]
*** RIVER *** [8c 8h 6c 2d] [2h]
*** SHOW DOWN ***
karanchawla09: shows [4c Jh 3c 6s]
harshb_95: shows [Kd 7d 8s Ts]
harshb_95 collected $22600 from pot
*** SUMMARY ***
Total pot $23400 | Rake $800
Board [8c 8h 6c 2d 2h]
Seat 1: harshb_95 (button) showed [Kd 7d 8s Ts] and won ($22600)
Seat 2: gaganhyd (small blind) folded before Flop
Seat 4: TurnOnTuneInDropOut (big blind) folded before Flop
Seat 5: kimjongun folded before Flop (didn't bet)
Seat 6: karanchawla09 showed [4c Jh 3c 6s] and lost

PokerStars Hand #1255059689: Omaha Pot Limit ($200/$400 USD) - 2020/10/23 13:28:25 ET
Table 'ADA675920511' 6-max Seat #2 is the button
Seat 1: harshb_95 ($22600 in chips)
Seat 2: gaganhyd ($19624 in chips)
Seat 4: TurnOnTuneInDropOut ($42380 in chips)
Seat 5: kimjongun ($42600 in chips)
Seat 6: karanchawla09 ($17505 in chips)
TurnOnTuneInDropOut: posts small blind $200
kimjongun: posts big blind $400
*** HOLE CARDS ***
Dealt to TurnOnTuneInDropOut [3c Th Ah 2h]
karanchawla09: raises $1000 to $1400
harshb_95: folds
gaganhyd: folds
TurnOnTuneInDropOut: folds
kimjongun: calls $1000
*** FLOP *** [5s Kc Kh]
kimjongun: checks
karanchawla09: checks
*** TURN *** [5s Kc Kh] [8s]
kimjongun: bets $1050
karanchawla09: calls $1050
*** RIVER *** [5s Kc Kh 8s] [2d]
kimjongun: bets $2550
karanchawla09: calls $2550
*** SHOW DOWN ***
kimjongun: mucks hand
karanchawla09: shows [4d 9d 9s As]
karanchawla09 collected $9791 from pot
*** SUMMARY ***
Total pot $10200 | Rake $409
Board [5s Kc Kh 8s 2d]
Seat 1: harshb_95 folded before Flop (didn't bet)
Seat 2: gaganhyd (button) folded before Flop (didn't bet)
Seat 4: TurnOnTuneInDropOut (small blind) folded before Flop
Seat 5: kimjongun (big blind) mucked
Seat 6: karanchawla09 showed [4d 9d 9s As] and won ($9791)

PokerStars Hand #1255059691: Omaha Pot Limit ($200/$400 USD) - 2020/10/23 13:30:15 ET
Table 'ADA675920511' 6-max Seat #5 is the button
Seat 1: harshb_95 ($21000 in chips)
Seat 2: gaganhyd ($19624 in chips)
Seat 4: TurnOnTuneInDropOut ($42180 in chips)
Seat 5: kimjongun ($60696 in chips)
harshb_95: posts small blind $200
gaganhyd: posts big blind $400
*** HOLE CARDS ***
Dealt to TurnOnTuneInDropOut [Ts Ah Kc Tc]
TurnOnTuneInDropOut: raises $1000 to $1400
kimjongun: folds
harshb_95: folds
gaganhyd: folds
Uncalled bet ($1000) returned to TurnOnTuneInDropOut
TurnOnTuneInDropOut collected $1000 from pot
TurnOnTuneInDropOut: doesn't show hand
*** SUMMARY ***
Total pot $1000 | Rake $0
Seat 1: harshb_95 (small blind) folded before Flop
Seat 2: gaganhyd (big blind) folded before Flop
Seat 4: TurnOnTuneInDropOut collected ($1000)
Seat 5: kimjongun (button) folded before Flop (didn't bet)

PokerStars Hand #1255059692: Omaha Pot Limit ($200/$400 USD) - 2020/10/23 13:30:30 ET
Table 'ADA675920511' 6-max Seat #1 is the button
Seat 1: harshb_95 ($20800 in chips)
Seat 2: gaganhyd ($19224 in chips)
Seat 4: TurnOnTuneInDropOut ($42780 in chips)
Seat 5: kimjongun ($60696 in chips)
gaganhyd: posts small blind $200
TurnOnTuneInDropOut: posts big blind $400
*** HOLE CARDS ***
Dealt to TurnOnTuneInDropOut [7c Kd Ah 6c]
kimjongun: folds
harshb_95: raises $650 to $1050
gaganhyd: folds
TurnOnTuneInDropOut: calls $650
*** FLOP *** [5h 3d Ts]
TurnOnTuneInDropOut: checks
harshb_95: bets $1725
TurnOnTuneInDropOut: raises $3882 to $5607
harshb_95: raises $13514 to $19121
TurnOnTuneInDropOut: folds
Uncalled bet ($13514) returned to harshb_95
harshb_95 collected $12972 from pot
harshb_95: doesn't show hand
*** SUMMARY ***
Total pot $13514 | Rake $542
Board [5h 3d Ts]
Seat 1: harshb_95 (button) collected ($12972)
Seat 2: gaganhyd (small blind) folded before Flop
Seat 4: TurnOnTuneInDropOut (big blind) folded on the Flop
Seat 5: kimjongun folded before Flop (didn't bet)

PokerStars Hand #1255059693: Omaha Pot Limit ($200/$400 USD) - 2020/10/23 13:30:59 ET
Table 'ADA675920511' 6-max Seat #2 is the button
Seat 1: harshb_95 ($27115 in chips)
Seat 2: gaganhyd ($19024 in chips)
Seat 4: TurnOnTuneInDropOut ($36123 in chips)
Seat 5: kimjongun ($60696 in chips)
TurnOnTuneInDropOut: posts small blind $200
kimjongun: posts big blind $400
*** HOLE CARDS ***
Dealt to TurnOnTuneInDropOut [9c Ah Kh Jc]
harshb_95: folds
gaganhyd: folds
TurnOnTuneInDropOut: raises $800 to $1200
kimjongun: calls $800
*** FLOP *** [8h 4c 7d]
TurnOnTuneInDropOut: checks
kimjongun: checks
*** TURN *** [8h 4c 7d] [Jd]
TurnOnTuneInDropOut: bets $2400
kimjongun: folds
Uncalled bet ($2400) returned to TurnOnTuneInDropOut
TurnOnTuneInDropOut collected $2304 from pot
TurnOnTuneInDropOut: doesn't show hand
*** SUMMARY ***
Total pot $2400 | Rake $96
Board [8h 4c 7d Jd]
Seat 1: harshb_95 folded before Flop (didn't bet)
Seat 2: gaganhyd (button) folded before Flop (didn't bet)
Seat 4: TurnOnTuneInDropOut (small blind) collected ($2304)
Seat 5: kimjongun (big blind) folded on the Turn

PokerStars Hand #1255059694: Omaha Pot Limit ($200/$400 USD) - 2020/10/23 13:31:50 ET
Table 'ADA675920511' 6-max Seat #4 is the button
Seat 1: harshb_95 ($27115 in chips)
Seat 2: gaganhyd ($19024 in chips)
Seat 4: TurnOnTuneInDropOut ($37227 in chips)
Seat 5: kimjongun ($59496 in chips)
kimjongun: posts small blind $200
harshb_95: posts big blind $400
*** HOLE CARDS ***
Dealt to TurnOnTuneInDropOut [Jd Th Qs 3h]
gaganhyd: raises $400 to $800
TurnOnTuneInDropOut: folds
kimjongun: folds
harshb_95: calls $400
*** FLOP *** [2s Jh Ts]
harshb_95: checks
gaganhyd: bets $900
harshb_95: folds
Uncalled bet ($900) returned to gaganhyd
gaganhyd collected $1728 from pot
gaganhyd: doesn't show hand
*** SUMMARY ***
Total pot $1800 | Rake $72
Board [2s Jh Ts]
Seat 1: harshb_95 (big blind) folded on the Flop
Seat 2: gaganhyd collected ($1728)
Seat 4: TurnOnTuneInDropOut (button) folded before Flop (didn't bet)
Seat 5: kimjongun (small blind) folded before Flop

PokerStars Hand #1255059695: Omaha Pot Limit ($200/$400 USD) - 2020/10/23 13:32:37 ET
Table 'ADA675920511' 6-max Seat #5 is the button
Seat 1: harshb_95 ($26315 in chips)
Seat 2: gaganhyd ($19952 in chips)
Seat 4: TurnOnTuneInDropOut ($37227 in chips)
Seat 5: kimjongun ($59296 in chips)
harshb_95: posts small blind $200
gaganhyd: posts big blind $400
*** HOLE CARDS ***
Dealt to TurnOnTuneInDropOut [6d 2h 6c 2d]
TurnOnTuneInDropOut: raises $1000 to $1400
kimjongun: calls $1400
harshb_95: folds
gaganhyd: folds
*** FLOP *** [5s 9h 8h]
TurnOnTuneInDropOut: checks
kimjongun: checks
*** TURN *** [5s 9h 8h] [Kd]
TurnOnTuneInDropOut: bets $3400
kimjongun: folds
Uncalled bet ($3400) returned to TurnOnTuneInDropOut
TurnOnTuneInDropOut collected $3264 from pot
TurnOnTuneInDropOut: doesn't show hand
*** SUMMARY ***
Total pot $3400 | Rake $136
Board [5s 9h 8h Kd]
Seat 1: harshb_95 (small blind) folded before Flop
Seat 2: gaganhyd (big blind) folded before Flop
Seat 4: TurnOnTuneInDropOut collected ($3264)
Seat 5: kimjongun (button) folded on the Turn

PokerStars Hand #1255059696: Omaha Pot Limit ($200/$400 USD) - 2020/10/23 13:33:19 ET
Table 'ADA675920511' 6-max Seat #1 is the button
Seat 1: harshb_95 ($26115 in chips)
Seat 2: gaganhyd ($19552 in chips)
Seat 4: TurnOnTuneInDropOut ($39091 in chips)
Seat 5: kimjongun ($57896 in chips)
gaganhyd: posts small blind $200
TurnOnTuneInDropOut: posts big blind $400
*** HOLE CARDS ***
Dealt to TurnOnTuneInDropOut [2c 3c 9d 2h]
kimjongun: folds
harshb_95: folds
gaganhyd: folds
Uncalled bet ($200) returned to TurnOnTuneInDropOut
TurnOnTuneInDropOut collected $400 from pot
TurnOnTuneInDropOut: doesn't show hand
*** SUMMARY ***
Total pot $400 | Rake $0
Seat 1: harshb_95 (button) folded before Flop (didn't bet)
Seat 2: gaganhyd (small blind) folded before Flop
Seat 4: TurnOnTuneInDropOut (big blind) collected ($400)
Seat 5: kimjongun folded before Flop (didn't bet)

PokerStars Hand #1255059697: Omaha Pot Limit ($200/$400 USD) - 2020/10/23 13:33:59 ET
Table 'ADA675920511' 6-max Seat #2 is the button
Seat 1: harshb_95 ($26115 in chips)
Seat 2: gaganhyd ($19352 in chips)
Seat 4: TurnOnTuneInDropOut ($39291 in chips)
Seat 5: kimjongun ($57896 in chips)
TurnOnTuneInDropOut: posts small blind $200
kimjongun: posts big blind $400
*** HOLE CARDS ***
Dealt to TurnOnTuneInDropOut [4h Ks 3c 3d]
harshb_95: raises $1000 to $1400
gaganhyd: folds
TurnOnTuneInDropOut: folds
kimjongun: calls $1000
*** FLOP *** [8d 7h 2s]
kimjongun: bets $2250
harshb_95: raises $2250 to $4500
kimjongun: calls $2250
*** TURN *** [8d 7h 2s] [3s]
kimjongun: checks
harshb_95: bets $12000
kimjongun: raises $12000 to $24000
harshb_95: calls $8215 and is all-in
Uncalled bet ($3785) returned to kimjongun
*** RIVER *** [8d 7h 2s 3s] [Kc]
*** SHOW DOWN ***
kimjongun: shows [7d Qd Td Ts]
harshb_95: shows [Th 7c 7s 9h]
harshb_95 collected $51630 from pot
*** SUMMARY ***
Total pot $52430 | Rake $800
Board [8d 7h 2s 3s Kc]
Seat 1: harshb_95 showed [Th 7c 7s 9h] and won ($51630)
Seat 2: gaganhyd (button) folded before Flop (didn't bet)
Seat 4: TurnOnTuneInDropOut (small blind) folded before Flop
Seat 5: kimjongun (big blind) showed [7d Qd Td Ts] and lost

PokerStars Hand #1255059699: Omaha Pot Limit ($200/$400 USD) - 2020/10/23 13:35:36 ET
Table 'ADA675920511' 6-max Seat #5 is the button
Seat 1: harshb_95 ($51630 in chips)
Seat 2: gaganhyd ($19352 in chips)
Seat 4: TurnOnTuneInDropOut ($37691 in chips)
Seat 5: kimjongun ($31581 in chips)
Seat 6: Sam565 ($13600 in chips)
Sam565: posts small blind $200
harshb_95: posts big blind $400
*** HOLE CARDS ***
Dealt to TurnOnTuneInDropOut [7s Tc 7c 3s]
gaganhyd: folds
TurnOnTuneInDropOut: raises $1000 to $1400
kimjongun: calls $1400
Sam565: calls $1200
harshb_95: folds
*** FLOP *** [Ah 2h 5c]
Sam565: bets $4600
TurnOnTuneInDropOut: folds
kimjongun: folds
Uncalled bet ($4600) returned to Sam565
Sam565 collected $4416 from pot
Sam565: doesn't show hand
*** SUMMARY ***
Total pot $4600 | Rake $184
Board [Ah 2h 5c]
Seat 1: harshb_95 (big blind) folded before Flop
Seat 2: gaganhyd folded before Flop (didn't bet)
Seat 4: TurnOnTuneInDropOut folded on the Flop
Seat 5: kimjongun (button) folded on the Flop
Seat 6: Sam565 (small blind) collected ($4416)

PokerStars Hand #1255059700: Omaha Pot Limit ($200/$400 USD) - 2020/10/23 13:36:15 ET
Table 'ADA675920511' 6-max Seat #6 is the button
Seat 1: harshb_95 ($51230 in chips)
Seat 2: gaganhyd ($19352 in chips)
Seat 4: TurnOnTuneInDropOut ($48000 in chips)
Seat 5: kimjongun ($30181 in chips)
Seat 6: Sam565 ($16616 in chips)
harshb_95: posts small blind $200
gaganhyd: posts big blind $400
*** HOLE CARDS ***
Dealt to TurnOnTuneInDropOut [6c 5c 8d 9s]
TurnOnTuneInDropOut: folds
kimjongun: folds
Sam565: folds
harshb_95: folds
Uncalled bet ($200) returned to gaganhyd
gaganhyd collected $400 from pot
gaganhyd: doesn't show hand
*** SUMMARY ***
Total pot $400 | Rake $0
Seat 1: harshb_95 (small blind) folded before Flop
Seat 2: gaganhyd (big blind) collected ($400)
Seat 4: TurnOnTuneInDropOut folded before Flop (didn't bet)
Seat 5: kimjongun folded before Flop (didn't bet)
Seat 6: Sam565 (button) folded before Flop (didn't bet)

PokerStars Hand #1255059701: Omaha Pot Limit ($200/$400 USD) - 2020/10/23 13:36:29 ET
Table 'ADA675920511' 6-max Seat #1 is the button
Seat 1: harshb_95 ($51030 in chips)
Seat 2: gaganhyd ($19552 in chips)
Seat 3: slotmachine ($28231 in chips)
Seat 4: TurnOnTuneInDropOut ($48000 in chips)
Seat 5: kimjongun ($30181 in chips)
Seat 6: Sam565 ($16616 in chips)
gaganhyd: posts small blind $200
slotmachine: posts big blind $400
*** HOLE CARDS ***
Dealt to TurnOnTuneInDropOut [Jd 6d 2c 6h]
TurnOnTuneInDropOut: folds
kimjongun: folds
Sam565: folds
harshb_95: folds
gaganhyd: raises $800 to $1200
slotmachine: calls $800
*** FLOP *** [7c 5d 5s]
gaganhyd: checks
slotmachine: checks
*** TURN *** [7c 5d 5s] [5h]
gaganhyd: bets $1200
slotmachine: folds
Uncalled bet ($1200) returned to gaganhyd
gaganhyd collected $2304 from pot
gaganhyd: doesn't show hand
*** SUMMARY ***
Total pot $2400 | Rake $96
Board [7c 5d 5s 5h]
Seat 1: harshb_95 (button) folded before Flop (didn't bet)
Seat 2: gaganhyd (small blind) collected ($2304)
Seat 3: slotmachine (big blind) folded on the Turn
Seat 4: TurnOnTuneInDropOut folded before Flop (didn't bet)
Seat 5: kimjongun folded before Flop (didn't bet)
Seat 6: Sam565 folded before Flop (didn't bet)

PokerStars Hand #1255059704: Omaha Pot Limit ($200/$400 USD) - 2020/10/23 13:39:08 ET
Table 'ADA675920511' 6-max Seat #4 is the button
Seat 1: harshb_95 ($51590 in chips)
Seat 2: gaganhyd ($20656 in chips)
Seat 3: slotmachine ($48000 in chips)
Seat 4: TurnOnTuneInDropOut ($46740 in chips)
Seat 5: kimjongun ($29781 in chips)
Seat 6: Sam565 ($17783 in chips)
kimjongun: posts small blind $200
Sam565: posts big blind $400
*** HOLE CARDS ***
Dealt to TurnOnTuneInDropOut [Jh Ts Qs Td]
harshb_95: folds
gaganhyd: folds
slotmachine: folds
TurnOnTuneInDropOut: raises $1000 to $1400
kimjongun: folds
Sam565: folds
Uncalled bet ($1000) returned to TurnOnTuneInDropOut
TurnOnTuneInDropOut collected $1000 from pot
TurnOnTuneInDropOut: doesn't show hand
*** SUMMARY ***
Total pot $1000 | Rake $0
Seat 1: harshb_95 folded before Flop (didn't bet)
Seat 2: gaganhyd folded before Flop (didn't bet)
Seat 3: slotmachine folded before Flop (didn't bet)
Seat 4: TurnOnTuneInDropOut (button) collected ($1000)
Seat 5: kimjongun (small blind) folded before Flop
Seat 6: Sam565 (big blind) folded before Flop

PokerStars Hand #1255059705: Omaha Pot Limit ($200/$400 USD) - 2020/10/23 13:39:27 ET
Table 'ADA675920511' 6-max Seat #5 is the button
Seat 1: harshb_95 ($51590 in chips)
Seat 2: gaganhyd ($20656 in chips)
Seat 3: slotmachine ($48000 in chips)
Seat 4: TurnOnTuneInDropOut ($47340 in chips)
Seat 5: kimjongun ($29581 in chips)
Seat 6: Sam565 ($17383 in chips)
Sam565: posts small blind $200
harshb_95: posts big blind $400
*** HOLE CARDS ***
Dealt to TurnOnTuneInDropOut [Tc 7d Ts 3d]
gaganhyd: folds
slotmachine: folds
TurnOnTuneInDropOut: folds
kimjongun: folds
Sam565: calls $200
harshb_95: raises $600 to $1000
Sam565: calls $600
*** FLOP *** [8c 4s 2s]
Sam565: checks
harshb_95: bets $1000
Sam565: calls $1000
*** TURN *** [8c 4s 2s] [5s]
Sam565: checks
harshb_95: checks
*** RIVER *** [8c 4s 2s 5s] [2d]
Sam565: checks
harshb_95: checks
*** SHOW DOWN ***
Sam565: shows [6s 5h 8d Qh]
harshb_95: shows [Qc Th 7c Js]
Sam565 collected $3840 from pot
*** SUMMARY ***
Total pot $4000 | Rake $160
Board [8c 4s 2s 5s 2d]
Seat 1: harshb_95 (big blind) showed [Qc Th 7c Js] and lost
Seat 2: gaganhyd folded before Flop (didn't bet)
Seat 3: slotmachine folded before Flop (didn't bet)
Seat 4: TurnOnTuneInDropOut folded before Flop (didn't bet)
Seat 5: kimjongun (button) folded before Flop (didn't bet)
Seat 6: Sam565 (small blind) showed [6s 5h 8d Qh] and won ($3840)

PokerStars Hand #1255059706: Omaha Pot Limit ($200/$400 USD) - 2020/10/23 13:40:21 ET
Table 'ADA675920511' 6-max Seat #6 is the button
Seat 1: harshb_95 ($49590 in chips)
Seat 2: gaganhyd ($20656 in chips)
Seat 3: slotmachine ($48000 in chips)
Seat 4: TurnOnTuneInDropOut ($47340 in chips)
Seat 5: kimjongun ($29581 in chips)
Seat 6: Sam565 ($19223 in chips)
harshb_95: posts small blind $200
gaganhyd: posts big blind $400
*** HOLE CARDS ***
Dealt to TurnOnTuneInDropOut [Th 8c 3c Tc]
slotmachine: folds
TurnOnTuneInDropOut: folds
kimjongun: folds
Sam565: folds
harshb_95: folds
Uncalled bet ($200) returned to gaganhyd
gaganhyd collected $400 from pot
gaganhyd: doesn't show hand
*** SUMMARY ***
Total pot $400 | Rake $0
Seat 1: harshb_95 (small blind) folded before Flop
Seat 2: gaganhyd (big blind) collected ($400)
Seat 3: slotmachine folded before Flop (didn't bet)
Seat 4: TurnOnTuneInDropOut folded before Flop (didn't bet)
Seat 5: kimjongun folded before Flop (didn't bet)
Seat 6: Sam565 (button) folded before Flop (didn't bet)

PokerStars Hand #1255059707: Omaha Pot Limit ($200/$400 USD) - 2020/10/23 13:40:52 ET
Table 'ADA675920511' 6-max Seat #2 is the button
Seat 2: gaganhyd ($20856 in chips)
Seat 3: slotmachine ($48000 in chips)
Seat 4: TurnOnTuneInDropOut ($47340 in chips)
Seat 5: kimjongun ($29581 in chips)
Seat 6: Sam565 ($19223 in chips)
slotmachine: posts small blind $200
TurnOnTuneInDropOut: posts big blind $400
*** HOLE CARDS ***
Dealt to TurnOnTuneInDropOut [Jc Js 7h 7d]
kimjongun: folds
Sam565: folds
gaganhyd: folds
slotmachine: folds
Uncalled bet ($200) returned to TurnOnTuneInDropOut
TurnOnTuneInDropOut collected $400 from pot
TurnOnTuneInDropOut: doesn't show hand
*** SUMMARY ***
Total pot $400 | Rake $0
Seat 2: gaganhyd (button) folded before Flop (didn't bet)
Seat 3: slotmachine (small blind) folded before Flop
Seat 4: TurnOnTuneInDropOut (big blind) collected ($400)
Seat 5: kimjongun folded before Flop (didn't bet)
Seat 6: Sam565 folded before Flop (didn't bet)

PokerStars Hand #1255059709: Omaha Pot Limit ($200/$400 USD) - 2020/10/23 13:42:22 ET
Table 'ADA675920511' 6-max Seat #4 is the button
Seat 2: gaganhyd ($20856 in chips)
Seat 3: slotmachine ($47800 in chips)
Seat 4: TurnOnTuneInDropOut ($47340 in chips)
Seat 5: kimjongun ($24581 in chips)
Seat 6: Sam565 ($24014 in chips)
kimjongun: posts small blind $200
Sam565: posts big blind $400
*** HOLE CARDS ***
Dealt to TurnOnTuneInDropOut [Jh Qc Qs 4d]
gaganhyd: folds
slotmachine: raises $1000 to $1400
TurnOnTuneInDropOut: folds
kimjongun: folds
Sam565: folds
Uncalled bet ($1000) returned to slotmachine
slotmachine collected $1000 from pot
slotmachine: doesn't show hand
*** SUMMARY ***
Total pot $1000 | Rake $0
Seat 2: gaganhyd folded before Flop (didn't bet)
Seat 3: slotmachine collected ($1000)
Seat 4: TurnOnTuneInDropOut (button) folded before Flop (didn't bet)
Seat 5: kimjongun (small blind) folded before Flop
Seat 6: Sam565 (big blind) folded before Flop

PokerStars Hand #1255059710: Omaha Pot Limit ($200/$400 USD) - 2020/10/23 13:42:39 ET
Table 'ADA675920511' 6-max Seat #5 is the button
Seat 2: gaganhyd ($20856 in chips)
Seat 3: slotmachine ($48400 in chips)
Seat 4: TurnOnTuneInDropOut ($47340 in chips)
Seat 5: kimjongun ($24381 in chips)
Seat 6: Sam565 ($23614 in chips)
Sam565: posts small blind $200
gaganhyd: posts big blind $400
*** HOLE CARDS ***
Dealt to TurnOnTuneInDropOut [2h 8d Js 5s]
slotmachine: folds
TurnOnTuneInDropOut: folds
kimjongun: folds
Sam565: calls $200
gaganhyd: raises $800 to $1200
Sam565: calls $800
*** FLOP *** [2d Ad Kh]
Sam565: checks
gaganhyd: bets $1200
Sam565: calls $1200
*** TURN *** [2d Ad Kh] [3h]
Sam565: checks
gaganhyd: bets $4800
Sam565: folds
Uncalled bet ($4800) returned to gaganhyd
gaganhyd collected $4608 from pot
gaganhyd: doesn't show hand
*** SUMMARY ***
Total pot $4800 | Rake $192
Board [2d Ad Kh 3h]
Seat 2: gaganhyd (big blind) collected ($4608)
Seat 3: slotmachine folded before Flop (didn't bet)
Seat 4: TurnOnTuneInDropOut folded before Flop (didn't bet)
Seat 5: kimjongun (button) folded before Flop (didn't bet)
Seat 6: Sam565 (small blind) folded on the Turn

PokerStars Hand #1255059711: Omaha Pot Limit ($200/$400 USD) - 2020/10/23 13:43:23 ET
Table 'ADA675920511' 6-max Seat #6 is the button
Seat 2: gaganhyd ($23064 in chips)
Seat 3: slotmachine ($48400 in chips)
Seat 4: TurnOnTuneInDropOut ($47340 in chips)
Seat 5: kimjongun ($24381 in chips)
Seat 6: Sam565 ($21214 in chips)
gaganhyd: posts small blind $200
slotmachine: posts big blind $400
*** HOLE CARDS ***
Dealt to TurnOnTuneInDropOut [Kc 8h Ad 4s]
TurnOnTuneInDropOut: folds
kimjongun: folds
Sam565: folds
gaganhyd: folds
Uncalled bet ($200) returned to slotmachine
slotmachine collected $400 from pot
slotmachine: doesn't show hand
*** SUMMARY ***
Total pot $400 | Rake $0
Seat 2: gaganhyd (small blind) folded before Flop
Seat 3: slotmachine (big blind) collected ($400)
Seat 4: TurnOnTuneInDropOut folded before Flop (didn't bet)
Seat 5: kimjongun folded before Flop (didn't bet)
Seat 6: Sam565 (button) folded before Flop (didn't bet)

PokerStars Hand #1255059712: Omaha Pot Limit ($200/$400 USD) - 2020/10/23 13:43:39 ET
Table 'ADA675920511' 6-max Seat #2 is the button
Seat 2: gaganhyd ($22864 in chips)
Seat 3: slotmachine ($48600 in chips)
Seat 4: TurnOnTuneInDropOut ($47340 in chips)
Seat 5: kimjongun ($24381 in chips)
Seat 6: Sam565 ($21214 in chips)
slotmachine: posts small blind $200
TurnOnTuneInDropOut: posts big blind $400
*** HOLE CARDS ***
Dealt to TurnOnTuneInDropOut [9s Kd 5d Ts]
kimjongun: raises $600 to $1000
Sam565: folds
gaganhyd: folds
slotmachine: raises $2400 to $3400
TurnOnTuneInDropOut: folds
kimjongun: calls $2400
*** FLOP *** [Ac 4h 8s]
slotmachine: bets $3600
kimjongun: folds
Uncalled bet ($3600) returned to slotmachine
slotmachine collected $6911 from pot
slotmachine: doesn't show hand
*** SUMMARY ***
Total pot $7200 | Rake $289
Board [Ac 4h 8s]
Seat 2: gaganhyd (button) folded before Flop (didn't bet)
Seat 3: slotmachine (small blind) collected ($6911)
Seat 4: TurnOnTuneInDropOut (big blind) folded before Flop
Seat 5: kimjongun folded on the Flop
Seat 6: Sam565 folded before Flop (didn't bet)

PokerStars Hand #1255059714: Omaha Pot Limit ($200/$400 USD) - 2020/10/23 13:45:02 ET
Table 'ADA675920511' 6-max Seat #4 is the button
Seat 2: gaganhyd ($22864 in chips)
Seat 3: slotmachine ($52111 in chips)
Seat 4: TurnOnTuneInDropOut ($46740 in chips)
Seat 5: kimjongun ($21081 in chips)
Seat 6: Sam565 ($21314 in chips)
kimjongun: posts small blind $200
Sam565: posts big blind $400
*** HOLE CARDS ***
Dealt to TurnOnTuneInDropOut [2s Qs 3h Ad]
gaganhyd: raises $650 to $1050
slotmachine: folds
TurnOnTuneInDropOut: folds
kimjongun: folds
Sam565: calls $650
*** FLOP *** [Kh 3c 6s]
Sam565: checks
gaganhyd: bets $1150
Sam565: folds
Uncalled bet ($1150) returned to gaganhyd
gaganhyd collected $2208 from pot
gaganhyd: doesn't show hand
*** SUMMARY ***
Total pot $2300 | Rake $92
Board [Kh 3c 6s]
Seat 2: gaganhyd collected ($2208)
Seat 3: slotmachine folded before Flop (didn't bet)
Seat 4: TurnOnTuneInDropOut (button) folded before Flop (didn't bet)
Seat 5: kimjongun (small blind) folded before Flop
Seat 6: Sam565 (big blind) folded on the Flop

PokerStars Hand #1255059715: Omaha Pot Limit ($200/$400 USD) - 2020/10/23 13:45:32 ET
Table 'ADA675920511' 6-max Seat #5 is the button
Seat 2: gaganhyd ($24022 in chips)
Seat 3: slotmachine ($52111 in chips)
Seat 4: TurnOnTuneInDropOut ($46740 in chips)
Seat 5: kimjongun ($20881 in chips)
Seat 6: Sam565 ($20264 in chips)
Sam565: posts small blind $200
gaganhyd: posts big blind $400
*** HOLE CARDS ***
Dealt to TurnOnTuneInDropOut [Ad Ah Kh 5h]
slotmachine: folds
TurnOnTuneInDropOut: raises $1000 to $1400
kimjongun: folds
Sam565: folds
gaganhyd: folds
Uncalled bet ($1000) returned to TurnOnTuneInDropOut
TurnOnTuneInDropOut collected $1000 from pot
TurnOnTuneInDropOut: doesn't show hand
*** SUMMARY ***
Total pot $1000 | Rake $0
Seat 2: gaganhyd (big blind) folded before Flop
Seat 3: slotmachine folded before Flop (didn't bet)
Seat 4: TurnOnTuneInDropOut collected ($1000)
Seat 5: kimjongun (button) folded before Flop (didn't bet)
Seat 6: Sam565 (small blind) folded before Flop

PokerStars Hand #1255059716: Omaha Pot Limit ($200/$400 USD) - 2020/10/23 13:46:24 ET
Table 'ADA675920511' 6-max Seat #6 is the button
Seat 2: gaganhyd ($23622 in chips)
Seat 3: slotmachine ($52111 in chips)
Seat 4: TurnOnTuneInDropOut ($47340 in chips)
Seat 5: kimjongun ($20881 in chips)
Seat 6: Sam565 ($20064 in chips)
gaganhyd: posts small blind $200
slotmachine: posts big blind $400
*** HOLE CARDS ***
Dealt to TurnOnTuneInDropOut [3d 9d 6c Qc]
TurnOnTuneInDropOut: folds
kimjongun: folds
Sam565: calls $400
gaganhyd: folds
slotmachine: checks
*** FLOP *** [Jh 9h 5s]
slotmachine: checks
Sam565: bets $1000
slotmachine: folds
Uncalled bet ($1000) returned to Sam565
Sam565 collected $960 from pot
Sam565: doesn't show hand
*** SUMMARY ***
Total pot $1000 | Rake $40
Board [Jh 9h 5s]
Seat 2: gaganhyd (small blind) folded before Flop
Seat 3: slotmachine (big blind) folded on the Flop
Seat 4: TurnOnTuneInDropOut folded before Flop (didn't bet)
Seat 5: kimjongun folded before Flop (didn't bet)
Seat 6: Sam565 (button) collected ($960)

PokerStars Hand #1255059717: Omaha Pot Limit ($200/$400 USD) - 2020/10/23 13:46:54 ET
Table 'ADA675920511' 6-max Seat #2 is the button
Seat 2: gaganhyd ($23422 in chips)
Seat 3: slotmachine ($51711 in chips)
Seat 4: TurnOnTuneInDropOut ($47340 in chips)
Seat 5: kimjongun ($20881 in chips)
Seat 6: Sam565 ($20624 in chips)
slotmachine: posts small blind $200
TurnOnTuneInDropOut: posts big blind $400
*** HOLE CARDS ***
Dealt to TurnOnTuneInDropOut [Kd Ac 5s 7h]
kimjongun: folds
Sam565: folds
gaganhyd: folds
slotmachine: raises $800 to $1200
TurnOnTuneInDropOut: folds
Uncalled bet ($800) returned to slotmachine
slotmachine collected $800 from pot
slotmachine: doesn't show hand
*** SUMMARY ***
Total pot $800 | Rake $0
Seat 2: gaganhyd (button) folded before Flop (didn't bet)
Seat 3: slotmachine (small blind) collected ($800)
Seat 4: TurnOnTuneInDropOut (big blind) folded before Flop
Seat 5: kimjongun folded before Flop (didn't bet)
Seat 6: Sam565 folded before Flop (didn't bet)

PokerStars Hand #1255059718: Omaha Pot Limit ($200/$400 USD) - 2020/10/23 13:47:10 ET
Table 'ADA675920511' 6-max Seat #3 is the button
Seat 2: gaganhyd ($23422 in chips)
Seat 3: slotmachine ($52111 in chips)
Seat 4: TurnOnTuneInDropOut ($46940 in chips)
Seat 5: kimjongun ($26097 in chips)
Seat 6: Sam565 ($20624 in chips)
TurnOnTuneInDropOut: posts small blind $200
kimjongun: posts big blind $400
*** HOLE CARDS ***
Dealt to TurnOnTuneInDropOut [Jh Td 9d Jc]
Sam565: folds
gaganhyd: folds
slotmachine: raises $1000 to $1400
TurnOnTuneInDropOut: calls $1200
kimjongun: folds
*** FLOP *** [6d 3c Ts]
TurnOnTuneInDropOut: checks
slotmachine: bets $3200
TurnOnTuneInDropOut: calls $3200
*** TURN *** [6d 3c Ts] [9s]
TurnOnTuneInDropOut: checks
slotmachine: checks
*** RIVER *** [6d 3c Ts 9s] [4h]
TurnOnTuneInDropOut: bets $3936
slotmachine: raises $6768 to $10704
TurnOnTuneInDropOut: raises $31008 to $41712
slotmachine: folds
Uncalled bet ($31008) returned to TurnOnTuneInDropOut
TurnOnTuneInDropOut collected $30208 from pot
TurnOnTuneInDropOut: doesn't show hand
*** SUMMARY ***
Total pot $31008 | Rake $800
Board [6d 3c Ts 9s 4h]
Seat 2: gaganhyd folded before Flop (didn't bet)
Seat 3: slotmachine (button) folded on the River
Seat 4: TurnOnTuneInDropOut (small blind) collected ($30208)
Seat 5: kimjongun (big blind) folded before Flop
Seat 6: Sam565 folded before Flop (didn't bet)

PokerStars Hand #1255059719: Omaha Pot Limit ($200/$400 USD) - 2020/10/23 13:48:33 ET
Table 'ADA675920511' 6-max Seat #4 is the button
Seat 1: soundfsilenz ($42000 in chips)
Seat 2: gaganhyd ($23422 in chips)
Seat 3: slotmachine ($48000 in chips)
Seat 4: TurnOnTuneInDropOut ($61844 in chips)
Seat 5: kimjongun ($25697 in chips)
kimjongun: posts small blind $200
soundfsilenz: posts big blind $400
*** HOLE CARDS ***
Dealt to TurnOnTuneInDropOut [Ts Ac 7d Td]
gaganhyd: raises $650 to $1050
slotmachine: folds
TurnOnTuneInDropOut: folds
kimjongun: folds
soundfsilenz: folds
Uncalled bet ($650) returned to gaganhyd
gaganhyd collected $1000 from pot
gaganhyd: doesn't show hand
*** SUMMARY ***
Total pot $1000 | Rake $0
Seat 1: soundfsilenz (big blind) folded before Flop
Seat 2: gaganhyd collected ($1000)
Seat 3: slotmachine folded before Flop (didn't bet)
Seat 4: TurnOnTuneInDropOut (button) folded before Flop (didn't bet)
Seat 5: kimjongun (small blind) folded before Flop

PokerStars Hand #1255059720: Omaha Pot Limit ($200/$400 USD) - 2020/10/23 13:48:57 ET
Table 'ADA675920511' 6-max Seat #5 is the button
Seat 1: soundfsilenz ($41600 in chips)
Seat 2: gaganhyd ($24022 in chips)
Seat 3: slotmachine ($48000 in chips)
Seat 4: TurnOnTuneInDropOut ($61844 in chips)
Seat 5: kimjongun ($25497 in chips)
soundfsilenz: posts small blind $200
gaganhyd: posts big blind $400
*** HOLE CARDS ***
Dealt to TurnOnTuneInDropOut [8d Ts 8h Ad]
slotmachine: folds
TurnOnTuneInDropOut: raises $1000 to $1400
kimjongun: folds
soundfsilenz: folds
gaganhyd: folds
Uncalled bet ($1000) returned to TurnOnTuneInDropOut
TurnOnTuneInDropOut collected $1000 from pot
TurnOnTuneInDropOut: doesn't show hand
*** SUMMARY ***
Total pot $1000 | Rake $0
Seat 1: soundfsilenz (small blind) folded before Flop
Seat 2: gaganhyd (big blind) folded before Flop
Seat 3: slotmachine folded before Flop (didn't bet)
Seat 4: TurnOnTuneInDropOut collected ($1000)
Seat 5: kimjongun (button) folded before Flop (didn't bet)

PokerStars Hand #1255059721: Omaha Pot Limit ($200/$400 USD) - 2020/10/23 13:49:21 ET
Table 'ADA675920511' 6-max Seat #1 is the button
Seat 1: soundfsilenz ($41400 in chips)
Seat 2: gaganhyd ($23622 in chips)
Seat 3: slotmachine ($48000 in chips)
Seat 4: TurnOnTuneInDropOut ($62444 in chips)
Seat 5: kimjongun ($25497 in chips)
gaganhyd: posts small blind $200
slotmachine: posts big blind $400
*** HOLE CARDS ***
Dealt to TurnOnTuneInDropOut [8c 7h 2h 3d]
TurnOnTuneInDropOut: folds
kimjongun: folds
soundfsilenz: raises $1000 to $1400
gaganhyd: folds
slotmachine: folds
Uncalled bet ($1000) returned to soundfsilenz
soundfsilenz collected $1000 from pot
soundfsilenz: doesn't show hand
*** SUMMARY ***
Total pot $1000 | Rake $0
Seat 1: soundfsilenz (button) collected ($1000)
Seat 2: gaganhyd (small blind) folded before Flop
Seat 3: slotmachine (big blind) folded before Flop
Seat 4: TurnOnTuneInDropOut folded before Flop (didn't bet)
Seat 5: kimjongun folded before Flop (didn't bet)

PokerStars Hand #1255059722: Omaha Pot Limit ($200/$400 USD) - 2020/10/23 13:49:45 ET
Table 'ADA675920511' 6-max Seat #2 is the button
Seat 1: soundfsilenz ($42000 in chips)
Seat 2: gaganhyd ($23422 in chips)
Seat 3: slotmachine ($47600 in chips)
Seat 4: TurnOnTuneInDropOut ($62444 in chips)
Seat 5: kimjongun ($25497 in chips)
slotmachine: posts small blind $200
TurnOnTuneInDropOut: posts big blind $400
*** HOLE CARDS ***
Dealt to TurnOnTuneInDropOut [6d Qh 2s Tc]
kimjongun: raises $600 to $1000
soundfsilenz: folds
gaganhyd: calls $1000
slotmachine: folds
TurnOnTuneInDropOut: folds
*** FLOP *** [Ts 8h 4d]
kimjongun: checks
gaganhyd: bets $1300
kimjongun: calls $1300
*** TURN *** [Ts 8h 4d] [4s]
kimjongun: checks
gaganhyd: checks
*** RIVER *** [Ts 8h 4d 4s] [5d]
kimjongun: bets $2600
gaganhyd: folds
Uncalled bet ($2600) returned to kimjongun
kimjongun collected $4991 from pot
kimjongun: doesn't show hand
*** SUMMARY ***
Total pot $5200 | Rake $209
Board [Ts 8h 4d 4s 5d]
Seat 1: soundfsilenz folded before Flop (didn't bet)
Seat 2: gaganhyd (button) folded on the River
Seat 3: slotmachine (small blind) folded before Flop
Seat 4: TurnOnTuneInDropOut (big blind) folded before Flop
Seat 5: kimjongun collected ($4991)

PokerStars Hand #1255059724: Omaha Pot Limit ($200/$400 USD) - 2020/10/23 13:51:26 ET
Table 'ADA675920511' 6-max Seat #4 is the button
Seat 1: soundfsilenz ($42000 in chips)
Seat 2: gaganhyd ($21122 in chips)
Seat 3: slotmachine ($45600 in chips)
Seat 4: TurnOnTuneInDropOut ($61844 in chips)
Seat 5: kimjongun ($27788 in chips)
Seat 6: vikram2013 ($14620 in chips)
kimjongun: posts small blind $200
vikram2013: posts big blind $400
*** HOLE CARDS ***
Dealt to TurnOnTuneInDropOut [2d Jh 7s 8d]
soundfsilenz: raises $1000 to $1400
gaganhyd: calls $1400
slotmachine: folds
TurnOnTuneInDropOut: folds
kimjongun: folds
vikram2013: folds
*** FLOP *** [3s Qs 5s]
soundfsilenz: checks
gaganhyd: checks
*** TURN *** [3s Qs 5s] [9d]
soundfsilenz: checks
gaganhyd: checks
*** RIVER *** [3s Qs 5s 9d] [Kh]
soundfsilenz: checks
gaganhyd: bets $2550
soundfsilenz: folds
Uncalled bet ($2550) returned to gaganhyd
gaganhyd collected $3264 from pot
gaganhyd: doesn't show hand
*** SUMMARY ***
Total pot $3400 | Rake $136
Board [3s Qs 5s 9d Kh]
Seat 1: soundfsilenz folded on the River
Seat 2: gaganhyd collected ($3264)
Seat 3: slotmachine folded before Flop (didn't bet)
Seat 4: TurnOnTuneInDropOut (button) folded before Flop (didn't bet)
Seat 5: kimjongun (small blind) folded before Flop
Seat 6: vikram2013 (big blind) folded before Flop

PokerStars Hand #1255059725: Omaha Pot Limit ($200/$400 USD) - 2020/10/23 13:52:25 ET
Table 'ADA675920511' 6-max Seat #5 is the button
Seat 1: soundfsilenz ($40600 in chips)
Seat 2: gaganhyd ($22986 in chips)
Seat 3: slotmachine ($45600 in chips)
Seat 4: TurnOnTuneInDropOut ($61844 in chips)
Seat 5: kimjongun ($27588 in chips)
Seat 6: vikram2013 ($14220 in chips)
vikram2013: posts small blind $200
soundfsilenz: posts big blind $400
*** HOLE CARDS ***
Dealt to TurnOnTuneInDropOut [6h 3d 3s 8c]
gaganhyd: folds
slotmachine: folds
TurnOnTuneInDropOut: folds
kimjongun: folds
vikram2013: raises $800 to $1200
soundfsilenz: folds
Uncalled bet ($800) returned to vikram2013
vikram2013 collected $800 from pot
vikram2013: doesn't show hand
*** SUMMARY ***
Total pot $800 | Rake $0
Seat 1: soundfsilenz (big blind) folded before Flop
Seat 2: gaganhyd folded before Flop (didn't bet)
Seat 3: slotmachine folded before Flop (didn't bet)
Seat 4: TurnOnTuneInDropOut folded before Flop (didn't bet)
Seat 5: kimjongun (button) folded before Flop (didn't bet)
Seat 6: vikram2013 (small blind) collected ($800)

PokerStars Hand #1255059726: Omaha Pot Limit ($200/$400 USD) - 2020/10/23 13:53:10 ET
Table 'ADA675920511' 6-max Seat #6 is the button
Seat 1: soundfsilenz ($40200 in chips)
Seat 2: gaganhyd ($22986 in chips)
Seat 3: slotmachine ($45600 in chips)
Seat 4: TurnOnTuneInDropOut ($61844 in chips)
Seat 5: kimjongun ($27588 in chips)
Seat 6: vikram2013 ($14620 in chips)
soundfsilenz: posts small blind $200
gaganhyd: posts big blind $400
*** HOLE CARDS ***
Dealt to TurnOnTuneInDropOut [4d Ah Td Qh]
slotmachine: raises $1000 to $1400
TurnOnTuneInDropOut: calls $1400
kimjongun: folds
vikram2013: folds
soundfsilenz: folds
gaganhyd: calls $1000
*** FLOP *** [Js Kh 6d]
gaganhyd: checks
slotmachine: bets $2904
TurnOnTuneInDropOut: calls $2904
gaganhyd: folds
*** TURN *** [Js Kh 6d] [9s]
slotmachine: checks
TurnOnTuneInDropOut: bets $9698
slotmachine: folds
Uncalled bet ($9698) returned to TurnOnTuneInDropOut
TurnOnTuneInDropOut collected $9799 from pot
TurnOnTuneInDropOut: doesn't show hand
*** SUMMARY ***
Total pot $10208 | Rake $409
Board [Js Kh 6d 9s]
Seat 1: soundfsilenz (small blind) folded before Flop
Seat 2: gaganhyd (big blind) folded on the Flop
Seat 3: slotmachine folded on the Turn
Seat 4: TurnOnTuneInDropOut collected ($9799)
Seat 5: kimjongun folded before Flop (didn't bet)
Seat 6: vikram2013 (button) folded before Flop (didn't bet)

PokerStars Hand #1255059727: Omaha Pot Limit ($200/$400 USD) - 2020/10/23 13:54:03 ET
Table 'ADA675920511' 6-max Seat #1 is the button
Seat 1: soundfsilenz ($40000 in chips)
Seat 2: gaganhyd ($21586 in chips)
Seat 3: slotmachine ($41296 in chips)
Seat 4: TurnOnTuneInDropOut ($67339 in chips)
Seat 5: kimjongun ($27588 in chips)
Seat 6: vikram2013 ($14620 in chips)
gaganhyd: posts small blind $200
slotmachine: posts big blind $400
*** HOLE CARDS ***
Dealt to TurnOnTuneInDropOut [Ac 6h 4c Jd]
TurnOnTuneInDropOut: folds
kimjongun: folds
vikram2013: calls $400
soundfsilenz: folds
gaganhyd: calls $200
slotmachine: checks
*** FLOP *** [6c As 5c]
gaganhyd: checks
slotmachine: checks
vikram2013: checks
*** TURN *** [6c As 5c] [8h]
gaganhyd: checks
slotmachine: bets $792
vikram2013: folds
gaganhyd: folds
Uncalled bet ($792) returned to slotmachine
slotmachine collected $1152 from pot
slotmachine: doesn't show hand
*** SUMMARY ***
Total pot $1200 | Rake $48
Board [6c As 5c 8h]
Seat 1: soundfsilenz (button) folded before Flop (didn't bet)
Seat 2: gaganhyd (small blind) folded on the Turn
Seat 3: slotmachine (big blind) collected ($1152)
Seat 4: TurnOnTuneInDropOut folded before Flop (didn't bet)
Seat 5: kimjongun folded before Flop (didn't bet)
Seat 6: vikram2013 folded on the Turn

PokerStars Hand #1255059730: Omaha Pot Limit ($200/$400 USD) - 2020/10/23 13:57:11 ET
Table 'ADA675920511' 6-max Seat #4 is the button
Seat 1: soundfsilenz ($43767 in chips)
Seat 2: gaganhyd ($21186 in chips)
Seat 3: slotmachine ($40248 in chips)
Seat 4: TurnOnTuneInDropOut ($76739 in chips)
Seat 5: kimjongun ($27188 in chips)
Seat 6: vikram2013 ($2220 in chips)
kimjongun: posts small blind $200
vikram2013: posts big blind $400
*** HOLE CARDS ***
Dealt to TurnOnTuneInDropOut [4d 9s 8h Kd]
soundfsilenz: folds
gaganhyd: folds
slotmachine: folds
TurnOnTuneInDropOut: folds
kimjongun: folds
Uncalled bet ($200) returned to vikram2013
vikram2013 collected $400 from pot
vikram2013: doesn't show hand
*** SUMMARY ***
Total pot $400 | Rake $0
Seat 1: soundfsilenz folded before Flop (didn't bet)
Seat 2: gaganhyd folded before Flop (didn't bet)
Seat 3: slotmachine folded before Flop (didn't bet)
Seat 4: TurnOnTuneInDropOut (button) folded before Flop (didn't bet)
Seat 5: kimjongun (small blind) folded before Flop
Seat 6: vikram2013 (big blind) collected ($400)

PokerStars Hand #1255059731: Omaha Pot Limit ($200/$400 USD) - 2020/10/23 13:57:31 ET
Table 'ADA675920511' 6-max Seat #5 is the button
Seat 1: soundfsilenz ($43767 in chips)
Seat 2: gaganhyd ($21186 in chips)
Seat 3: slotmachine ($40248 in chips)
Seat 4: TurnOnTuneInDropOut ($76739 in chips)
Seat 5: kimjongun ($26988 in chips)
Seat 6: vikram2013 ($2420 in chips)
vikram2013: posts small blind $200
soundfsilenz: posts big blind $400
*** HOLE CARDS ***
Dealt to TurnOnTuneInDropOut [Kc 9c Qh 5c]
gaganhyd: folds
slotmachine: folds
TurnOnTuneInDropOut: folds
kimjongun: folds
vikram2013: raises $800 to $1200
soundfsilenz: raises $2400 to $3600
vikram2013: calls $1220 and is all-in
Uncalled bet ($1180) returned to soundfsilenz
*** FLOP *** [Qc 7s 7d]
*** TURN *** [Qc 7s 7d] [Td]
*** RIVER *** [Qc 7s 7d Td] [5d]
*** SHOW DOWN ***
vikram2013: shows [4h 5s Ad Js]
soundfsilenz: shows [4s 3s Ah 5h]
soundfsilenz collected $2420 from pot
vikram2013 collected $2420 from pot
*** SUMMARY ***
Total pot $4840 | Rake $0
Board [Qc 7s 7d Td 5d]
Seat 1: soundfsilenz (big blind) showed [4s 3s Ah 5h] and won ($2420)
Seat 2: gaganhyd folded before Flop (didn't bet)
Seat 3: slotmachine folded before Flop (didn't bet)
Seat 4: TurnOnTuneInDropOut folded before Flop (didn't bet)
Seat 5: kimjongun (button) folded before Flop (didn't bet)
Seat 6: vikram2013 (small blind) showed [4h 5s Ad Js] and won ($2420)

PokerStars Hand #1255059733: Omaha Pot Limit ($200/$400 USD) - 2020/10/23 13:58:46 ET
Table 'ADA675920511' 6-max Seat #1 is the button
Seat 1: soundfsilenz ($43567 in chips)
Seat 2: gaganhyd ($20786 in chips)
Seat 3: slotmachine ($40248 in chips)
Seat 4: TurnOnTuneInDropOut ($79541 in chips)
Seat 5: kimjongun ($26988 in chips)
gaganhyd: posts small blind $200
slotmachine: posts big blind $400
*** HOLE CARDS ***
Dealt to TurnOnTuneInDropOut [4d 4c 3c 2d]
TurnOnTuneInDropOut: folds
kimjongun: raises $1000 to $1400
soundfsilenz: folds
gaganhyd: folds
slotmachine: raises $3000 to $4400
kimjongun: folds
Uncalled bet ($3000) returned to slotmachine
slotmachine collected $3000 from pot
slotmachine: doesn't show hand
*** SUMMARY ***
Total pot $3000 | Rake $0
Seat 1: soundfsilenz (button) folded before Flop (didn't bet)
Seat 2: gaganhyd (small blind) folded before Flop
Seat 3: slotmachine (big blind) collected ($3000)
Seat 4: TurnOnTuneInDropOut folded before Flop (didn't bet)
Seat 5: kimjongun folded before Flop

PokerStars Hand #1255059734: Omaha Pot Limit ($200/$400 USD) - 2020/10/23 13:59:13 ET
Table 'ADA675920511' 6-max Seat #2 is the button
Seat 1: soundfsilenz ($43567 in chips)
Seat 2: gaganhyd ($20586 in chips)
Seat 3: slotmachine ($48000 in chips)
Seat 4: TurnOnTuneInDropOut ($79541 in chips)
Seat 5: kimjongun ($25588 in chips)
slotmachine: posts small blind $200
TurnOnTuneInDropOut: posts big blind $400
*** HOLE CARDS ***
Dealt to TurnOnTuneInDropOut [Kh Qs Ks 6s]
kimjongun: folds
soundfsilenz: folds
gaganhyd: folds
slotmachine: folds
Uncalled bet ($200) returned to TurnOnTuneInDropOut
TurnOnTuneInDropOut collected $400 from pot
TurnOnTuneInDropOut: doesn't show hand
*** SUMMARY ***
Total pot $400 | Rake $0
Seat 1: soundfsilenz folded before Flop (didn't bet)
Seat 2: gaganhyd (button) folded before Flop (didn't bet)
Seat 3: slotmachine (small blind) folded before Flop
Seat 4: TurnOnTuneInDropOut (big blind) collected ($400)
Seat 5: kimjongun folded before Flop (didn't bet)

PokerStars Hand #1255059756: Omaha Pot Limit ($200/$400 USD) - 2020/10/23 14:11:34 ET
Table 'ADA675920511' 6-max Seat #2 is the button
Seat 1: Prateek1986 ($21375 in chips)
Seat 2: sherpalife ($48000 in chips)
Seat 3: slotmachine ($44468 in chips)
Seat 5: TurnOnTuneInDropOut ($79741 in chips)
Seat 6: soundfsilenz ($38567 in chips)
slotmachine: posts small blind $200
TurnOnTuneInDropOut: posts big blind $400
*** HOLE CARDS ***
Dealt to TurnOnTuneInDropOut [2d 5d 8s Ad]
soundfsilenz: folds
Prateek1986: folds
sherpalife: folds
slotmachine: raises $800 to $1200
TurnOnTuneInDropOut: calls $800
*** FLOP *** [6h 5h Ac]
slotmachine: checks
TurnOnTuneInDropOut: bets $1584
slotmachine: folds
Uncalled bet ($1584) returned to TurnOnTuneInDropOut
TurnOnTuneInDropOut collected $2304 from pot
TurnOnTuneInDropOut: doesn't show hand
*** SUMMARY ***
Total pot $2400 | Rake $96
Board [6h 5h Ac]
Seat 1: Prateek1986 folded before Flop (didn't bet)
Seat 2: sherpalife (button) folded before Flop (didn't bet)
Seat 3: slotmachine (small blind) folded on the Flop
Seat 5: TurnOnTuneInDropOut (big blind) collected ($2304)
Seat 6: soundfsilenz folded before Flop (didn't bet)

PokerStars Hand #1255059758: Omaha Pot Limit ($200/$400 USD) - 2020/10/23 14:13:25 ET
Table 'ADA675920511' 6-max Seat #5 is the button
Seat 1: Prateek1986 ($20075 in chips)
Seat 2: sherpalife ($48000 in chips)
Seat 3: slotmachine ($43268 in chips)
Seat 5: TurnOnTuneInDropOut ($83289 in chips)
Seat 6: soundfsilenz ($37267 in chips)
soundfsilenz: posts small blind $200
Prateek1986: posts big blind $400
*** HOLE CARDS ***
Dealt to TurnOnTuneInDropOut [8h Ks 7h Th]
sherpalife: folds
slotmachine: folds
TurnOnTuneInDropOut: raises $1000 to $1400
soundfsilenz: folds
Prateek1986: calls $1000
*** FLOP *** [Ts 6s Qh]
Prateek1986: checks
TurnOnTuneInDropOut: checks
*** TURN *** [Ts 6s Qh] [Td]
Prateek1986: bets $2250
TurnOnTuneInDropOut: raises $5063 to $7313
Prateek1986: calls $5063
*** RIVER *** [Ts 6s Qh Td] [Js]
Prateek1986: checks
TurnOnTuneInDropOut: checks
*** SHOW DOWN ***
Prateek1986: shows [2d 2c Kh Tc]
TurnOnTuneInDropOut: shows [8h Ks 7h Th]
TurnOnTuneInDropOut collected $8813 from pot
Prateek1986 collected $8813 from pot
*** SUMMARY ***
Total pot $17626 | Rake $0
Board [Ts 6s Qh Td Js]
Seat 1: Prateek1986 (big blind) showed [2d 2c Kh Tc] and won ($8813)
Seat 2: sherpalife folded before Flop (didn't bet)
Seat 3: slotmachine folded before Flop (didn't bet)
Seat 5: TurnOnTuneInDropOut (button) showed [8h Ks 7h Th] and won ($8813)
Seat 6: soundfsilenz (small blind) folded before Flop

PokerStars Hand #1255059759: Omaha Pot Limit ($200/$400 USD) - 2020/10/23 14:14:22 ET
Table 'ADA675920511' 6-max Seat #6 is the button
Seat 1: Prateek1986 ($20175 in chips)
Seat 2: sherpalife ($48000 in chips)
Seat 3: slotmachine ($43268 in chips)
Seat 5: TurnOnTuneInDropOut ($83389 in chips)
Seat 6: soundfsilenz ($37067 in chips)
Prateek1986: posts small blind $200
sherpalife: posts big blind $400
*** HOLE CARDS ***
Dealt to TurnOnTuneInDropOut [Qs 7h Js Kd]
slotmachine: folds
TurnOnTuneInDropOut: folds
soundfsilenz: folds
Prateek1986: raises $800 to $1200
sherpalife: folds
Uncalled bet ($800) returned to Prateek1986
Prateek1986 collected $800 from pot
Prateek1986: doesn't show hand
*** SUMMARY ***
Total pot $800 | Rake $0
Seat 1: Prateek1986 (small blind) collected ($800)
Seat 2: sherpalife (big blind) folded before Flop
Seat 3: slotmachine folded before Flop (didn't bet)
Seat 5: TurnOnTuneInDropOut folded before Flop (didn't bet)
Seat 6: soundfsilenz (button) folded before Flop (didn't bet)

PokerStars Hand #1255059760: Omaha Pot Limit ($200/$400 USD) - 2020/10/23 14:16:06 ET
Table 'ADA675920511' 6-max Seat #1 is the button
Seat 1: Prateek1986 ($20575 in chips)
Seat 2: sherpalife ($47600 in chips)
Seat 3: slotmachine ($43268 in chips)
Seat 5: TurnOnTuneInDropOut ($83389 in chips)
Seat 6: soundfsilenz ($37067 in chips)
sherpalife: posts small blind $200
slotmachine: posts big blind $400
*** HOLE CARDS ***
Dealt to TurnOnTuneInDropOut [Qd 5h 7s 5c]
TurnOnTuneInDropOut: folds
soundfsilenz: folds
Prateek1986: calls $400
sherpalife: folds
slotmachine: checks
*** FLOP *** [7h Qc Td]
slotmachine: checks
Prateek1986: checks
*** TURN *** [7h Qc Td] [4h]
slotmachine: checks
Prateek1986: checks
*** RIVER *** [7h Qc Td 4h] [2c]
slotmachine: checks
Prateek1986: checks
*** SHOW DOWN ***
slotmachine: shows [6d 8s 2s 7c]
Prateek1986: mucks hand
slotmachine collected $960 from pot
*** SUMMARY ***
Total pot $1000 | Rake $40
Board [7h Qc Td 4h 2c]
Seat 1: Prateek1986 (button) mucked
Seat 2: sherpalife (small blind) folded before Flop
Seat 3: slotmachine (big blind) showed [6d 8s 2s 7c] and won ($960)
Seat 5: TurnOnTuneInDropOut folded before Flop (didn't bet)
Seat 6: soundfsilenz folded before Flop (didn't bet)

PokerStars Hand #1255059761: Omaha Pot Limit ($200/$400 USD) - 2020/10/23 14:17:09 ET
Table 'ADA675920511' 6-max Seat #2 is the button
Seat 1: Prateek1986 ($20175 in chips)
Seat 2: sherpalife ($47400 in chips)
Seat 3: slotmachine ($43828 in chips)
Seat 4: Sam565 ($12000 in chips)
Seat 5: TurnOnTuneInDropOut ($83389 in chips)
Seat 6: soundfsilenz ($37067 in chips)
slotmachine: posts small blind $200
Sam565: posts big blind $400
*** HOLE CARDS ***
Dealt to TurnOnTuneInDropOut [2d Qs 7c Ah]
TurnOnTuneInDropOut: folds
soundfsilenz: folds
Prateek1986: folds
sherpalife: folds
slotmachine: folds
Uncalled bet ($200) returned to Sam565
Sam565 collected $400 from pot
Sam565: doesn't show hand
*** SUMMARY ***
Total pot $400 | Rake $0
Seat 1: Prateek1986 folded before Flop (didn't bet)
Seat 2: sherpalife (button) folded before Flop (didn't bet)
Seat 3: slotmachine (small blind) folded before Flop
Seat 4: Sam565 (big blind) collected ($400)
Seat 5: TurnOnTuneInDropOut folded before Flop (didn't bet)
Seat 6: soundfsilenz folded before Flop (didn't bet)

PokerStars Hand #1255059764: Omaha Pot Limit ($200/$400 USD) - 2020/10/23 14:21:06 ET
Table 'ADA675920511' 6-max Seat #6 is the button
Seat 1: Prateek1986 ($18625 in chips)
Seat 2: sherpalife ($47960 in chips)
Seat 3: slotmachine ($43628 in chips)
Seat 5: TurnOnTuneInDropOut ($84639 in chips)
Seat 6: soundfsilenz ($36867 in chips)
Prateek1986: posts small blind $200
sherpalife: posts big blind $400
*** HOLE CARDS ***
Dealt to TurnOnTuneInDropOut [Tc Ah 7s 2s]
slotmachine: folds
TurnOnTuneInDropOut: folds
soundfsilenz: folds
Prateek1986: calls $200
sherpalife: raises $800 to $1200
Prateek1986: folds
Uncalled bet ($800) returned to sherpalife
sherpalife collected $800 from pot
sherpalife: doesn't show hand
*** SUMMARY ***
Total pot $800 | Rake $0
Seat 1: Prateek1986 (small blind) folded before Flop
Seat 2: sherpalife (big blind) collected ($800)
Seat 3: slotmachine folded before Flop (didn't bet)
Seat 5: TurnOnTuneInDropOut folded before Flop (didn't bet)
Seat 6: soundfsilenz (button) folded before Flop (didn't bet)

PokerStars Hand #1255059765: Omaha Pot Limit ($200/$400 USD) - 2020/10/23 14:22:01 ET
Table 'ADA675920511' 6-max Seat #1 is the button
Seat 1: Prateek1986 ($18225 in chips)
Seat 2: sherpalife ($48360 in chips)
Seat 3: slotmachine ($43628 in chips)
Seat 5: TurnOnTuneInDropOut ($84639 in chips)
Seat 6: soundfsilenz ($36867 in chips)
sherpalife: posts small blind $200
slotmachine: posts big blind $400
*** HOLE CARDS ***
Dealt to TurnOnTuneInDropOut [Th 7h 8s 5c]
TurnOnTuneInDropOut: folds
soundfsilenz: folds
Prateek1986: calls $400
sherpalife: folds
slotmachine: raises $1000 to $1400
Prateek1986: calls $1000
*** FLOP *** [Jh 8c 7s]
slotmachine: checks
Prateek1986: checks
*** TURN *** [Jh 8c 7s] [3c]
slotmachine: checks
Prateek1986: checks
*** RIVER *** [Jh 8c 7s 3c] [5h]
slotmachine: checks
Prateek1986: checks
*** SHOW DOWN ***
slotmachine: shows [3s Ks Kh 4h]
Prateek1986: mucks hand
slotmachine collected $2880 from pot
*** SUMMARY ***
Total pot $3000 | Rake $120
Board [Jh 8c 7s 3c 5h]
Seat 1: Prateek1986 (button) mucked
Seat 2: sherpalife (small blind) folded before Flop
Seat 3: slotmachine (big blind) showed [3s Ks Kh 4h] and won ($2880)
Seat 5: TurnOnTuneInDropOut folded before Flop (didn't bet)
Seat 6: soundfsilenz folded before Flop (didn't bet)

PokerStars Hand #1255059766: Omaha Pot Limit ($200/$400 USD) - 2020/10/23 14:23:36 ET
Table 'ADA675920511' 6-max Seat #2 is the button
Seat 1: Prateek1986 ($16825 in chips)
Seat 2: sherpalife ($48160 in chips)
Seat 3: slotmachine ($45108 in chips)
Seat 4: Sam565 ($12000 in chips)
Seat 5: TurnOnTuneInDropOut ($84639 in chips)
Seat 6: soundfsilenz ($36867 in chips)
slotmachine: posts small blind $200
Sam565: posts big blind $400
*** HOLE CARDS ***
Dealt to TurnOnTuneInDropOut [3c 8d 5h Ac]
TurnOnTuneInDropOut: folds
soundfsilenz: folds
Prateek1986: raises $1000 to $1400
sherpalife: folds
slotmachine: raises $3200 to $4600
Sam565: folds
Prateek1986: calls $3200
*** FLOP *** [Qc Jh Jd]
slotmachine: bets $2768
Prateek1986: raises $9457 to $12225 and is all-in
slotmachine: folds
Uncalled bet ($9457) returned to Prateek1986
Prateek1986 collected $14529 from pot
Prateek1986: doesn't show hand
*** SUMMARY ***
Total pot $15136 | Rake $607
Board [Qc Jh Jd]
Seat 1: Prateek1986 collected ($14529)
Seat 2: sherpalife (button) folded before Flop (didn't bet)
Seat 3: slotmachine (small blind) folded on the Flop
Seat 4: Sam565 (big blind) folded before Flop
Seat 5: TurnOnTuneInDropOut folded before Flop (didn't bet)
Seat 6: soundfsilenz folded before Flop (didn't bet)

PokerStars Hand #1255059768: Omaha Pot Limit ($200/$400 USD) - 2020/10/23 14:25:40 ET
Table 'ADA675920511' 6-max Seat #4 is the button
Seat 1: Prateek1986 ($22186 in chips)
Seat 2: sherpalife ($50392 in chips)
Seat 3: slotmachine ($48000 in chips)
Seat 4: Sam565 ($11400 in chips)
Seat 5: TurnOnTuneInDropOut ($84239 in chips)
Seat 6: soundfsilenz ($36867 in chips)
TurnOnTuneInDropOut: posts small blind $200
soundfsilenz: posts big blind $400
*** HOLE CARDS ***
Dealt to TurnOnTuneInDropOut [Td 6s 2c Tc]
Prateek1986: raises $1000 to $1400
sherpalife: folds
slotmachine: folds
Sam565: folds
TurnOnTuneInDropOut: folds
soundfsilenz: folds
Uncalled bet ($1000) returned to Prateek1986
Prateek1986 collected $1000 from pot
Prateek1986: doesn't show hand
*** SUMMARY ***
Total pot $1000 | Rake $0
Seat 1: Prateek1986 collected ($1000)
Seat 2: sherpalife folded before Flop (didn't bet)
Seat 3: slotmachine folded before Flop (didn't bet)
Seat 4: Sam565 (button) folded before Flop (didn't bet)
Seat 5: TurnOnTuneInDropOut (small blind) folded before Flop
Seat 6: soundfsilenz (big blind) folded before Flop

PokerStars Hand #1255059771: Omaha Pot Limit ($200/$400 USD) - 2020/10/23 14:30:21 ET
Table 'ADA675920511' 6-max Seat #1 is the button
Seat 1: Prateek1986 ($21986 in chips)
Seat 2: sherpalife ($49392 in chips)
Seat 3: slotmachine ($48000 in chips)
Seat 4: Sam565 ($11104 in chips)
Seat 5: TurnOnTuneInDropOut ($84039 in chips)
Seat 6: soundfsilenz ($38323 in chips)
sherpalife: posts small blind $200
slotmachine: posts big blind $400
*** HOLE CARDS ***
Dealt to TurnOnTuneInDropOut [Jd Ts 2d 9s]
Sam565: folds
TurnOnTuneInDropOut: folds
soundfsilenz: folds
Prateek1986: folds
sherpalife: folds
Uncalled bet ($200) returned to slotmachine
slotmachine collected $400 from pot
slotmachine: doesn't show hand
*** SUMMARY ***
Total pot $400 | Rake $0
Seat 1: Prateek1986 (button) folded before Flop (didn't bet)
Seat 2: sherpalife (small blind) folded before Flop
Seat 3: slotmachine (big blind) collected ($400)
Seat 4: Sam565 folded before Flop (didn't bet)
Seat 5: TurnOnTuneInDropOut folded before Flop (didn't bet)
Seat 6: soundfsilenz folded before Flop (didn't bet)

PokerStars Hand #1255059772: Omaha Pot Limit ($200/$400 USD) - 2020/10/23 14:30:55 ET
Table 'ADA675920511' 6-max Seat #2 is the button
Seat 1: Prateek1986 ($21986 in chips)
Seat 2: sherpalife ($49192 in chips)
Seat 3: slotmachine ($48200 in chips)
Seat 4: Sam565 ($11104 in chips)
Seat 5: TurnOnTuneInDropOut ($84039 in chips)
Seat 6: soundfsilenz ($38323 in chips)
slotmachine: posts small blind $200
Sam565: posts big blind $400
*** HOLE CARDS ***
Dealt to TurnOnTuneInDropOut [Ts 5s 6h 4c]
TurnOnTuneInDropOut: folds
soundfsilenz: folds
Prateek1986: raises $1000 to $1400
sherpalife: calls $1400
slotmachine: folds
Sam565: calls $1000
*** FLOP *** [Jc Td Ah]
Sam565: checks
Prateek1986: bets $4400
sherpalife: folds
Sam565: folds
Uncalled bet ($4400) returned to Prateek1986
Prateek1986 collected $4224 from pot
Prateek1986: doesn't show hand
*** SUMMARY ***
Total pot $4400 | Rake $176
Board [Jc Td Ah]
Seat 1: Prateek1986 collected ($4224)
Seat 2: sherpalife (button) folded on the Flop
Seat 3: slotmachine (small blind) folded before Flop
Seat 4: Sam565 (big blind) folded on the Flop
Seat 5: TurnOnTuneInDropOut folded before Flop (didn't bet)
Seat 6: soundfsilenz folded before Flop (didn't bet)

PokerStars Hand #1255059776: Omaha Pot Limit ($200/$400 USD) - 2020/10/23 14:35:38 ET
Table 'ADA675920511' 6-max Seat #6 is the button
Seat 1: Prateek1986 ($17382 in chips)
Seat 2: sherpalife ($40977 in chips)
Seat 3: slotmachine ($57082 in chips)
Seat 4: Sam565 ($9104 in chips)
Seat 5: TurnOnTuneInDropOut ($83439 in chips)
Seat 6: soundfsilenz ($43531 in chips)
Prateek1986: posts small blind $200
sherpalife: posts big blind $400
*** HOLE CARDS ***
Dealt to TurnOnTuneInDropOut [9d 3s Ks Qs]
slotmachine: raises $1000 to $1400
Sam565: folds
TurnOnTuneInDropOut: folds
soundfsilenz: folds
Prateek1986: calls $1200
sherpalife: calls $1000
*** FLOP *** [7s 6h Kd]
Prateek1986: bets $3150
sherpalife: raises $10500 to $13650
slotmachine: folds
Prateek1986: folds
Uncalled bet ($10500) returned to sherpalife
sherpalife collected $10079 from pot
sherpalife: doesn't show hand
*** SUMMARY ***
Total pot $10500 | Rake $421
Board [7s 6h Kd]
Seat 1: Prateek1986 (small blind) folded on the Flop
Seat 2: sherpalife (big blind) collected ($10079)
Seat 3: slotmachine folded on the Flop
Seat 4: Sam565 folded before Flop (didn't bet)
Seat 5: TurnOnTuneInDropOut folded before Flop (didn't bet)
Seat 6: soundfsilenz (button) folded before Flop (didn't bet)

PokerStars Hand #1255059777: Omaha Pot Limit ($200/$400 USD) - 2020/10/23 14:36:45 ET
Table 'ADA675920511' 6-max Seat #1 is the button
Seat 1: Prateek1986 ($12832 in chips)
Seat 2: sherpalife ($46506 in chips)
Seat 3: slotmachine ($55682 in chips)
Seat 4: Sam565 ($9104 in chips)
Seat 5: TurnOnTuneInDropOut ($83439 in chips)
Seat 6: soundfsilenz ($43531 in chips)
sherpalife: posts small blind $200
slotmachine: posts big blind $400
*** HOLE CARDS ***
Dealt to TurnOnTuneInDropOut [Tc 7s 9h 3c]
Sam565: folds
TurnOnTuneInDropOut: folds
soundfsilenz: raises $1000 to $1400
Prateek1986: raises $3400 to $4800
sherpalife: folds
slotmachine: folds
soundfsilenz: calls $3400
*** FLOP *** [4c 4h 6s]
soundfsilenz: checks
Prateek1986: bets $8032 and is all-in
soundfsilenz: folds
Uncalled bet ($8032) returned to Prateek1986
Prateek1986 collected $9791 from pot
Prateek1986: doesn't show hand
*** SUMMARY ***
Total pot $10200 | Rake $409
Board [4c 4h 6s]
Seat 1: Prateek1986 (button) collected ($9791)
Seat 2: sherpalife (small blind) folded before Flop
Seat 3: slotmachine (big blind) folded before Flop
Seat 4: Sam565 folded before Flop (didn't bet)
Seat 5: TurnOnTuneInDropOut folded before Flop (didn't bet)
Seat 6: soundfsilenz folded on the Flop

PokerStars Hand #1255059778: Omaha Pot Limit ($200/$400 USD) - 2020/10/23 14:37:54 ET
Table 'ADA675920511' 6-max Seat #2 is the button
Seat 1: Prateek1986 ($17823 in chips)
Seat 2: sherpalife ($46306 in chips)
Seat 3: slotmachine ($55282 in chips)
Seat 4: Sam565 ($9104 in chips)
Seat 5: TurnOnTuneInDropOut ($83439 in chips)
Seat 6: soundfsilenz ($38731 in chips)
slotmachine: posts small blind $200
Sam565: posts big blind $400
*** HOLE CARDS ***
Dealt to TurnOnTuneInDropOut [4d 7h 3c 9d]
TurnOnTuneInDropOut: folds
soundfsilenz: folds
Prateek1986: raises $1000 to $1400
sherpalife: folds
slotmachine: folds
Sam565: calls $1000
*** FLOP *** [8d Qc 8c]
Sam565: checks
Prateek1986: bets $3000
Sam565: calls $3000
*** TURN *** [8d Qc 8c] [Ad]
Sam565: bets $4704 and is all-in
Prateek1986: calls $4704
*** RIVER *** [8d Qc 8c Ad] [Ts]
*** SHOW DOWN ***
Sam565: shows [Jd Ac 6s 9c]
Prateek1986: shows [Qd 7c Kd 6c]
Sam565 collected $17670 from pot
*** SUMMARY ***
Total pot $18408 | Rake $738
Board [8d Qc 8c Ad Ts]
Seat 1: Prateek1986 showed [Qd 7c Kd 6c] and lost
Seat 2: sherpalife (button) folded before Flop (didn't bet)
Seat 3: slotmachine (small blind) folded before Flop
Seat 4: Sam565 (big blind) showed [Jd Ac 6s 9c] and won ($17670)
Seat 5: TurnOnTuneInDropOut folded before Flop (didn't bet)
Seat 6: soundfsilenz folded before Flop (didn't bet)

PokerStars Hand #1255059779: Omaha Pot Limit ($200/$400 USD) - 2020/10/23 14:39:00 ET
Table 'ADA675920511' 6-max Seat #3 is the button
Seat 1: Prateek1986 ($8719 in chips)
Seat 2: sherpalife ($46306 in chips)
Seat 3: slotmachine ($55082 in chips)
Seat 4: Sam565 ($17670 in chips)
Seat 5: TurnOnTuneInDropOut ($83439 in chips)
Seat 6: soundfsilenz ($38731 in chips)
Sam565: posts small blind $200
TurnOnTuneInDropOut: posts big blind $400
*** HOLE CARDS ***
Dealt to TurnOnTuneInDropOut [5c Qc 9s 2c]
soundfsilenz: folds
Prateek1986: raises $1000 to $1400
sherpalife: raises $3400 to $4800
slotmachine: folds
Sam565: folds
TurnOnTuneInDropOut: folds
Prateek1986: raises $3919 to $8719 and is all-in
sherpalife: calls $3919
*** FLOP *** [Ts Ah 4h]
*** TURN *** [Ts Ah 4h] [7h]
*** RIVER *** [Ts Ah 4h 7h] [8h]
*** SHOW DOWN ***
Prateek1986: shows [4c 3c Td 3d]
sherpalife: shows [Kc Tc Qh Ks]
Prateek1986 collected $17315 from pot
*** SUMMARY ***
Total pot $18038 | Rake $723
Board [Ts Ah 4h 7h 8h]
Seat 1: Prateek1986 showed [4c 3c Td 3d] and won ($17315)
Seat 2: sherpalife showed [Kc Tc Qh Ks] and lost
Seat 3: slotmachine (button) folded before Flop (didn't bet)
Seat 4: Sam565 (small blind) folded before Flop
Seat 5: TurnOnTuneInDropOut (big blind) folded before Flop
Seat 6: soundfsilenz folded before Flop (didn't bet)

PokerStars Hand #1255059781: Omaha Pot Limit ($200/$400 USD) - 2020/10/23 14:40:34 ET
Table 'ADA675920511' 6-max Seat #5 is the button
Seat 1: Prateek1986 ($17315 in chips)
Seat 2: sherpalife ($46850 in chips)
Seat 3: slotmachine ($45638 in chips)
Seat 4: Sam565 ($17470 in chips)
Seat 5: TurnOnTuneInDropOut ($82839 in chips)
Seat 6: soundfsilenz ($38331 in chips)
soundfsilenz: posts small blind $200
Prateek1986: posts big blind $400
*** HOLE CARDS ***
Dealt to TurnOnTuneInDropOut [Ad Qh 9c 5h]
sherpalife: folds
slotmachine: raises $1000 to $1400
Sam565: folds
TurnOnTuneInDropOut: folds
soundfsilenz: folds
Prateek1986: raises $3000 to $4400
slotmachine: raises $9000 to $13400
Prateek1986: raises $3915 to $17315 and is all-in
slotmachine: calls $3915
*** FLOP *** [Qs Qd 5s]
*** TURN *** [Qs Qd 5s] [8h]
*** RIVER *** [Qs Qd 5s 8h] [Kc]
*** SHOW DOWN ***
Prateek1986: shows [6c Jh 2c Jc]
slotmachine: shows [3c Kh Kd 6s]
slotmachine collected $34030 from pot
*** SUMMARY ***
Total pot $34830 | Rake $800
Board [Qs Qd 5s 8h Kc]
Seat 1: Prateek1986 (big blind) showed [6c Jh 2c Jc] and lost
Seat 2: sherpalife folded before Flop (didn't bet)
Seat 3: slotmachine showed [3c Kh Kd 6s] and won ($34030)
Seat 4: Sam565 folded before Flop (didn't bet)
Seat 5: TurnOnTuneInDropOut (button) folded before Flop (didn't bet)
Seat 6: soundfsilenz (small blind) folded before Flop

PokerStars Hand #1255059782: Omaha Pot Limit ($200/$400 USD) - 2020/10/23 14:41:21 ET
Table 'ADA675920511' 6-max Seat #6 is the button
Seat 2: sherpalife ($46850 in chips)
Seat 3: slotmachine ($62353 in chips)
Seat 4: Sam565 ($17470 in chips)
Seat 5: TurnOnTuneInDropOut ($82839 in chips)
Seat 6: soundfsilenz ($38131 in chips)
sherpalife: posts small blind $200
slotmachine: posts big blind $400
*** HOLE CARDS ***
Dealt to TurnOnTuneInDropOut [3c 5c 7h 8d]
Sam565: folds
TurnOnTuneInDropOut: folds
soundfsilenz: folds
sherpalife: calls $200
slotmachine: checks
*** FLOP *** [2h 9c Kc]
sherpalife: bets $400
slotmachine: raises $1600 to $2000
sherpalife: calls $1600
*** TURN *** [2h 9c Kc] [9s]
sherpalife: checks
slotmachine: bets $2400
sherpalife: calls $2400
*** RIVER *** [2h 9c Kc 9s] [Td]
sherpalife: checks
slotmachine: bets $4800
sherpalife: calls $4800
*** SHOW DOWN ***
sherpalife: mucks hand
slotmachine: shows [9h 6c Jh 9d]
slotmachine collected $18430 from pot
*** SUMMARY ***
Total pot $19200 | Rake $770
Board [2h 9c Kc 9s Td]
Seat 2: sherpalife (small blind) mucked
Seat 3: slotmachine (big blind) showed [9h 6c Jh 9d] and won ($18430)
Seat 4: Sam565 folded before Flop (didn't bet)
Seat 5: TurnOnTuneInDropOut folded before Flop (didn't bet)
Seat 6: soundfsilenz (button) folded before Flop (didn't bet)

PokerStars Hand #1109334719: Omaha Pot Limit ($200/$400 USD) - 2020/10/23 12:32:26 ET
Table 'ADA722387266' 6-max Seat #3 is the button
Seat 1: aakashchak76 ($47600 in chips)
Seat 2: TurnOnTuneInDropOut ($48000 in chips)
Seat 3: slotmachine ($45975 in chips)
aakashchak76: posts small blind $200
TurnOnTuneInDropOut: posts big blind $400
*** HOLE CARDS ***
Dealt to TurnOnTuneInDropOut [3c 5s Qc Qs]
slotmachine: folds
aakashchak76: calls $200
TurnOnTuneInDropOut: raises $800 to $1200
aakashchak76: calls $800
*** FLOP *** [5h 9c 8s]
aakashchak76: bets $400
TurnOnTuneInDropOut: calls $400
*** TURN *** [5h 9c 8s] [8d]
aakashchak76: checks
TurnOnTuneInDropOut: checks
*** RIVER *** [5h 9c 8s 8d] [Ac]
aakashchak76: checks
TurnOnTuneInDropOut: checks
*** SHOW DOWN ***
aakashchak76: shows [Qd 7h 4c Tc]
TurnOnTuneInDropOut: shows [3c 5s Qc Qs]
TurnOnTuneInDropOut collected $3072 from pot
*** SUMMARY ***
Total pot $3200 | Rake $128
Board [5h 9c 8s 8d Ac]
Seat 1: aakashchak76 (small blind) showed [Qd 7h 4c Tc] and lost
Seat 2: TurnOnTuneInDropOut (big blind) showed [3c 5s Qc Qs] and won ($3072)
Seat 3: slotmachine (button) folded before Flop (didn't bet)

PokerStars Hand #1109334720: Omaha Pot Limit ($200/$400 USD) - 2020/10/23 12:32:59 ET
Table 'ADA722387266' 6-max Seat #1 is the button
Seat 1: aakashchak76 ($46000 in chips)
Seat 2: TurnOnTuneInDropOut ($49472 in chips)
Seat 3: slotmachine ($45975 in chips)
TurnOnTuneInDropOut: posts small blind $200
slotmachine: posts big blind $400
*** HOLE CARDS ***
Dealt to TurnOnTuneInDropOut [8c As Tc 5h]
aakashchak76: folds
TurnOnTuneInDropOut: raises $800 to $1200
slotmachine: calls $800
*** FLOP *** [2d Jc Js]
TurnOnTuneInDropOut: bets $592
slotmachine: calls $592
*** TURN *** [2d Jc Js] [Qc]
TurnOnTuneInDropOut: bets $2366
slotmachine: calls $2366
*** RIVER *** [2d Jc Js Qc] [9s]
TurnOnTuneInDropOut: checks
slotmachine: checks
*** SHOW DOWN ***
TurnOnTuneInDropOut: shows [8c As Tc 5h]
slotmachine: mucks hand
TurnOnTuneInDropOut collected $7983 from pot
*** SUMMARY ***
Total pot $8316 | Rake $333
Board [2d Jc Js Qc 9s]
Seat 1: aakashchak76 (button) folded before Flop (didn't bet)
Seat 2: TurnOnTuneInDropOut (small blind) showed [8c As Tc 5h] and won ($7983)
Seat 3: slotmachine (big blind) mucked

PokerStars Hand #1109334721: Omaha Pot Limit ($200/$400 USD) - 2020/10/23 12:34:05 ET
Table 'ADA722387266' 6-max Seat #2 is the button
Seat 1: aakashchak76 ($46000 in chips)
Seat 2: TurnOnTuneInDropOut ($53297 in chips)
Seat 3: slotmachine ($41817 in chips)
slotmachine: posts small blind $200
aakashchak76: posts big blind $400
*** HOLE CARDS ***
Dealt to TurnOnTuneInDropOut [As Qh Ac 4h]
TurnOnTuneInDropOut: raises $1000 to $1400
slotmachine: folds
aakashchak76: calls $1000
*** FLOP *** [9c 5d 5c]
aakashchak76: bets $3000
TurnOnTuneInDropOut: calls $3000
*** TURN *** [9c 5d 5c] [7s]
aakashchak76: bets $9000
TurnOnTuneInDropOut: calls $9000
*** RIVER *** [9c 5d 5c 7s] [2c]
aakashchak76: bets $27000
TurnOnTuneInDropOut: folds
Uncalled bet ($27000) returned to aakashchak76
aakashchak76 collected $26300 from pot
aakashchak76: doesn't show hand
*** SUMMARY ***
Total pot $27000 | Rake $700
Board [9c 5d 5c 7s 2c]
Seat 1: aakashchak76 (big blind) collected ($26300)
Seat 2: TurnOnTuneInDropOut (button) folded on the River
Seat 3: slotmachine (small blind) folded before Flop

PokerStars Hand #1109334722: Omaha Pot Limit ($200/$400 USD) - 2020/10/23 12:35:10 ET
Table 'ADA722387266' 6-max Seat #3 is the button
Seat 1: aakashchak76 ($58900 in chips)
Seat 2: TurnOnTuneInDropOut ($48000 in chips)
Seat 3: slotmachine ($41617 in chips)
aakashchak76: posts small blind $200
TurnOnTuneInDropOut: posts big blind $400
*** HOLE CARDS ***
Dealt to TurnOnTuneInDropOut [9d 7s 6s 8c]
slotmachine: folds
aakashchak76: calls $200
TurnOnTuneInDropOut: raises $800 to $1200
aakashchak76: calls $800
*** FLOP *** [Ac 8s Jc]
aakashchak76: checks
TurnOnTuneInDropOut: bets $1200
aakashchak76: folds
Uncalled bet ($1200) returned to TurnOnTuneInDropOut
TurnOnTuneInDropOut collected $2304 from pot
TurnOnTuneInDropOut: doesn't show hand
*** SUMMARY ***
Total pot $2400 | Rake $96
Board [Ac 8s Jc]
Seat 1: aakashchak76 (small blind) folded on the Flop
Seat 2: TurnOnTuneInDropOut (big blind) collected ($2304)
Seat 3: slotmachine (button) folded before Flop (didn't bet)

PokerStars Hand #1109334786: Omaha Pot Limit ($200/$400 USD) - 2020/10/23 13:24:42 ET
Table 'ADA722387266' 6-max Seat #5 is the button
Seat 1: Lock2k16 ($24500 in chips)
Seat 2: TurnOnTuneInDropOut ($30000 in chips)
Seat 3: slotmachine ($49772 in chips)
Seat 4: XirT ($20466 in chips)
Seat 5: kimjongun ($34902 in chips)
Lock2k16: posts small blind $200
TurnOnTuneInDropOut: posts big blind $400
*** HOLE CARDS ***
Dealt to TurnOnTuneInDropOut [4c Qc 2s Th]
slotmachine: folds
XirT: folds
kimjongun: raises $1000 to $1400
Lock2k16: calls $1200
TurnOnTuneInDropOut: folds
*** FLOP *** [4s Ad Kd]
Lock2k16: checks
kimjongun: checks
*** TURN *** [4s Ad Kd] [As]
Lock2k16: bets $800
kimjongun: raises $3400 to $4200
Lock2k16: folds
Uncalled bet ($3400) returned to kimjongun
kimjongun collected $4608 from pot
kimjongun: doesn't show hand
*** SUMMARY ***
Total pot $4800 | Rake $192
Board [4s Ad Kd As]
Seat 1: Lock2k16 (small blind) folded on the Turn
Seat 2: TurnOnTuneInDropOut (big blind) folded before Flop
Seat 3: slotmachine folded before Flop (didn't bet)
Seat 4: XirT folded before Flop (didn't bet)
Seat 5: kimjongun (button) collected ($4608)

PokerStars Hand #1109334787: Omaha Pot Limit ($200/$400 USD) - 2020/10/23 13:25:44 ET
Table 'ADA722387266' 6-max Seat #1 is the button
Seat 1: Lock2k16 ($22300 in chips)
Seat 2: TurnOnTuneInDropOut ($29600 in chips)
Seat 3: slotmachine ($49772 in chips)
Seat 4: XirT ($20466 in chips)
Seat 5: kimjongun ($37310 in chips)
TurnOnTuneInDropOut: posts small blind $200
slotmachine: posts big blind $400
*** HOLE CARDS ***
Dealt to TurnOnTuneInDropOut [Td 2h Kd Ah]
XirT: folds
kimjongun: folds
Lock2k16: raises $400 to $800
TurnOnTuneInDropOut: raises $2000 to $2800
slotmachine: calls $2400
Lock2k16: calls $2000
*** FLOP *** [8d 7c 4s]
TurnOnTuneInDropOut: checks
slotmachine: checks
Lock2k16: bets $1200
TurnOnTuneInDropOut: folds
slotmachine: calls $1200
*** TURN *** [8d 7c 4s] [2c]
slotmachine: checks
Lock2k16: checks
*** RIVER *** [8d 7c 4s 2c] [4h]
slotmachine: checks
Lock2k16: checks
*** SHOW DOWN ***
slotmachine: mucks hand
Lock2k16: shows [Ks Tc Kc Ts]
Lock2k16 collected $10367 from pot
*** SUMMARY ***
Total pot $10800 | Rake $433
Board [8d 7c 4s 2c 4h]
Seat 1: Lock2k16 (button) showed [Ks Tc Kc Ts] and won ($10367)
Seat 2: TurnOnTuneInDropOut (small blind) folded on the Flop
Seat 3: slotmachine (big blind) mucked
Seat 4: XirT folded before Flop (didn't bet)
Seat 5: kimjongun folded before Flop (didn't bet)

PokerStars Hand #1109334791: Omaha Pot Limit ($200/$400 USD) - 2020/10/23 13:29:44 ET
Table 'ADA722387266' 6-max Seat #5 is the button
Seat 1: Lock2k16 ($29347 in chips)
Seat 2: TurnOnTuneInDropOut ($26800 in chips)
Seat 3: slotmachine ($49851 in chips)
Seat 4: XirT ($17866 in chips)
Seat 5: kimjongun ($33910 in chips)
Seat 6: vaibz16 ($12543 in chips)
vaibz16: posts small blind $200
Lock2k16: posts big blind $400
*** HOLE CARDS ***
Dealt to TurnOnTuneInDropOut [9d 5c As 3s]
TurnOnTuneInDropOut: folds
slotmachine: folds
XirT: calls $400
kimjongun: folds
vaibz16: folds
Lock2k16: raises $1000 to $1400
XirT: calls $1000
*** FLOP *** [9c Kh 7c]
Lock2k16: checks
XirT: bets $3000
Lock2k16: calls $3000
*** TURN *** [9c Kh 7c] [Jc]
Lock2k16: checks
XirT: checks
*** RIVER *** [9c Kh 7c Jc] [Qh]
Lock2k16: checks
XirT: checks
*** SHOW DOWN ***
Lock2k16: mucks hand
XirT: shows [4d Jd Kc Ks]
XirT collected $8639 from pot
*** SUMMARY ***
Total pot $9000 | Rake $361
Board [9c Kh 7c Jc Qh]
Seat 1: Lock2k16 (big blind) mucked
Seat 2: TurnOnTuneInDropOut folded before Flop (didn't bet)
Seat 3: slotmachine folded before Flop (didn't bet)
Seat 4: XirT showed [4d Jd Kc Ks] and won ($8639)
Seat 5: kimjongun (button) folded before Flop (didn't bet)
Seat 6: vaibz16 (small blind) folded before Flop

PokerStars Hand #1109334793: Omaha Pot Limit ($200/$400 USD) - 2020/10/23 13:31:45 ET
Table 'ADA722387266' 6-max Seat #1 is the button
Seat 1: Lock2k16 ($24147 in chips)
Seat 2: TurnOnTuneInDropOut ($39143 in chips)
Seat 3: slotmachine ($49851 in chips)
Seat 4: XirT ($22105 in chips)
Seat 5: kimjongun ($33910 in chips)
TurnOnTuneInDropOut: posts small blind $200
slotmachine: posts big blind $400
*** HOLE CARDS ***
Dealt to TurnOnTuneInDropOut [2s 2h 2d As]
XirT: folds
kimjongun: folds
Lock2k16: raises $400 to $800
TurnOnTuneInDropOut: folds
slotmachine: folds
Uncalled bet ($400) returned to Lock2k16
Lock2k16 collected $1000 from pot
Lock2k16: doesn't show hand
*** SUMMARY ***
Total pot $1000 | Rake $0
Seat 1: Lock2k16 (button) collected ($1000)
Seat 2: TurnOnTuneInDropOut (small blind) folded before Flop
Seat 3: slotmachine (big blind) folded before Flop
Seat 4: XirT folded before Flop (didn't bet)
Seat 5: kimjongun folded before Flop (didn't bet)

PokerStars Hand #1109334794: Omaha Pot Limit ($200/$400 USD) - 2020/10/23 13:32:00 ET
Table 'ADA722387266' 6-max Seat #2 is the button
Seat 1: Lock2k16 ($24747 in chips)
Seat 2: TurnOnTuneInDropOut ($38943 in chips)
Seat 3: slotmachine ($49451 in chips)
Seat 4: XirT ($22105 in chips)
Seat 5: kimjongun ($33910 in chips)
Seat 6: vaibz16 ($12000 in chips)
slotmachine: posts small blind $200
XirT: posts big blind $400
*** HOLE CARDS ***
Dealt to TurnOnTuneInDropOut [Qh 4h Jh 8s]
kimjongun: folds
vaibz16: folds
Lock2k16: raises $1000 to $1400
TurnOnTuneInDropOut: folds
slotmachine: folds
XirT: folds
Uncalled bet ($1000) returned to Lock2k16
Lock2k16 collected $1000 from pot
Lock2k16: doesn't show hand
*** SUMMARY ***
Total pot $1000 | Rake $0
Seat 1: Lock2k16 collected ($1000)
Seat 2: TurnOnTuneInDropOut (button) folded before Flop (didn't bet)
Seat 3: slotmachine (small blind) folded before Flop
Seat 4: XirT (big blind) folded before Flop
Seat 5: kimjongun folded before Flop (didn't bet)
Seat 6: vaibz16 folded before Flop (didn't bet)

PokerStars Hand #1109334796: Omaha Pot Limit ($200/$400 USD) - 2020/10/23 13:33:36 ET
Table 'ADA722387266' 6-max Seat #4 is the button
Seat 1: Lock2k16 ($62094 in chips)
Seat 2: TurnOnTuneInDropOut ($38943 in chips)
Seat 3: slotmachine ($49251 in chips)
Seat 4: XirT ($21505 in chips)
Seat 5: kimjongun ($8563 in chips)
kimjongun: posts small blind $200
Lock2k16: posts big blind $400
*** HOLE CARDS ***
Dealt to TurnOnTuneInDropOut [3h 4s 4h 6s]
TurnOnTuneInDropOut: folds
slotmachine: raises $1000 to $1400
XirT: folds
kimjongun: folds
Lock2k16: folds
Uncalled bet ($1000) returned to slotmachine
slotmachine collected $1000 from pot
slotmachine: doesn't show hand
*** SUMMARY ***
Total pot $1000 | Rake $0
Seat 1: Lock2k16 (big blind) folded before Flop
Seat 2: TurnOnTuneInDropOut folded before Flop (didn't bet)
Seat 3: slotmachine collected ($1000)
Seat 4: XirT (button) folded before Flop (didn't bet)
Seat 5: kimjongun (small blind) folded before Flop

PokerStars Hand #1109334797: Omaha Pot Limit ($200/$400 USD) - 2020/10/23 13:34:06 ET
Table 'ADA722387266' 6-max Seat #5 is the button
Seat 1: Lock2k16 ($61694 in chips)
Seat 2: TurnOnTuneInDropOut ($38943 in chips)
Seat 3: slotmachine ($49851 in chips)
Seat 4: XirT ($21505 in chips)
Seat 5: kimjongun ($8363 in chips)
Lock2k16: posts small blind $200
TurnOnTuneInDropOut: posts big blind $400
*** HOLE CARDS ***
Dealt to TurnOnTuneInDropOut [Jh 4d Ts Jd]
slotmachine: folds
XirT: raises $1000 to $1400
kimjongun: folds
Lock2k16: folds
TurnOnTuneInDropOut: calls $1000
*** FLOP *** [6s 7c 9d]
TurnOnTuneInDropOut: checks
XirT: checks
*** TURN *** [6s 7c 9d] [9s]
TurnOnTuneInDropOut: checks
XirT: bets $3000
TurnOnTuneInDropOut: calls $3000
*** RIVER *** [6s 7c 9d 9s] [2h]
TurnOnTuneInDropOut: checks
XirT: checks
*** SHOW DOWN ***
TurnOnTuneInDropOut: shows [Jh 4d Ts Jd]
XirT: mucks hand
TurnOnTuneInDropOut collected $8639 from pot
*** SUMMARY ***
Total pot $9000 | Rake $361
Board [6s 7c 9d 9s 2h]
Seat 1: Lock2k16 (small blind) folded before Flop
Seat 2: TurnOnTuneInDropOut (big blind) showed [Jh 4d Ts Jd] and won ($8639)
Seat 3: slotmachine folded before Flop (didn't bet)
Seat 4: XirT mucked
Seat 5: kimjongun (button) folded before Flop (didn't bet)

PokerStars Hand #1109334799: Omaha Pot Limit ($200/$400 USD) - 2020/10/23 13:35:47 ET
Table 'ADA722387266' 6-max Seat #2 is the button
Seat 1: Lock2k16 ($62630 in chips)
Seat 2: TurnOnTuneInDropOut ($42782 in chips)
Seat 3: slotmachine ($49451 in chips)
Seat 4: XirT ($16705 in chips)
Seat 5: kimjongun ($8363 in chips)
slotmachine: posts small blind $200
XirT: posts big blind $400
*** HOLE CARDS ***
Dealt to TurnOnTuneInDropOut [8c 6c Jh Jd]
kimjongun: folds
Lock2k16: raises $400 to $800
TurnOnTuneInDropOut: calls $800
slotmachine: folds
XirT: folds
*** FLOP *** [Ah 8d Th]
Lock2k16: bets $1650
TurnOnTuneInDropOut: folds
Uncalled bet ($1650) returned to Lock2k16
Lock2k16 collected $2112 from pot
Lock2k16: doesn't show hand
*** SUMMARY ***
Total pot $2200 | Rake $88
Board [Ah 8d Th]
Seat 1: Lock2k16 collected ($2112)
Seat 2: TurnOnTuneInDropOut (button) folded on the Flop
Seat 3: slotmachine (small blind) folded before Flop
Seat 4: XirT (big blind) folded before Flop
Seat 5: kimjongun folded before Flop (didn't bet)

PokerStars Hand #1109334802: Omaha Pot Limit ($200/$400 USD) - 2020/10/23 13:38:38 ET
Table 'ADA722387266' 6-max Seat #5 is the button
Seat 1: Lock2k16 ($62742 in chips)
Seat 2: TurnOnTuneInDropOut ($47111 in chips)
Seat 3: slotmachine ($49251 in chips)
Seat 4: XirT ($17425 in chips)
Seat 5: kimjongun ($27785 in chips)
Seat 6: vaibz16 ($7050 in chips)
vaibz16: posts small blind $200
Lock2k16: posts big blind $400
*** HOLE CARDS ***
Dealt to TurnOnTuneInDropOut [9d Tc As Js]
TurnOnTuneInDropOut: raises $1000 to $1400
slotmachine: calls $1400
XirT: folds
kimjongun: raises $4800 to $6200
vaibz16: folds
Lock2k16: folds
TurnOnTuneInDropOut: folds
slotmachine: calls $4800
*** FLOP *** [Jc Ts 2c]
slotmachine: checks
kimjongun: bets $14400
slotmachine: folds
Uncalled bet ($14400) returned to kimjongun
kimjongun collected $13823 from pot
kimjongun: doesn't show hand
*** SUMMARY ***
Total pot $14400 | Rake $577
Board [Jc Ts 2c]
Seat 1: Lock2k16 (big blind) folded before Flop
Seat 2: TurnOnTuneInDropOut folded before Flop
Seat 3: slotmachine folded on the Flop
Seat 4: XirT folded before Flop (didn't bet)
Seat 5: kimjongun (button) collected ($13823)
Seat 6: vaibz16 (small blind) folded before Flop

PokerStars Hand #1109334803: Omaha Pot Limit ($200/$400 USD) - 2020/10/23 13:39:26 ET
Table 'ADA722387266' 6-max Seat #6 is the button
Seat 1: Lock2k16 ($62342 in chips)
Seat 2: TurnOnTuneInDropOut ($45711 in chips)
Seat 3: slotmachine ($43051 in chips)
Seat 4: XirT ($17425 in chips)
Seat 5: kimjongun ($35408 in chips)
Seat 6: vaibz16 ($22673 in chips)
Lock2k16: posts small blind $200
TurnOnTuneInDropOut: posts big blind $400
*** HOLE CARDS ***
Dealt to TurnOnTuneInDropOut [3d 7h Kc Qd]
slotmachine: folds
XirT: folds
kimjongun: raises $1000 to $1400
vaibz16: folds
Lock2k16: calls $1200
TurnOnTuneInDropOut: folds
*** FLOP *** [Qh Kd 6s]
Lock2k16: bets $1600
kimjongun: folds
Uncalled bet ($1600) returned to Lock2k16
Lock2k16 collected $3072 from pot
Lock2k16: doesn't show hand
*** SUMMARY ***
Total pot $3200 | Rake $128
Board [Qh Kd 6s]
Seat 1: Lock2k16 (small blind) collected ($3072)
Seat 2: TurnOnTuneInDropOut (big blind) folded before Flop
Seat 3: slotmachine folded before Flop (didn't bet)
Seat 4: XirT folded before Flop (didn't bet)
Seat 5: kimjongun folded on the Flop
Seat 6: vaibz16 (button) folded before Flop (didn't bet)

PokerStars Hand #1109334804: Omaha Pot Limit ($200/$400 USD) - 2020/10/23 13:40:03 ET
Table 'ADA722387266' 6-max Seat #1 is the button
Seat 1: Lock2k16 ($64014 in chips)
Seat 2: TurnOnTuneInDropOut ($45311 in chips)
Seat 3: slotmachine ($43051 in chips)
Seat 4: XirT ($17425 in chips)
Seat 5: kimjongun ($34008 in chips)
Seat 6: vaibz16 ($22673 in chips)
TurnOnTuneInDropOut: posts small blind $200
slotmachine: posts big blind $400
*** HOLE CARDS ***
Dealt to TurnOnTuneInDropOut [3h 5s 8d Ad]
XirT: folds
kimjongun: folds
vaibz16: raises $1000 to $1400
Lock2k16: calls $1400
TurnOnTuneInDropOut: folds
slotmachine: raises $4400 to $5800
vaibz16: calls $4400
Lock2k16: calls $4400
*** FLOP *** [Kc Kd 3c]
slotmachine: bets $5808
vaibz16: calls $5808
Lock2k16: raises $35024 to $40832
slotmachine: folds
vaibz16: folds
Uncalled bet ($35024) returned to Lock2k16
Lock2k16 collected $34224 from pot
Lock2k16: doesn't show hand
*** SUMMARY ***
Total pot $35024 | Rake $800
Board [Kc Kd 3c]
Seat 1: Lock2k16 (button) collected ($34224)
Seat 2: TurnOnTuneInDropOut (small blind) folded before Flop
Seat 3: slotmachine (big blind) folded on the Flop
Seat 4: XirT folded before Flop (didn't bet)
Seat 5: kimjongun folded before Flop (didn't bet)
Seat 6: vaibz16 folded on the Flop

PokerStars Hand #1109334808: Omaha Pot Limit ($200/$400 USD) - 2020/10/23 13:44:32 ET
Table 'ADA722387266' 6-max Seat #5 is the button
Seat 1: Lock2k16 ($83762 in chips)
Seat 2: TurnOnTuneInDropOut ($56255 in chips)
Seat 3: slotmachine ($47800 in chips)
Seat 4: XirT ($16825 in chips)
Seat 5: kimjongun ($29367 in chips)
Seat 6: vaibz16 ($11713 in chips)
vaibz16: posts small blind $200
Lock2k16: posts big blind $400
*** HOLE CARDS ***
Dealt to TurnOnTuneInDropOut [6c 5d 3s Ts]
TurnOnTuneInDropOut: folds
slotmachine: raises $1000 to $1400
XirT: folds
kimjongun: folds
vaibz16: folds
Lock2k16: calls $1000
*** FLOP *** [Ah 9d 8h]
Lock2k16: checks
slotmachine: checks
*** TURN *** [Ah 9d 8h] [7c]
Lock2k16: bets $2250
slotmachine: folds
Uncalled bet ($2250) returned to Lock2k16
Lock2k16 collected $2880 from pot
Lock2k16: doesn't show hand
*** SUMMARY ***
Total pot $3000 | Rake $120
Board [Ah 9d 8h 7c]
Seat 1: Lock2k16 (big blind) collected ($2880)
Seat 2: TurnOnTuneInDropOut folded before Flop (didn't bet)
Seat 3: slotmachine folded on the Turn
Seat 4: XirT folded before Flop (didn't bet)
Seat 5: kimjongun (button) folded before Flop (didn't bet)
Seat 6: vaibz16 (small blind) folded before Flop

PokerStars Hand #1109334810: Omaha Pot Limit ($200/$400 USD) - 2020/10/23 13:46:21 ET
Table 'ADA722387266' 6-max Seat #1 is the button
Seat 1: Lock2k16 ($93449 in chips)
Seat 2: TurnOnTuneInDropOut ($50255 in chips)
Seat 3: slotmachine ($46400 in chips)
Seat 4: XirT ($16825 in chips)
Seat 5: kimjongun ($29367 in chips)
Seat 6: vaibz16 ($13288 in chips)
TurnOnTuneInDropOut: posts small blind $200
slotmachine: posts big blind $400
*** HOLE CARDS ***
Dealt to TurnOnTuneInDropOut [Qd 5s 3c Js]
XirT: folds
kimjongun: folds
vaibz16: folds
Lock2k16: raises $400 to $800
TurnOnTuneInDropOut: folds
slotmachine: folds
Uncalled bet ($400) returned to Lock2k16
Lock2k16 collected $1000 from pot
Lock2k16: doesn't show hand
*** SUMMARY ***
Total pot $1000 | Rake $0
Seat 1: Lock2k16 (button) collected ($1000)
Seat 2: TurnOnTuneInDropOut (small blind) folded before Flop
Seat 3: slotmachine (big blind) folded before Flop
Seat 4: XirT folded before Flop (didn't bet)
Seat 5: kimjongun folded before Flop (didn't bet)
Seat 6: vaibz16 folded before Flop (didn't bet)

PokerStars Hand #1109334811: Omaha Pot Limit ($200/$400 USD) - 2020/10/23 13:46:44 ET
Table 'ADA722387266' 6-max Seat #2 is the button
Seat 1: Lock2k16 ($94049 in chips)
Seat 2: TurnOnTuneInDropOut ($50055 in chips)
Seat 3: slotmachine ($46000 in chips)
Seat 4: XirT ($16825 in chips)
Seat 5: kimjongun ($29367 in chips)
Seat 6: vaibz16 ($13288 in chips)
slotmachine: posts small blind $200
XirT: posts big blind $400
*** HOLE CARDS ***
Dealt to TurnOnTuneInDropOut [Ts 4c 9c Js]
kimjongun: folds
vaibz16: folds
Lock2k16: raises $1000 to $1400
TurnOnTuneInDropOut: folds
slotmachine: raises $3200 to $4600
XirT: folds
Lock2k16: folds
Uncalled bet ($3200) returned to slotmachine
slotmachine collected $3200 from pot
slotmachine: doesn't show hand
*** SUMMARY ***
Total pot $3200 | Rake $0
Seat 1: Lock2k16 folded before Flop
Seat 2: TurnOnTuneInDropOut (button) folded before Flop (didn't bet)
Seat 3: slotmachine (small blind) collected ($3200)
Seat 4: XirT (big blind) folded before Flop
Seat 5: kimjongun folded before Flop (didn't bet)
Seat 6: vaibz16 folded before Flop (didn't bet)

PokerStars Hand #1109334812: Omaha Pot Limit ($200/$400 USD) - 2020/10/23 13:47:21 ET
Table 'ADA722387266' 6-max Seat #3 is the button
Seat 1: Lock2k16 ($92649 in chips)
Seat 2: TurnOnTuneInDropOut ($50055 in chips)
Seat 3: slotmachine ($47800 in chips)
Seat 4: XirT ($16425 in chips)
Seat 5: kimjongun ($29367 in chips)
Seat 6: vaibz16 ($13288 in chips)
XirT: posts small blind $200
kimjongun: posts big blind $400
*** HOLE CARDS ***
Dealt to TurnOnTuneInDropOut [3s 9d 4c Jh]
vaibz16: raises $1000 to $1400
Lock2k16: folds
TurnOnTuneInDropOut: folds
slotmachine: folds
XirT: calls $1200
kimjongun: folds
*** FLOP *** [Ks 2c 6d]
XirT: checks
vaibz16: bets $1600
XirT: calls $1600
*** TURN *** [Ks 2c 6d] [7c]
XirT: checks
vaibz16: checks
*** RIVER *** [Ks 2c 6d 7c] [As]
XirT: checks
vaibz16: bets $4800
XirT: folds
Uncalled bet ($4800) returned to vaibz16
vaibz16 collected $6143 from pot
vaibz16: doesn't show hand
*** SUMMARY ***
Total pot $6400 | Rake $257
Board [Ks 2c 6d 7c As]
Seat 1: Lock2k16 folded before Flop (didn't bet)
Seat 2: TurnOnTuneInDropOut folded before Flop (didn't bet)
Seat 3: slotmachine (button) folded before Flop (didn't bet)
Seat 4: XirT (small blind) folded on the River
Seat 5: kimjongun (big blind) folded before Flop
Seat 6: vaibz16 collected ($6143)

PokerStars Hand #1109334813: Omaha Pot Limit ($200/$400 USD) - 2020/10/23 13:48:17 ET
Table 'ADA722387266' 6-max Seat #4 is the button
Seat 2: TurnOnTuneInDropOut ($50055 in chips)
Seat 3: slotmachine ($47800 in chips)
Seat 4: XirT ($13425 in chips)
Seat 5: kimjongun ($28967 in chips)
Seat 6: vaibz16 ($16431 in chips)
kimjongun: posts small blind $200
vaibz16: posts big blind $400
*** HOLE CARDS ***
Dealt to TurnOnTuneInDropOut [Qh 8h Kc 4c]
TurnOnTuneInDropOut: raises $1000 to $1400
slotmachine: folds
XirT: folds
kimjongun: folds
vaibz16: calls $1000
*** FLOP *** [6d Ts Th]
vaibz16: checks
TurnOnTuneInDropOut: bets $990
vaibz16: calls $990
*** TURN *** [6d Ts Th] [2d]
vaibz16: checks
TurnOnTuneInDropOut: checks
*** RIVER *** [6d Ts Th 2d] [Jh]
vaibz16: checks
TurnOnTuneInDropOut: checks
*** SHOW DOWN ***
vaibz16: shows [Qs 6s 8c 9s]
vaibz16 collected $4780 from pot
*** SUMMARY ***
Total pot $4980 | Rake $200
Board [6d Ts Th 2d Jh]
Seat 2: TurnOnTuneInDropOut
Seat 3: slotmachine folded before Flop (didn't bet)
Seat 4: XirT (button) folded before Flop (didn't bet)
Seat 5: kimjongun (small blind) folded before Flop
Seat 6: vaibz16 (big blind) showed [Qs 6s 8c 9s] and won ($4780)

PokerStars Hand #1109334814: Omaha Pot Limit ($200/$400 USD) - 2020/10/23 13:49:09 ET
Table 'ADA722387266' 6-max Seat #5 is the button
Seat 1: soundfsilenz ($42000 in chips)
Seat 2: TurnOnTuneInDropOut ($47665 in chips)
Seat 3: slotmachine ($47800 in chips)
Seat 4: XirT ($13425 in chips)
Seat 5: kimjongun ($28767 in chips)
Seat 6: vaibz16 ($18821 in chips)
vaibz16: posts small blind $200
soundfsilenz: posts big blind $400
*** HOLE CARDS ***
Dealt to TurnOnTuneInDropOut [9d Tc 2s Qd]
TurnOnTuneInDropOut: folds
slotmachine: folds
XirT: folds
kimjongun: folds
vaibz16: raises $800 to $1200
soundfsilenz: folds
Uncalled bet ($800) returned to vaibz16
vaibz16 collected $800 from pot
vaibz16: doesn't show hand
*** SUMMARY ***
Total pot $800 | Rake $0
Seat 1: soundfsilenz (big blind) folded before Flop
Seat 2: TurnOnTuneInDropOut folded before Flop (didn't bet)
Seat 3: slotmachine folded before Flop (didn't bet)
Seat 4: XirT folded before Flop (didn't bet)
Seat 5: kimjongun (button) folded before Flop (didn't bet)
Seat 6: vaibz16 (small blind) collected ($800)

PokerStars Hand #1109334815: Omaha Pot Limit ($200/$400 USD) - 2020/10/23 13:49:39 ET
Table 'ADA722387266' 6-max Seat #6 is the button
Seat 1: soundfsilenz ($41600 in chips)
Seat 2: TurnOnTuneInDropOut ($47665 in chips)
Seat 3: slotmachine ($47800 in chips)
Seat 4: XirT ($13425 in chips)
Seat 5: kimjongun ($28767 in chips)
Seat 6: vaibz16 ($19221 in chips)
soundfsilenz: posts small blind $200
TurnOnTuneInDropOut: posts big blind $400
*** HOLE CARDS ***
Dealt to TurnOnTuneInDropOut [9s 6h 6s 8d]
slotmachine: raises $1000 to $1400
XirT: calls $1400
kimjongun: folds
vaibz16: folds
soundfsilenz: raises $4600 to $6000
TurnOnTuneInDropOut: folds
slotmachine: folds
XirT: calls $4600
*** FLOP *** [5s 9d Jc]
soundfsilenz: bets $9246
XirT: calls $7425 and is all-in
Uncalled bet ($1821) returned to soundfsilenz
*** TURN *** [5s 9d Jc] [8h]
*** RIVER *** [5s 9d Jc 8h] [5d]
*** SHOW DOWN ***
soundfsilenz: shows [Ah 8c Ac 2d]
XirT: shows [Jh 6c Kc Ts]
soundfsilenz collected $27850 from pot
*** SUMMARY ***
Total pot $28650 | Rake $800
Board [5s 9d Jc 8h 5d]
Seat 1: soundfsilenz (small blind) showed [Ah 8c Ac 2d] and won ($27850)
Seat 2: TurnOnTuneInDropOut (big blind) folded before Flop
Seat 3: slotmachine folded before Flop
Seat 4: XirT showed [Jh 6c Kc Ts] and lost
Seat 5: kimjongun folded before Flop (didn't bet)
Seat 6: vaibz16 (button) folded before Flop (didn't bet)

PokerStars Hand #1109334816: Omaha Pot Limit ($200/$400 USD) - 2020/10/23 13:50:33 ET
Table 'ADA722387266' 6-max Seat #1 is the button
Seat 1: soundfsilenz ($56025 in chips)
Seat 2: TurnOnTuneInDropOut ($47265 in chips)
Seat 3: slotmachine ($46400 in chips)
Seat 5: kimjongun ($28767 in chips)
Seat 6: vaibz16 ($19221 in chips)
TurnOnTuneInDropOut: posts small blind $200
slotmachine: posts big blind $400
*** HOLE CARDS ***
Dealt to TurnOnTuneInDropOut [7s Qc Ts 9h]
kimjongun: folds
vaibz16: folds
soundfsilenz: folds
TurnOnTuneInDropOut: raises $800 to $1200
slotmachine: calls $800
*** FLOP *** [Tc 4s 3s]
TurnOnTuneInDropOut: checks
slotmachine: checks
*** TURN *** [Tc 4s 3s] [5d]
TurnOnTuneInDropOut: checks
slotmachine: checks
*** RIVER *** [Tc 4s 3s 5d] [3h]
TurnOnTuneInDropOut: checks
slotmachine: checks
*** SHOW DOWN ***
TurnOnTuneInDropOut: shows [7s Qc Ts 9h]
slotmachine: mucks hand
TurnOnTuneInDropOut collected $2304 from pot
*** SUMMARY ***
Total pot $2400 | Rake $96
Board [Tc 4s 3s 5d 3h]
Seat 1: soundfsilenz (button) folded before Flop (didn't bet)
Seat 2: TurnOnTuneInDropOut (small blind) showed [7s Qc Ts 9h] and won ($2304)
Seat 3: slotmachine (big blind) mucked
Seat 5: kimjongun folded before Flop (didn't bet)
Seat 6: vaibz16 folded before Flop (didn't bet)

PokerStars Hand #1109334817: Omaha Pot Limit ($200/$400 USD) - 2020/10/23 13:51:11 ET
Table 'ADA722387266' 6-max Seat #2 is the button
Seat 1: soundfsilenz ($56025 in chips)
Seat 2: TurnOnTuneInDropOut ($48369 in chips)
Seat 3: slotmachine ($45200 in chips)
Seat 4: Sam565 ($12462 in chips)
Seat 5: kimjongun ($28767 in chips)
Seat 6: vaibz16 ($19221 in chips)
slotmachine: posts small blind $200
Sam565: posts big blind $400
*** HOLE CARDS ***
Dealt to TurnOnTuneInDropOut [8s 4h Ac 8d]
kimjongun: folds
vaibz16: raises $1000 to $1400
soundfsilenz: raises $3400 to $4800
TurnOnTuneInDropOut: folds
slotmachine: folds
Sam565: calls $4400
vaibz16: calls $3400
*** FLOP *** [8h 4c 9c]
Sam565: bets $7662 and is all-in
vaibz16: calls $7662
soundfsilenz: raises $7662 to $15324
vaibz16: calls $6759 and is all-in
Uncalled bet ($903) returned to soundfsilenz
*** TURN *** [8h 4c 9c] [3h]
*** RIVER *** [8h 4c 9c 3h] [3s]
*** SHOW DOWN ***
vaibz16: shows [Th Jh Kd Td]
soundfsilenz: shows [Jd Tc Ah Qc]
vaibz16 collected $13518 from side pot
Sam565: shows [7h 9s Kh Kc]
Sam565 collected $36786 from main pot
*** SUMMARY ***
Total pot $51104 Main pot $36786. Side pot $13518. | Rake $800
Board [8h 4c 9c 3h 3s]
Seat 1: soundfsilenz showed [Jd Tc Ah Qc] and lost
Seat 2: TurnOnTuneInDropOut (button) folded before Flop (didn't bet)
Seat 3: slotmachine (small blind) folded before Flop
Seat 4: Sam565 (big blind) showed [7h 9s Kh Kc] and won ($36786)
Seat 5: kimjongun folded before Flop (didn't bet)
Seat 6: vaibz16 showed [Th Jh Kd Td] and won ($13518)

PokerStars Hand #1109334841: Omaha Pot Limit ($200/$400 USD) - 2020/10/23 14:12:06 ET
Table 'ADA722387266' 6-max Seat #4 is the button
Seat 1: soundfsilenz ($45605 in chips)
Seat 2: gaganhyd ($16539 in chips)
Seat 3: slotmachine ($43000 in chips)
Seat 4: mangeshnc ($19959 in chips)
Seat 5: kimjongun ($22926 in chips)
Seat 6: TurnOnTuneInDropOut ($48369 in chips)
kimjongun: posts small blind $200
TurnOnTuneInDropOut: posts big blind $400
*** HOLE CARDS ***
Dealt to TurnOnTuneInDropOut [8h 7d Ts 6c]
soundfsilenz: folds
gaganhyd: folds
slotmachine: raises $1000 to $1400
mangeshnc: folds
kimjongun: folds
TurnOnTuneInDropOut: folds
Uncalled bet ($1000) returned to slotmachine
slotmachine collected $1000 from pot
slotmachine: doesn't show hand
*** SUMMARY ***
Total pot $1000 | Rake $0
Seat 1: soundfsilenz folded before Flop (didn't bet)
Seat 2: gaganhyd folded before Flop (didn't bet)
Seat 3: slotmachine collected ($1000)
Seat 4: mangeshnc (button) folded before Flop (didn't bet)
Seat 5: kimjongun (small blind) folded before Flop
Seat 6: TurnOnTuneInDropOut (big blind) folded before Flop

PokerStars Hand #1109334842: Omaha Pot Limit ($200/$400 USD) - 2020/10/23 14:12:44 ET
Table 'ADA722387266' 6-max Seat #5 is the button
Seat 1: soundfsilenz ($45605 in chips)
Seat 2: gaganhyd ($16539 in chips)
Seat 3: slotmachine ($43600 in chips)
Seat 4: mangeshnc ($19959 in chips)
Seat 5: kimjongun ($22726 in chips)
Seat 6: TurnOnTuneInDropOut ($47969 in chips)
TurnOnTuneInDropOut: posts small blind $200
soundfsilenz: posts big blind $400
*** HOLE CARDS ***
Dealt to TurnOnTuneInDropOut [Kc Ts 6h 7h]
gaganhyd: folds
slotmachine: folds
mangeshnc: folds
kimjongun: raises $1000 to $1400
TurnOnTuneInDropOut: folds
soundfsilenz: folds
Uncalled bet ($1000) returned to kimjongun
kimjongun collected $1000 from pot
kimjongun: doesn't show hand
*** SUMMARY ***
Total pot $1000 | Rake $0
Seat 1: soundfsilenz (big blind) folded before Flop
Seat 2: gaganhyd folded before Flop (didn't bet)
Seat 3: slotmachine folded before Flop (didn't bet)
Seat 4: mangeshnc folded before Flop (didn't bet)
Seat 5: kimjongun (button) collected ($1000)
Seat 6: TurnOnTuneInDropOut (small blind) folded before Flop

PokerStars Hand #1109334843: Omaha Pot Limit ($200/$400 USD) - 2020/10/23 14:13:24 ET
Table 'ADA722387266' 6-max Seat #6 is the button
Seat 1: soundfsilenz ($45205 in chips)
Seat 2: gaganhyd ($16539 in chips)
Seat 3: slotmachine ($43600 in chips)
Seat 4: mangeshnc ($19959 in chips)
Seat 5: kimjongun ($23326 in chips)
Seat 6: TurnOnTuneInDropOut ($47769 in chips)
soundfsilenz: posts small blind $200
gaganhyd: posts big blind $400
*** HOLE CARDS ***
Dealt to TurnOnTuneInDropOut [Qc Ah 7d 6c]
slotmachine: raises $1000 to $1400
mangeshnc: folds
kimjongun: folds
TurnOnTuneInDropOut: folds
soundfsilenz: folds
gaganhyd: folds
Uncalled bet ($1000) returned to slotmachine
slotmachine collected $1000 from pot
slotmachine: doesn't show hand
*** SUMMARY ***
Total pot $1000 | Rake $0
Seat 1: soundfsilenz (small blind) folded before Flop
Seat 2: gaganhyd (big blind) folded before Flop
Seat 3: slotmachine collected ($1000)
Seat 4: mangeshnc folded before Flop (didn't bet)
Seat 5: kimjongun folded before Flop (didn't bet)
Seat 6: TurnOnTuneInDropOut (button) folded before Flop (didn't bet)

PokerStars Hand #1109334844: Omaha Pot Limit ($200/$400 USD) - 2020/10/23 14:14:05 ET
Table 'ADA722387266' 6-max Seat #1 is the button
Seat 1: soundfsilenz ($45005 in chips)
Seat 2: gaganhyd ($16139 in chips)
Seat 3: slotmachine ($44200 in chips)
Seat 4: mangeshnc ($19959 in chips)
Seat 5: kimjongun ($23326 in chips)
Seat 6: TurnOnTuneInDropOut ($47769 in chips)
gaganhyd: posts small blind $200
slotmachine: posts big blind $400
*** HOLE CARDS ***
Dealt to TurnOnTuneInDropOut [8h Kc 5d 9s]
mangeshnc: raises $1000 to $1400
kimjongun: folds
TurnOnTuneInDropOut: folds
soundfsilenz: folds
gaganhyd: calls $1200
slotmachine: folds
*** FLOP *** [5c 3s Kh]
gaganhyd: checks
mangeshnc: bets $3200
gaganhyd: raises $9600 to $12800
mangeshnc: calls $9600
*** TURN *** [5c 3s Kh] [7h]
gaganhyd: bets $1939 and is all-in
mangeshnc: calls $1939
*** RIVER *** [5c 3s Kh 7h] [7c]
*** SHOW DOWN ***
gaganhyd: shows [3c 2h 4h Ac]
mangeshnc: shows [Jc 7s Jh 4c]
mangeshnc collected $31878 from pot
*** SUMMARY ***
Total pot $32678 | Rake $800
Board [5c 3s Kh 7h 7c]
Seat 1: soundfsilenz (button) folded before Flop (didn't bet)
Seat 2: gaganhyd (small blind) showed [3c 2h 4h Ac] and lost
Seat 3: slotmachine (big blind) folded before Flop
Seat 4: mangeshnc showed [Jc 7s Jh 4c] and won ($31878)
Seat 5: kimjongun folded before Flop (didn't bet)
Seat 6: TurnOnTuneInDropOut folded before Flop (didn't bet)

PokerStars Hand #1109334845: Omaha Pot Limit ($200/$400 USD) - 2020/10/23 14:15:04 ET
Table 'ADA722387266' 6-max Seat #3 is the button
Seat 1: soundfsilenz ($45005 in chips)
Seat 3: slotmachine ($43800 in chips)
Seat 4: mangeshnc ($35698 in chips)
Seat 5: kimjongun ($23326 in chips)
Seat 6: TurnOnTuneInDropOut ($47769 in chips)
mangeshnc: posts small blind $200
kimjongun: posts big blind $400
*** HOLE CARDS ***
Dealt to TurnOnTuneInDropOut [6h 4h Qc 8c]
TurnOnTuneInDropOut: folds
soundfsilenz: folds
slotmachine: folds
mangeshnc: calls $200
kimjongun: checks
*** FLOP *** [3s 7h 8s]
mangeshnc: checks
kimjongun: checks
*** TURN *** [3s 7h 8s] [6c]
mangeshnc: bets $800
kimjongun: calls $800
*** RIVER *** [3s 7h 8s 6c] [Kh]
mangeshnc: bets $2400
kimjongun: calls $2400
*** SHOW DOWN ***
mangeshnc: shows [4c Ks 5d Ac]
kimjongun: mucks hand
mangeshnc collected $6911 from pot
*** SUMMARY ***
Total pot $7200 | Rake $289
Board [3s 7h 8s 6c Kh]
Seat 1: soundfsilenz folded before Flop (didn't bet)
Seat 3: slotmachine (button) folded before Flop (didn't bet)
Seat 4: mangeshnc (small blind) showed [4c Ks 5d Ac] and won ($6911)
Seat 5: kimjongun (big blind) mucked
Seat 6: TurnOnTuneInDropOut folded before Flop (didn't bet)

PokerStars Hand #1109334846: Omaha Pot Limit ($200/$400 USD) - 2020/10/23 14:16:28 ET
Table 'ADA722387266' 6-max Seat #4 is the button
Seat 1: soundfsilenz ($45005 in chips)
Seat 2: gaganhyd ($20682 in chips)
Seat 3: slotmachine ($43800 in chips)
Seat 4: mangeshnc ($39009 in chips)
Seat 5: kimjongun ($19726 in chips)
Seat 6: TurnOnTuneInDropOut ($47769 in chips)
kimjongun: posts small blind $200
TurnOnTuneInDropOut: posts big blind $400
*** HOLE CARDS ***
Dealt to TurnOnTuneInDropOut [Th Ts Ah 6d]
soundfsilenz: folds
gaganhyd: raises $650 to $1050
slotmachine: calls $1050
mangeshnc: calls $1050
kimjongun: folds
TurnOnTuneInDropOut: calls $650
*** FLOP *** [Js 9d Jd]
TurnOnTuneInDropOut: checks
gaganhyd: checks
slotmachine: checks
mangeshnc: checks
*** TURN *** [Js 9d Jd] [Jh]
TurnOnTuneInDropOut: checks
gaganhyd: checks
slotmachine: checks
mangeshnc: bets $4400
TurnOnTuneInDropOut: folds
gaganhyd: folds
slotmachine: calls $4400
*** RIVER *** [Js 9d Jd Jh] [2s]
slotmachine: checks
mangeshnc: checks
*** SHOW DOWN ***
slotmachine: shows [9s Kh 2c Ks]
mangeshnc: mucks hand
slotmachine collected $12671 from pot
*** SUMMARY ***
Total pot $13200 | Rake $529
Board [Js 9d Jd Jh 2s]
Seat 1: soundfsilenz folded before Flop (didn't bet)
Seat 2: gaganhyd folded on the Turn
Seat 3: slotmachine showed [9s Kh 2c Ks] and won ($12671)
Seat 4: mangeshnc (button) mucked
Seat 5: kimjongun (small blind) folded before Flop
Seat 6: TurnOnTuneInDropOut (big blind) folded on the Turn

PokerStars Hand #1109334850: Omaha Pot Limit ($200/$400 USD) - 2020/10/23 14:20:10 ET
Table 'ADA722387266' 6-max Seat #2 is the button
Seat 1: soundfsilenz ($46285 in chips)
Seat 2: gaganhyd ($19032 in chips)
Seat 3: slotmachine ($50621 in chips)
Seat 4: mangeshnc ($33279 in chips)
Seat 5: kimjongun ($19526 in chips)
Seat 6: TurnOnTuneInDropOut ($46519 in chips)
slotmachine: posts small blind $200
mangeshnc: posts big blind $400
*** HOLE CARDS ***
Dealt to TurnOnTuneInDropOut [Jc 9h 5h Kh]
kimjongun: raises $600 to $1000
TurnOnTuneInDropOut: folds
soundfsilenz: folds
gaganhyd: folds
slotmachine: folds
mangeshnc: calls $600
*** FLOP *** [4h Td Js]
mangeshnc: checks
kimjongun: bets $1452
mangeshnc: calls $1452
*** TURN *** [4h Td Js] [7d]
mangeshnc: checks
kimjongun: bets $3828
mangeshnc: calls $3828
*** RIVER *** [4h Td Js 7d] [6d]
mangeshnc: bets $12760
kimjongun: raises $486 to $13246 and is all-in
mangeshnc: calls $486
*** SHOW DOWN ***
mangeshnc: shows [Ad 3c Tc 3d]
kimjongun: shows [9d 9c Qd 7c]
mangeshnc collected $38452 from pot
*** SUMMARY ***
Total pot $39252 | Rake $800
Board [4h Td Js 7d 6d]
Seat 1: soundfsilenz folded before Flop (didn't bet)
Seat 2: gaganhyd (button) folded before Flop (didn't bet)
Seat 3: slotmachine (small blind) folded before Flop
Seat 4: mangeshnc (big blind) showed [Ad 3c Tc 3d] and won ($38452)
Seat 5: kimjongun showed [9d 9c Qd 7c] and lost
Seat 6: TurnOnTuneInDropOut folded before Flop (didn't bet)

PokerStars Hand #1109334851: Omaha Pot Limit ($200/$400 USD) - 2020/10/23 14:21:13 ET
Table 'ADA722387266' 6-max Seat #3 is the button
Seat 1: soundfsilenz ($46285 in chips)
Seat 2: gaganhyd ($19032 in chips)
Seat 3: slotmachine ($50421 in chips)
Seat 4: mangeshnc ($52205 in chips)
Seat 5: kimjongun ($27462 in chips)
Seat 6: TurnOnTuneInDropOut ($46519 in chips)
mangeshnc: posts small blind $200
kimjongun: posts big blind $400
*** HOLE CARDS ***
Dealt to TurnOnTuneInDropOut [Jd 4s Qc 5s]
TurnOnTuneInDropOut: folds
soundfsilenz: raises $1000 to $1400
gaganhyd: folds
slotmachine: raises $3400 to $4800
mangeshnc: folds
kimjongun: folds
soundfsilenz: folds
Uncalled bet ($3400) returned to slotmachine
slotmachine collected $3400 from pot
slotmachine: doesn't show hand
*** SUMMARY ***
Total pot $3400 | Rake $0
Seat 1: soundfsilenz folded before Flop
Seat 2: gaganhyd folded before Flop (didn't bet)
Seat 3: slotmachine (button) collected ($3400)
Seat 4: mangeshnc (small blind) folded before Flop
Seat 5: kimjongun (big blind) folded before Flop
Seat 6: TurnOnTuneInDropOut folded before Flop (didn't bet)

PokerStars Hand #1109334854: Omaha Pot Limit ($200/$400 USD) - 2020/10/23 14:23:30 ET
Table 'ADA722387266' 6-max Seat #6 is the button
Seat 1: soundfsilenz ($44485 in chips)
Seat 2: gaganhyd ($19032 in chips)
Seat 3: slotmachine ($52421 in chips)
Seat 4: mangeshnc ($52414 in chips)
Seat 5: kimjongun ($26862 in chips)
Seat 6: TurnOnTuneInDropOut ($46400 in chips)
soundfsilenz: posts small blind $200
gaganhyd: posts big blind $400
*** HOLE CARDS ***
Dealt to TurnOnTuneInDropOut [8h Jc 5d Kd]
slotmachine: folds
mangeshnc: folds
kimjongun: folds
TurnOnTuneInDropOut: folds
soundfsilenz: raises $800 to $1200
gaganhyd: calls $800
*** FLOP *** [4h 9s 5c]
soundfsilenz: bets $1608
gaganhyd: calls $1608
*** TURN *** [4h 9s 5c] [Qs]
soundfsilenz: checks
gaganhyd: checks
*** RIVER *** [4h 9s 5c Qs] [Jd]
soundfsilenz: checks
gaganhyd: bets $4212
soundfsilenz: calls $4212
*** SHOW DOWN ***
soundfsilenz: mucks hand
gaganhyd: shows [Kc Ts 8c 6d]
gaganhyd collected $13477 from pot
*** SUMMARY ***
Total pot $14040 | Rake $563
Board [4h 9s 5c Qs Jd]
Seat 1: soundfsilenz (small blind) mucked
Seat 2: gaganhyd (big blind) showed [Kc Ts 8c 6d] and won ($13477)
Seat 3: slotmachine folded before Flop (didn't bet)
Seat 4: mangeshnc folded before Flop (didn't bet)
Seat 5: kimjongun folded before Flop (didn't bet)
Seat 6: TurnOnTuneInDropOut (button) folded before Flop (didn't bet)

PokerStars Hand #1109334855: Omaha Pot Limit ($200/$400 USD) - 2020/10/23 14:24:47 ET
Table 'ADA722387266' 6-max Seat #1 is the button
Seat 1: soundfsilenz ($37465 in chips)
Seat 2: gaganhyd ($25489 in chips)
Seat 3: slotmachine ($52421 in chips)
Seat 4: mangeshnc ($52414 in chips)
Seat 5: kimjongun ($26862 in chips)
Seat 6: TurnOnTuneInDropOut ($46400 in chips)
gaganhyd: posts small blind $200
slotmachine: posts big blind $400
*** HOLE CARDS ***
Dealt to TurnOnTuneInDropOut [2s Th 4c As]
mangeshnc: folds
kimjongun: folds
TurnOnTuneInDropOut: folds
soundfsilenz: folds
gaganhyd: folds
Uncalled bet ($200) returned to slotmachine
slotmachine collected $400 from pot
slotmachine: doesn't show hand
*** SUMMARY ***
Total pot $400 | Rake $0
Seat 1: soundfsilenz (button) folded before Flop (didn't bet)
Seat 2: gaganhyd (small blind) folded before Flop
Seat 3: slotmachine (big blind) collected ($400)
Seat 4: mangeshnc folded before Flop (didn't bet)
Seat 5: kimjongun folded before Flop (didn't bet)
Seat 6: TurnOnTuneInDropOut folded before Flop (didn't bet)

PokerStars Hand #1109334856: Omaha Pot Limit ($200/$400 USD) - 2020/10/23 14:25:14 ET
Table 'ADA722387266' 6-max Seat #2 is the button
Seat 1: soundfsilenz ($37465 in chips)
Seat 2: gaganhyd ($25289 in chips)
Seat 3: slotmachine ($52621 in chips)
Seat 4: mangeshnc ($52414 in chips)
Seat 5: kimjongun ($26862 in chips)
Seat 6: TurnOnTuneInDropOut ($46400 in chips)
slotmachine: posts small blind $200
mangeshnc: posts big blind $400
*** HOLE CARDS ***
Dealt to TurnOnTuneInDropOut [2h 4d 6s 3h]
kimjongun: folds
TurnOnTuneInDropOut: folds
soundfsilenz: folds
gaganhyd: folds
slotmachine: raises $800 to $1200
mangeshnc: folds
Uncalled bet ($800) returned to slotmachine
slotmachine collected $800 from pot
slotmachine: doesn't show hand
*** SUMMARY ***
Total pot $800 | Rake $0
Seat 1: soundfsilenz folded before Flop (didn't bet)
Seat 2: gaganhyd (button) folded before Flop (didn't bet)
Seat 3: slotmachine (small blind) collected ($800)
Seat 4: mangeshnc (big blind) folded before Flop
Seat 5: kimjongun folded before Flop (didn't bet)
Seat 6: TurnOnTuneInDropOut folded before Flop (didn't bet)

PokerStars Hand #1109334857: Omaha Pot Limit ($200/$400 USD) - 2020/10/23 14:26:01 ET
Table 'ADA722387266' 6-max Seat #3 is the button
Seat 1: soundfsilenz ($37465 in chips)
Seat 2: gaganhyd ($25289 in chips)
Seat 3: slotmachine ($53021 in chips)
Seat 4: mangeshnc ($52014 in chips)
Seat 5: kimjongun ($26862 in chips)
Seat 6: TurnOnTuneInDropOut ($46400 in chips)
mangeshnc: posts small blind $200
kimjongun: posts big blind $400
*** HOLE CARDS ***
Dealt to TurnOnTuneInDropOut [Ah 2d 3s Kc]
TurnOnTuneInDropOut: folds
soundfsilenz: raises $1000 to $1400
gaganhyd: calls $1400
slotmachine: folds
mangeshnc: folds
kimjongun: folds
*** FLOP *** [7d 6h 5c]
soundfsilenz: checks
gaganhyd: checks
*** TURN *** [7d 6h 5c] [Th]
soundfsilenz: checks
gaganhyd: bets $1700
soundfsilenz: raises $4760 to $6460
gaganhyd: raises $16320 to $22780
soundfsilenz: folds
Uncalled bet ($16320) returned to gaganhyd
gaganhyd collected $15666 from pot
gaganhyd: doesn't show hand
*** SUMMARY ***
Total pot $16320 | Rake $654
Board [7d 6h 5c Th]
Seat 1: soundfsilenz folded on the Turn
Seat 2: gaganhyd collected ($15666)
Seat 3: slotmachine (button) folded before Flop (didn't bet)
Seat 4: mangeshnc (small blind) folded before Flop
Seat 5: kimjongun (big blind) folded before Flop
Seat 6: TurnOnTuneInDropOut folded before Flop (didn't bet)

PokerStars Hand #1109334859: Omaha Pot Limit ($200/$400 USD) - 2020/10/23 14:28:34 ET
Table 'ADA722387266' 6-max Seat #6 is the button
Seat 1: soundfsilenz ($29205 in chips)
Seat 2: gaganhyd ($33095 in chips)
Seat 3: slotmachine ($53021 in chips)
Seat 4: mangeshnc ($53294 in chips)
Seat 6: TurnOnTuneInDropOut ($45208 in chips)
soundfsilenz: posts small blind $200
gaganhyd: posts big blind $400
*** HOLE CARDS ***
Dealt to TurnOnTuneInDropOut [3h 2h 9s 3c]
slotmachine: folds
mangeshnc: folds
TurnOnTuneInDropOut: folds
soundfsilenz: folds
Uncalled bet ($200) returned to gaganhyd
gaganhyd collected $400 from pot
gaganhyd: doesn't show hand
*** SUMMARY ***
Total pot $400 | Rake $0
Seat 1: soundfsilenz (small blind) folded before Flop
Seat 2: gaganhyd (big blind) collected ($400)
Seat 3: slotmachine folded before Flop (didn't bet)
Seat 4: mangeshnc folded before Flop (didn't bet)
Seat 6: TurnOnTuneInDropOut (button) folded before Flop (didn't bet)

PokerStars Hand #1109334860: Omaha Pot Limit ($200/$400 USD) - 2020/10/23 14:28:56 ET
Table 'ADA722387266' 6-max Seat #1 is the button
Seat 1: soundfsilenz ($29005 in chips)
Seat 2: gaganhyd ($33295 in chips)
Seat 3: slotmachine ($53021 in chips)
Seat 4: mangeshnc ($53294 in chips)
Seat 6: TurnOnTuneInDropOut ($45208 in chips)
gaganhyd: posts small blind $200
slotmachine: posts big blind $400
*** HOLE CARDS ***
Dealt to TurnOnTuneInDropOut [6d Kd Td Th]
mangeshnc: folds
TurnOnTuneInDropOut: folds
soundfsilenz: folds
gaganhyd: folds
Uncalled bet ($200) returned to slotmachine
slotmachine collected $400 from pot
slotmachine: doesn't show hand
*** SUMMARY ***
Total pot $400 | Rake $0
Seat 1: soundfsilenz (button) folded before Flop (didn't bet)
Seat 2: gaganhyd (small blind) folded before Flop
Seat 3: slotmachine (big blind) collected ($400)
Seat 4: mangeshnc folded before Flop (didn't bet)
Seat 6: TurnOnTuneInDropOut folded before Flop (didn't bet)

PokerStars Hand #1109334861: Omaha Pot Limit ($200/$400 USD) - 2020/10/23 14:29:29 ET
Table 'ADA722387266' 6-max Seat #2 is the button
Seat 1: soundfsilenz ($29005 in chips)
Seat 2: gaganhyd ($33095 in chips)
Seat 3: slotmachine ($53221 in chips)
Seat 4: mangeshnc ($53294 in chips)
Seat 6: TurnOnTuneInDropOut ($45208 in chips)
slotmachine: posts small blind $200
mangeshnc: posts big blind $400
*** HOLE CARDS ***
Dealt to TurnOnTuneInDropOut [2h 9c 4c Th]
TurnOnTuneInDropOut: folds
soundfsilenz: folds
gaganhyd: folds
slotmachine: folds
Uncalled bet ($200) returned to mangeshnc
mangeshnc collected $400 from pot
mangeshnc: doesn't show hand
*** SUMMARY ***
Total pot $400 | Rake $0
Seat 1: soundfsilenz folded before Flop (didn't bet)
Seat 2: gaganhyd (button) folded before Flop (didn't bet)
Seat 3: slotmachine (small blind) folded before Flop
Seat 4: mangeshnc (big blind) collected ($400)
Seat 6: TurnOnTuneInDropOut folded before Flop (didn't bet)

PokerStars Hand #1109334862: Omaha Pot Limit ($200/$400 USD) - 2020/10/23 14:29:43 ET
Table 'ADA722387266' 6-max Seat #3 is the button
Seat 1: soundfsilenz ($29005 in chips)
Seat 2: gaganhyd ($33095 in chips)
Seat 3: slotmachine ($53021 in chips)
Seat 4: mangeshnc ($53494 in chips)
Seat 5: kimjongun ($26462 in chips)
Seat 6: TurnOnTuneInDropOut ($45208 in chips)
mangeshnc: posts small blind $200
kimjongun: posts big blind $400
*** HOLE CARDS ***
Dealt to TurnOnTuneInDropOut [5c 9h Ah 2d]
TurnOnTuneInDropOut: folds
soundfsilenz: folds
gaganhyd: folds
slotmachine: raises $1000 to $1400
mangeshnc: calls $1200
kimjongun: folds
*** FLOP *** [9d 4d 3c]
mangeshnc: checks
slotmachine: bets $3200
mangeshnc: calls $3200
*** TURN *** [9d 4d 3c] [5d]
mangeshnc: checks
slotmachine: bets $9600
mangeshnc: folds
Uncalled bet ($9600) returned to slotmachine
slotmachine collected $9215 from pot
slotmachine: doesn't show hand
*** SUMMARY ***
Total pot $9600 | Rake $385
Board [9d 4d 3c 5d]
Seat 1: soundfsilenz folded before Flop (didn't bet)
Seat 2: gaganhyd folded before Flop (didn't bet)
Seat 3: slotmachine (button) collected ($9215)
Seat 4: mangeshnc (small blind) folded on the Turn
Seat 5: kimjongun (big blind) folded before Flop
Seat 6: TurnOnTuneInDropOut folded before Flop (didn't bet)

PokerStars Hand #1109334864: Omaha Pot Limit ($200/$400 USD) - 2020/10/23 14:32:37 ET
Table 'ADA722387266' 6-max Seat #5 is the button
Seat 1: soundfsilenz ($29005 in chips)
Seat 2: gaganhyd ($27645 in chips)
Seat 3: slotmachine ($48000 in chips)
Seat 4: mangeshnc ($47844 in chips)
Seat 5: kimjongun ($25862 in chips)
Seat 6: TurnOnTuneInDropOut ($96316 in chips)
TurnOnTuneInDropOut: posts small blind $200
soundfsilenz: posts big blind $400
*** HOLE CARDS ***
Dealt to TurnOnTuneInDropOut [3c Qs 6h Ad]
gaganhyd: folds
slotmachine: folds
mangeshnc: raises $1000 to $1400
kimjongun: calls $1400
TurnOnTuneInDropOut: folds
soundfsilenz: folds
*** FLOP *** [8c 5h 4s]
mangeshnc: bets $3400
kimjongun: calls $3400
*** TURN *** [8c 5h 4s] [9d]
mangeshnc: checks
kimjongun: checks
*** RIVER *** [8c 5h 4s 9d] [Ts]
mangeshnc: bets $10200
kimjongun: raises $10862 to $21062 and is all-in
mangeshnc: calls $10862
*** SHOW DOWN ***
mangeshnc: shows [Jc Qc Qh Kc]
kimjongun: shows [Jh 7s Th Jd]
mangeshnc collected $51524 from pot
*** SUMMARY ***
Total pot $52324 | Rake $800
Board [8c 5h 4s 9d Ts]
Seat 1: soundfsilenz (big blind) folded before Flop
Seat 2: gaganhyd folded before Flop (didn't bet)
Seat 3: slotmachine folded before Flop (didn't bet)
Seat 4: mangeshnc showed [Jc Qc Qh Kc] and won ($51524)
Seat 5: kimjongun (button) showed [Jh 7s Th Jd] and lost
Seat 6: TurnOnTuneInDropOut (small blind) folded before Flop

PokerStars Hand #1109334865: Omaha Pot Limit ($200/$400 USD) - 2020/10/23 14:33:55 ET
Table 'ADA722387266' 6-max Seat #6 is the button
Seat 1: soundfsilenz ($28605 in chips)
Seat 2: gaganhyd ($27645 in chips)
Seat 3: slotmachine ($48000 in chips)
Seat 4: mangeshnc ($73506 in chips)
Seat 6: TurnOnTuneInDropOut ($96116 in chips)
soundfsilenz: posts small blind $200
gaganhyd: posts big blind $400
*** HOLE CARDS ***
Dealt to TurnOnTuneInDropOut [4s Jd 5s 8h]
slotmachine: folds
mangeshnc: folds
TurnOnTuneInDropOut: folds
soundfsilenz: folds
Uncalled bet ($200) returned to gaganhyd
gaganhyd collected $400 from pot
gaganhyd: doesn't show hand
*** SUMMARY ***
Total pot $400 | Rake $0
Seat 1: soundfsilenz (small blind) folded before Flop
Seat 2: gaganhyd (big blind) collected ($400)
Seat 3: slotmachine folded before Flop (didn't bet)
Seat 4: mangeshnc folded before Flop (didn't bet)
Seat 6: TurnOnTuneInDropOut (button) folded before Flop (didn't bet)

PokerStars Hand #1109334866: Omaha Pot Limit ($200/$400 USD) - 2020/10/23 14:34:16 ET
Table 'ADA722387266' 6-max Seat #1 is the button
Seat 1: soundfsilenz ($28405 in chips)
Seat 2: gaganhyd ($27845 in chips)
Seat 3: slotmachine ($48000 in chips)
Seat 4: mangeshnc ($73506 in chips)
Seat 6: TurnOnTuneInDropOut ($96116 in chips)
gaganhyd: posts small blind $200
slotmachine: posts big blind $400
*** HOLE CARDS ***
Dealt to TurnOnTuneInDropOut [6d 5h 6s Th]
mangeshnc: folds
TurnOnTuneInDropOut: folds
soundfsilenz: folds
gaganhyd: folds
Uncalled bet ($200) returned to slotmachine
slotmachine collected $400 from pot
slotmachine: doesn't show hand
*** SUMMARY ***
Total pot $400 | Rake $0
Seat 1: soundfsilenz (button) folded before Flop (didn't bet)
Seat 2: gaganhyd (small blind) folded before Flop
Seat 3: slotmachine (big blind) collected ($400)
Seat 4: mangeshnc folded before Flop (didn't bet)
Seat 6: TurnOnTuneInDropOut folded before Flop (didn't bet)

PokerStars Hand #1109334867: Omaha Pot Limit ($200/$400 USD) - 2020/10/23 14:34:42 ET
Table 'ADA722387266' 6-max Seat #2 is the button
Seat 1: soundfsilenz ($28405 in chips)
Seat 2: gaganhyd ($27645 in chips)
Seat 3: slotmachine ($48200 in chips)
Seat 4: mangeshnc ($73506 in chips)
Seat 6: TurnOnTuneInDropOut ($96116 in chips)
slotmachine: posts small blind $200
mangeshnc: posts big blind $400
*** HOLE CARDS ***
Dealt to TurnOnTuneInDropOut [4s 6s 9h 2h]
TurnOnTuneInDropOut: folds
soundfsilenz: raises $1000 to $1400
gaganhyd: calls $1400
slotmachine: calls $1200
mangeshnc: calls $1000
*** FLOP *** [3c 8c Kh]
slotmachine: checks
mangeshnc: checks
soundfsilenz: checks
gaganhyd: bets $2800
slotmachine: folds
mangeshnc: calls $2800
soundfsilenz: folds
*** TURN *** [3c 8c Kh] [8d]
mangeshnc: checks
gaganhyd: bets $4904
mangeshnc: calls $4904
*** RIVER *** [3c 8c Kh 8d] [4d]
mangeshnc: checks
gaganhyd: bets $9409
mangeshnc: folds
Uncalled bet ($9409) returned to gaganhyd
gaganhyd collected $20208 from pot
gaganhyd: doesn't show hand
*** SUMMARY ***
Total pot $21008 | Rake $800
Board [3c 8c Kh 8d 4d]
Seat 1: soundfsilenz folded on the Flop
Seat 2: gaganhyd (button) collected ($20208)
Seat 3: slotmachine (small blind) folded on the Flop
Seat 4: mangeshnc (big blind) folded on the River
Seat 6: TurnOnTuneInDropOut folded before Flop (didn't bet)

PokerStars Hand #1109334868: Omaha Pot Limit ($200/$400 USD) - 2020/10/23 14:36:16 ET
Table 'ADA722387266' 6-max Seat #3 is the button
Seat 1: soundfsilenz ($27005 in chips)
Seat 2: gaganhyd ($38749 in chips)
Seat 3: slotmachine ($46800 in chips)
Seat 4: mangeshnc ($64402 in chips)
Seat 5: kimjongun ($28001 in chips)
Seat 6: TurnOnTuneInDropOut ($96116 in chips)
mangeshnc: posts small blind $200
kimjongun: posts big blind $400
*** HOLE CARDS ***
Dealt to TurnOnTuneInDropOut [3h Tc 9c Ah]
TurnOnTuneInDropOut: folds
soundfsilenz: folds
gaganhyd: raises $1000 to $1400
slotmachine: folds
mangeshnc: calls $1200
kimjongun: folds
*** FLOP *** [4s As 9h]
mangeshnc: bets $3200
gaganhyd: folds
Uncalled bet ($3200) returned to mangeshnc
mangeshnc collected $3072 from pot
mangeshnc: doesn't show hand
*** SUMMARY ***
Total pot $3200 | Rake $128
Board [4s As 9h]
Seat 1: soundfsilenz folded before Flop (didn't bet)
Seat 2: gaganhyd folded on the Flop
Seat 3: slotmachine (button) folded before Flop (didn't bet)
Seat 4: mangeshnc (small blind) collected ($3072)
Seat 5: kimjongun (big blind) folded before Flop
Seat 6: TurnOnTuneInDropOut folded before Flop (didn't bet)

PokerStars Hand #1109334869: Omaha Pot Limit ($200/$400 USD) - 2020/10/23 14:37:37 ET
Table 'ADA722387266' 6-max Seat #4 is the button
Seat 1: soundfsilenz ($39006 in chips)
Seat 2: gaganhyd ($37349 in chips)
Seat 3: slotmachine ($46800 in chips)
Seat 4: mangeshnc ($66074 in chips)
Seat 5: kimjongun ($27601 in chips)
Seat 6: TurnOnTuneInDropOut ($96116 in chips)
kimjongun: posts small blind $200
TurnOnTuneInDropOut: posts big blind $400
*** HOLE CARDS ***
Dealt to TurnOnTuneInDropOut [9c 6h 6s 4d]
soundfsilenz: folds
gaganhyd: raises $650 to $1050
slotmachine: folds
mangeshnc: folds
kimjongun: folds
TurnOnTuneInDropOut: folds
Uncalled bet ($650) returned to gaganhyd
gaganhyd collected $1000 from pot
gaganhyd: doesn't show hand
*** SUMMARY ***
Total pot $1000 | Rake $0
Seat 1: soundfsilenz folded before Flop (didn't bet)
Seat 2: gaganhyd collected ($1000)
Seat 3: slotmachine folded before Flop (didn't bet)
Seat 4: mangeshnc (button) folded before Flop (didn't bet)
Seat 5: kimjongun (small blind) folded before Flop
Seat 6: TurnOnTuneInDropOut (big blind) folded before Flop

PokerStars Hand #1109334870: Omaha Pot Limit ($200/$400 USD) - 2020/10/23 14:38:03 ET
Table 'ADA722387266' 6-max Seat #5 is the button
Seat 1: soundfsilenz ($39006 in chips)
Seat 2: gaganhyd ($37949 in chips)
Seat 3: slotmachine ($46800 in chips)
Seat 4: mangeshnc ($66074 in chips)
Seat 5: kimjongun ($27401 in chips)
Seat 6: TurnOnTuneInDropOut ($95716 in chips)
TurnOnTuneInDropOut: posts small blind $200
soundfsilenz: posts big blind $400
*** HOLE CARDS ***
Dealt to TurnOnTuneInDropOut [7d Ac 6d 8c]
gaganhyd: folds
slotmachine: raises $1000 to $1400
mangeshnc: calls $1400
kimjongun: folds
TurnOnTuneInDropOut: folds
soundfsilenz: folds
*** FLOP *** [7c 6c 2d]
slotmachine: checks
mangeshnc: bets $3400
slotmachine: folds
Uncalled bet ($3400) returned to mangeshnc
mangeshnc collected $3264 from pot
mangeshnc: doesn't show hand
*** SUMMARY ***
Total pot $3400 | Rake $136
Board [7c 6c 2d]
Seat 1: soundfsilenz (big blind) folded before Flop
Seat 2: gaganhyd folded before Flop (didn't bet)
Seat 3: slotmachine folded on the Flop
Seat 4: mangeshnc collected ($3264)
Seat 5: kimjongun (button) folded before Flop (didn't bet)
Seat 6: TurnOnTuneInDropOut (small blind) folded before Flop

PokerStars Hand #1109334872: Omaha Pot Limit ($200/$400 USD) - 2020/10/23 14:40:37 ET
Table 'ADA722387266' 6-max Seat #1 is the button
Seat 1: soundfsilenz ($38406 in chips)
Seat 2: gaganhyd ($46327 in chips)
Seat 3: slotmachine ($45400 in chips)
Seat 4: mangeshnc ($59038 in chips)
Seat 5: kimjongun ($27401 in chips)
Seat 6: TurnOnTuneInDropOut ($95516 in chips)
gaganhyd: posts small blind $200
slotmachine: posts big blind $400
*** HOLE CARDS ***
Dealt to TurnOnTuneInDropOut [9h 8c 4s 4h]
mangeshnc: raises $1000 to $1400
kimjongun: folds
TurnOnTuneInDropOut: folds
soundfsilenz: raises $3400 to $4800
gaganhyd: folds
slotmachine: folds
mangeshnc: calls $3400
*** FLOP *** [8d As Th]
mangeshnc: checks
soundfsilenz: bets $5508
mangeshnc: calls $5508
*** TURN *** [8d As Th] [Kd]
mangeshnc: checks
soundfsilenz: checks
*** RIVER *** [8d As Th Kd] [Jc]
mangeshnc: bets $10608
soundfsilenz: folds
Uncalled bet ($10608) returned to mangeshnc
mangeshnc collected $20416 from pot
mangeshnc: doesn't show hand
*** SUMMARY ***
Total pot $21216 | Rake $800
Board [8d As Th Kd Jc]
Seat 1: soundfsilenz (button) folded on the River
Seat 2: gaganhyd (small blind) folded before Flop
Seat 3: slotmachine (big blind) folded before Flop
Seat 4: mangeshnc collected ($20416)
Seat 5: kimjongun folded before Flop (didn't bet)
Seat 6: TurnOnTuneInDropOut folded before Flop (didn't bet)

PokerStars Hand #1109334873: Omaha Pot Limit ($200/$400 USD) - 2020/10/23 14:42:17 ET
Table 'ADA722387266' 6-max Seat #2 is the button
Seat 1: soundfsilenz ($28098 in chips)
Seat 2: gaganhyd ($46127 in chips)
Seat 3: slotmachine ($45000 in chips)
Seat 4: mangeshnc ($69146 in chips)
Seat 5: kimjongun ($27401 in chips)
Seat 6: TurnOnTuneInDropOut ($95516 in chips)
slotmachine: posts small blind $200
mangeshnc: posts big blind $400
*** HOLE CARDS ***
Dealt to TurnOnTuneInDropOut [4c 5c 4h Qc]
kimjongun: folds
TurnOnTuneInDropOut: folds
soundfsilenz: raises $1000 to $1400
gaganhyd: raises $3400 to $4800
slotmachine: folds
mangeshnc: folds
soundfsilenz: calls $3400
*** FLOP *** [Ac Qh Qd]
soundfsilenz: checks
gaganhyd: checks
*** TURN *** [Ac Qh Qd] [7s]
soundfsilenz: checks
gaganhyd: bets $3465
soundfsilenz: folds
Uncalled bet ($3465) returned to gaganhyd
gaganhyd collected $9791 from pot
gaganhyd: doesn't show hand
*** SUMMARY ***
Total pot $10200 | Rake $409
Board [Ac Qh Qd 7s]
Seat 1: soundfsilenz folded on the Turn
Seat 2: gaganhyd (button) collected ($9791)
Seat 3: slotmachine (small blind) folded before Flop
Seat 4: mangeshnc (big blind) folded before Flop
Seat 5: kimjongun folded before Flop (didn't bet)
Seat 6: TurnOnTuneInDropOut folded before Flop (didn't bet)

PokerStars Hand #1109334874: Omaha Pot Limit ($200/$400 USD) - 2020/10/23 14:43:31 ET
Table 'ADA722387266' 6-max Seat #3 is the button
Seat 1: soundfsilenz ($40099 in chips)
Seat 2: gaganhyd ($51118 in chips)
Seat 3: slotmachine ($44800 in chips)
Seat 4: mangeshnc ($68746 in chips)
Seat 5: kimjongun ($27401 in chips)
Seat 6: TurnOnTuneInDropOut ($95516 in chips)
mangeshnc: posts small blind $200
kimjongun: posts big blind $400
*** HOLE CARDS ***
Dealt to TurnOnTuneInDropOut [7c 2c Th 8d]
TurnOnTuneInDropOut: folds
soundfsilenz: folds
gaganhyd: folds
slotmachine: raises $1000 to $1400
mangeshnc: calls $1200
kimjongun: folds
*** FLOP *** [Ac 6s Js]
mangeshnc: checks
slotmachine: checks
*** TURN *** [Ac 6s Js] [4d]
mangeshnc: bets $3200
slotmachine: folds
Uncalled bet ($3200) returned to mangeshnc
mangeshnc collected $3072 from pot
mangeshnc: doesn't show hand
*** SUMMARY ***
Total pot $3200 | Rake $128
Board [Ac 6s Js 4d]
Seat 1: soundfsilenz folded before Flop (didn't bet)
Seat 2: gaganhyd folded before Flop (didn't bet)
Seat 3: slotmachine (button) folded on the Turn
Seat 4: mangeshnc (small blind) collected ($3072)
Seat 5: kimjongun (big blind) folded before Flop
Seat 6: TurnOnTuneInDropOut folded before Flop (didn't bet)

PokerStars Hand #155975274: Omaha Pot Limit ($500/$1000 USD) - 2020/10/23 13:56:32 ET
Table 'ADA766532706' 6-max Seat #1 is the button
Seat 1: slotmachine ($136209 in chips)
Seat 2: TurnOnTuneInDropOut ($74000 in chips)
Seat 3: vaibz16 ($30000 in chips)
Seat 4: slowcoach ($60995 in chips)
Seat 5: badtameez_donk ($124108 in chips)
Seat 6: aggtarun ($127841 in chips)
TurnOnTuneInDropOut: posts small blind $500
vaibz16: posts big blind $1000
*** HOLE CARDS ***
Dealt to TurnOnTuneInDropOut [4s Td 6s Kh]
slowcoach: raises $1000 to $2000
badtameez_donk: folds
aggtarun: calls $2000
slotmachine: folds
TurnOnTuneInDropOut: folds
vaibz16: calls $1000
*** FLOP *** [3c Ts 4d]
vaibz16: checks
slowcoach: bets $4875
aggtarun: calls $4875
vaibz16: folds
*** TURN *** [3c Ts 4d] [3s]
slowcoach: bets $8125
aggtarun: calls $8125
*** RIVER *** [3c Ts 4d 3s] [9s]
slowcoach: checks
aggtarun: bets $20725
slowcoach: folds
Uncalled bet ($20725) returned to aggtarun
aggtarun collected $31522 from pot
aggtarun: doesn't show hand
*** SUMMARY ***
Total pot $32500 | Rake $978
Board [3c Ts 4d 3s 9s]
Seat 1: slotmachine (button) folded before Flop (didn't bet)
Seat 2: TurnOnTuneInDropOut (small blind) folded before Flop
Seat 3: vaibz16 (big blind) folded on the Flop
Seat 4: slowcoach folded on the River
Seat 5: badtameez_donk folded before Flop (didn't bet)
Seat 6: aggtarun collected ($31522)

PokerStars Hand #155975276: Omaha Pot Limit ($500/$1000 USD) - 2020/10/23 14:00:29 ET
Table 'ADA766532706' 6-max Seat #3 is the button
Seat 1: slotmachine ($135209 in chips)
Seat 2: TurnOnTuneInDropOut ($73500 in chips)
Seat 3: vaibz16 ($27000 in chips)
Seat 4: slowcoach ($1995 in chips)
Seat 5: badtameez_donk ($168709 in chips)
Seat 6: aggtarun ($144363 in chips)
slowcoach: posts small blind $500
badtameez_donk: posts big blind $1000
*** HOLE CARDS ***
Dealt to TurnOnTuneInDropOut [2d 3s 5h 3d]
aggtarun: raises $2500 to $3500
slotmachine: folds
TurnOnTuneInDropOut: folds
vaibz16: calls $3500
slowcoach: calls $1495 and is all-in
badtameez_donk: folds
*** FLOP *** [Qs Jh 5c]
aggtarun: bets $9995
vaibz16: folds
Uncalled bet ($9995) returned to aggtarun
*** TURN *** [Qs Jh 5c] [4h]
*** RIVER *** [Qs Jh 5c 4h] [2s]
*** SHOW DOWN ***
aggtarun: shows [Js Ad 6c Qd]
aggtarun collected $3010 from side pot
slowcoach: shows [4c Ac Kh 4d]
slowcoach collected $6684 from main pot
*** SUMMARY ***
Total pot $9995 Main pot $6684. Side pot $3010. | Rake $301
Board [Qs Jh 5c 4h 2s]
Seat 1: slotmachine folded before Flop (didn't bet)
Seat 2: TurnOnTuneInDropOut folded before Flop (didn't bet)
Seat 3: vaibz16 (button) folded on the Flop
Seat 4: slowcoach (small blind) showed [4c Ac Kh 4d] and won ($6684)
Seat 5: badtameez_donk (big blind) folded before Flop
Seat 6: aggtarun showed [Js Ad 6c Qd] and won ($3010)

PokerStars Hand #155975277: Omaha Pot Limit ($500/$1000 USD) - 2020/10/23 14:01:12 ET
Table 'ADA766532706' 6-max Seat #4 is the button
Seat 1: slotmachine ($135209 in chips)
Seat 2: TurnOnTuneInDropOut ($73500 in chips)
Seat 3: vaibz16 ($23500 in chips)
Seat 4: slowcoach ($6775 in chips)
Seat 5: badtameez_donk ($167709 in chips)
badtameez_donk: posts small blind $500
slotmachine: posts big blind $1000
*** HOLE CARDS ***
Dealt to TurnOnTuneInDropOut [Jd Th 9c Ts]
TurnOnTuneInDropOut: folds
vaibz16: folds
slowcoach: raises $2500 to $3500
badtameez_donk: folds
slotmachine: raises $5500 to $9000
slowcoach: calls $3275 and is all-in
Uncalled bet ($2225) returned to slotmachine
*** FLOP *** [8d 4h 5c]
*** TURN *** [8d 4h 5c] [5s]
*** RIVER *** [8d 4h 5c 5s] [3s]
*** SHOW DOWN ***
slotmachine: shows [9h Qc 3h Tc]
slowcoach: shows [Kc Jc 7c 8s]
slowcoach collected $13627 from pot
*** SUMMARY ***
Total pot $14050 | Rake $423
Board [8d 4h 5c 5s 3s]
Seat 1: slotmachine (big blind) showed [9h Qc 3h Tc] and lost
Seat 2: TurnOnTuneInDropOut folded before Flop (didn't bet)
Seat 3: vaibz16 folded before Flop (didn't bet)
Seat 4: slowcoach (button) showed [Kc Jc 7c 8s] and won ($13627)
Seat 5: badtameez_donk (small blind) folded before Flop

